//MAP CONVERTED BY dmm2tgm.py THIS HEADER COMMENT PREVENTS RECONVERSION, DO NOT REMOVE
"a" = (
/turf/closed/mineral/smooth/bigred,
/area/bigredv2/caves/rock)
"b" = (
/obj/structure/cable,
/turf/closed/wall/r_wall,
/area/bigredv2/outside/southcheckpoint)
"c" = (
/obj/machinery/light{
	dir = 8;
	icon_state = "tube1"
	},
/obj/effect/decal/cleanable/dirt,
/obj/structure/cable,
/turf/open/floor/tile/dark{
	},
/area/bigredv2/outside/southcheckpoint)
"d" = (
/obj/structure/table/mainship,
/obj/effect/spawner/random/tool,
/turf/open/floor/tile/dark{
	},
/area/bigredv2/outside/southcheckpoint)
"e" = (
/obj/machinery/door/airlock/mainship/security/glass{
	dir = 4;
	icon_state = "door_locked";
	locked = 1;
	name = "\improper Checkpoint Office"
	},
/obj/structure/cable,
/turf/open/floor/tile/dark{
	},
/area/bigredv2/outside/southcheckpoint)
"f" = (
/obj/item/radio,
/obj/structure/table/mainship,
/turf/open/floor/tile/dark{
	},
/area/bigredv2/outside/southcheckpoint)
"h" = (
/obj/effect/decal/cleanable/blood,
/obj/effect/spawner/gibspawner/human,
/turf/open/floor/tile/dark{
	},
/area/bigredv2/outside/southcheckpoint)
"j" = (
/obj/effect/decal/cleanable/dirt,
/turf/open/floor/tile/dark{
	},
/area/bigredv2/outside/southcheckpoint)
"k" = (
/obj/structure/filingcabinet,
/obj/structure/cable,
/turf/open/floor/podhatch/floor,
/area/bigredv2/outside/southcheckpoint)
"l" = (
/obj/item/trash/sosjerky,
/obj/effect/decal/cleanable/dirt,
/obj/structure/cable,
/turf/open/floor/tile/dark{
	},
/area/bigredv2/outside/southcheckpoint)
"m" = (
/obj/structure/table/mainship,
/turf/open/floor/podhatch/floor,
/area/bigredv2/outside/southcheckpoint)
"n" = (
/obj/machinery/door/airlock/mainship/security/glass{
	dir = 1;
	name = "\improper Checkpoint Office"
	},
/turf/open/floor/tile/dark{
	},
/area/bigredv2/outside/southcheckpoint)
"o" = (
/obj/structure/table/mainship,
/obj/machinery/computer/secure_data{
	dir = 8
	},
/turf/open/floor/tile/dark{
	},
/area/bigredv2/outside/southcheckpoint)
"q" = (
/obj/structure/rack,
/obj/effect/spawner/random/toolbox,
/turf/open/floor/tile/dark{
	},
/area/bigredv2/outside/southcheckpoint)
"s" = (
/obj/structure/rack,
/obj/item/stack/sheet/metal/small_stack,
/turf/open/floor/tile/dark{
	},
/area/bigredv2/outside/southcheckpoint)
"t" = (
/obj/effect/decal/cleanable/blood,
/turf/open/floor/tile/dark{
	},
/area/bigredv2/outside/southcheckpoint)
"u" = (
/obj/structure/inflatable,
/turf/open/floor/podhatch/floor,
/area/bigredv2/outside/southcheckpoint)
"v" = (
/obj/structure/rack,
/obj/item/storage/firstaid,
/turf/open/floor/tile/dark{
	},
/area/bigredv2/outside/southcheckpoint)
"w" = (
/obj/structure/table/mainship,
/obj/effect/spawner/random/technology_scanner,
/turf/open/floor/podhatch/floor,
/area/bigredv2/outside/southcheckpoint)
"z" = (
/obj/machinery/power/apc{
	start_charge = 0
	},
/obj/structure/cable,
/turf/open/floor/tile/dark{
	},
/area/bigredv2/outside/southcheckpoint)
"A" = (
/obj/structure/table/mainship,
/obj/machinery/computer/security/wooden_tv{
	dir = 8
	},
/turf/open/floor/podhatch/floor,
/area/bigredv2/outside/southcheckpoint)
"B" = (
/obj/structure/table/mainship,
/obj/item/restraints/handcuffs,
/turf/open/floor/tile/dark{
	},
/area/bigredv2/outside/southcheckpoint)
"E" = (
/obj/structure/bed/chair/office/light{
	dir = 4;
	icon_state = "officechair_white"
	},
/turf/open/floor/tile/dark{
	},
/area/bigredv2/outside/southcheckpoint)
"F" = (
/obj/structure/largecrate,
/turf/open/floor/tile/dark{
	},
/area/bigredv2/outside/southcheckpoint)
"G" = (
/turf/closed/wall/r_wall,
/area/bigredv2/outside/southcheckpoint)
"H" = (
/turf/open/floor/podhatch/floor,
/area/bigredv2/outside/southcheckpoint)
"I" = (
/obj/structure/window/framed/colony/reinforced,
/turf/open/floor/plating,
/area/bigredv2/outside/southcheckpoint)
"L" = (
/obj/machinery/light{
	dir = 4
	},
/turf/open/floor/tile/dark{
	},
/area/bigredv2/outside/southcheckpoint)
"O" = (
/obj/effect/decal/cleanable/dirt,
/obj/structure/cable,
/turf/open/floor/tile/dark{
	},
/area/bigredv2/outside/southcheckpoint)
"P" = (
/obj/structure/rack,
/obj/item/clothing/mask/gas,
/obj/item/flashlight,
/obj/machinery/light{
	dir = 4
	},
/turf/open/floor/tile/dark{
	},
/area/bigredv2/outside/southcheckpoint)
"Q" = (
/obj/structure/largecrate,
/turf/open/floor/podhatch/floor,
/area/bigredv2/outside/southcheckpoint)
"R" = (
/obj/structure/table/mainship,
/obj/item/ashtray/bronze,
/obj/item/trash/cigbutt/cigarbutt,
/turf/open/floor/podhatch/floor,
/area/bigredv2/outside/southcheckpoint)
"S" = (
/obj/structure/table/mainship,
/obj/item/attachable/motiondetector,
/turf/open/floor/tile/dark{
	},
/area/bigredv2/outside/southcheckpoint)
"T" = (
/obj/structure/cable,
/turf/open/floor/tile/dark{
	},
/area/bigredv2/outside/southcheckpoint)
"U" = (
/turf/open/floor/tile/dark{
	},
/area/bigredv2/outside/southcheckpoint)
"W" = (
/obj/structure/window/framed/colony/reinforced,
/turf/open/floor/tile/dark{
	},
/area/bigredv2/outside/southcheckpoint)
"X" = (
/obj/machinery/light{
	dir = 8;
	icon_state = "tube1"
	},
/obj/machinery/vending/security,
/turf/open/floor/tile/dark{
	},
/area/bigredv2/outside/southcheckpoint)
"Y" = (
/obj/structure/closet/secure_closet/marshal,
/turf/open/floor/podhatch/floor,
/area/bigredv2/outside/southcheckpoint)

(1,1,1) = {"
G
b
G
G
G
G
G
G
G
a
"}
(2,1,1) = {"
W
k
c
f
S
B
X
u
G
a
"}
(3,1,1) = {"
I
m
T
l
O
j
U
u
G
a
"}
(4,1,1) = {"
G
R
E
j
T
j
j
H
G
a
"}
(5,1,1) = {"
G
A
o
U
T
j
U
Y
G
a
"}
(6,1,1) = {"
G
G
G
G
e
G
G
G
G
a
"}
(7,1,1) = {"
G
F
F
U
O
U
d
m
G
a
"}
(8,1,1) = {"
G
z
T
O
O
U
U
w
G
a
"}
(9,1,1) = {"
n
j
j
U
U
j
U
H
G
a
"}
(10,1,1) = {"
G
U
h
t
U
j
j
H
G
a
"}
(11,1,1) = {"
G
t
L
q
v
s
P
Q
G
a
"}
(12,1,1) = {"
G
G
G
G
G
G
G
G
G
a
"}
