//MAP CONVERTED BY dmm2tgm.py THIS HEADER COMMENT PREVENTS RECONVERSION, DO NOT REMOVE
"al" = (
/atom/movable/effect/landmark/weed_node,
/turf/open/floor/plating/ground/mars/random/cave/rock,
/area/bigredv2/caves/west)
"am" = (
/obj/machinery/door/poddoor/timed_late/containment/landing_zone/lz2{
	dir = 2
	},
/turf/closed/wall/r_wall,
/area/shuttle/drop2/lz2)
"av" = (
/obj/machinery/door/airlock/multi_tile/mainship/generic{
	dir = 1;
	name = "\improper Cargo Bay"
	},
/turf/open/floor,
/area/bigredv2/outside/cargo)
"aP" = (
/obj/machinery/floodlight/landing,
/turf/open/floor/marking/asteroidwarning{
	dir = 5
	},
/area/shuttle/drop2/lz2)
"aX" = (
/turf/open/floor/plating/ground/mars/dirttosand{
	dir = 10
	},
/area/shuttle/drop2/lz2)
"bS" = (
/obj/machinery/door/poddoor/timed_late/containment/landing_zone/lz2,
/turf/open/floor/marking/asteroidwarning,
/area/bigredv2/outside/w)
"bV" = (
/atom/movable/effect/decal/cleanable/dirt,
/turf/open/floor/marking/asteroidwarning{
	dir = 8
	},
/area/shuttle/drop2/lz2)
"cI" = (
/obj/machinery/landinglight/ds2/delaythree{
	dir = 8
	},
/turf/open/floor/marking/asteroidwarning{
	dir = 8
	},
/area/shuttle/drop2/lz2)
"cW" = (
/atom/movable/effect/decal/cleanable/dirt,
/obj/structure/cable,
/turf/open/floor/marking/asteroidwarning{
	dir = 4
	},
/area/shuttle/drop2/lz2)
"db" = (
/obj/machinery/door/poddoor/timed_late/containment/landing_zone/lz2,
/turf/open/floor/asteroidfloor,
/area/shuttle/drop2/lz2)
"dx" = (
/turf/closed/wall/r_wall,
/area/bigredv2/outside/cargo)
"dJ" = (
/obj/structure/table,
/obj/item/clothing/ears/earmuffs,
/obj/machinery/door/poddoor/timed_late/containment/landing_zone/lz2,
/turf/open/floor,
/area/bigredv2/outside/cargo)
"dU" = (
/atom/movable/effect/decal/cleanable/dirt,
/turf/open/floor/marking/asteroidwarning{
	dir = 6
	},
/area/shuttle/drop2/lz2)
"eg" = (
/obj/machinery/landinglight/ds2/delaythree{
	dir = 1
	},
/turf/open/floor/marking/asteroidwarning{
	dir = 1
	},
/area/shuttle/drop2/lz2)
"eh" = (
/obj/machinery/door/poddoor/timed_late/containment/landing_zone/lz2,
/turf/open/floor/marking/asteroidwarning,
/area/bigredv2/outside/sw)
"ey" = (
/atom/movable/effect/landmark/lv624/fog_blocker,
/turf/open/floor/plating/ground/mars/random/cave/rock,
/area/bigredv2/caves/west)
"fz" = (
/turf/open/floor/plating/ground/mars/random/sand,
/area/shuttle/drop2/lz2)
"fT" = (
/atom/movable/effect/landmark/weed_node,
/turf/open/floor/plating/ground/mars/random/cave/rock,
/area/bigredv2/caves/southwest)
"fW" = (
/atom/movable/effect/ai_node,
/turf/open/floor/plating/ground/mars/random/cave/rock,
/area/bigredv2/caves/west)
"gF" = (
/atom/movable/effect/ai_node,
/turf/open/floor/plating/ground/mars/random/cave,
/area/bigredv2/caves/southwest)
"gQ" = (
/obj/machinery/door/poddoor/shutters/mainship{
	dir = 2;
	id = "Engineering";
	name = "\improper Engineering Shutters"
	},
/obj/structure/window/framed/colony/reinforced,
/obj/machinery/door/poddoor/timed_late/containment/landing_zone/lz2,
/turf/open/floor/plating,
/area/bigredv2/outside/engineering)
"gW" = (
/obj/machinery/camera/autoname/lz_camera,
/turf/open/floor/plating,
/area/shuttle/drop2/lz2)
"hO" = (
/turf/open/floor/plating/icefloor/warnplate{
	dir = 8
	},
/area/shuttle/drop2/lz2)
"it" = (
/turf/open/floor/plating/icefloor/warnplate{
	dir = 1
	},
/area/shuttle/drop2/lz2)
"jz" = (
/obj/machinery/door/poddoor/timed_late/containment/landing_zone/lz2,
/turf/open/floor/asteroidfloor,
/area/bigredv2/outside/w)
"jR" = (
/obj/machinery/door/poddoor/timed_late/containment/landing_zone/lz2,
/turf/closed/wall/r_wall,
/area/bigredv2/outside/cargo)
"kC" = (
/atom/movable/effect/attach_point/weapon/dropship1{
	dir = 8;
	icon_state = "equip_base_l_wing"
	},
/turf/open/floor/plating/icefloor/warnplate{
	dir = 8
	},
/area/shuttle/drop2/lz2)
"kH" = (
/turf/open/floor/marking/asteroidwarning{
	dir = 8
	},
/area/shuttle/drop2/lz2)
"kM" = (
/turf/open/floor/plating/ground/mars/dirttosand,
/area/shuttle/drop2/lz2)
"kW" = (
/obj/machinery/landinglight/ds2/delaytwo,
/turf/open/floor/marking/asteroidwarning,
/area/shuttle/drop2/lz2)
"lJ" = (
/obj/machinery/door/poddoor/shutters/mainship{
	id = "Cargonia";
	name = "\improper Cargo Shutters"
	},
/obj/structure/window/framed/colony/reinforced,
/turf/open/floor/plating,
/area/bigredv2/outside/cargo)
"mf" = (
/obj/machinery/landinglight/ds2{
	dir = 4
	},
/turf/open/floor/marking/asteroidwarning{
	dir = 6
	},
/area/shuttle/drop2/lz2)
"mi" = (
/atom/movable/effect/landmark/weed_node,
/turf/open/floor/plating/ground/mars/random/cave,
/area/bigredv2/caves/southwest)
"mo" = (
/turf/open/floor/marking/asteroidwarning{
	dir = 5
	},
/area/shuttle/drop2/lz2)
"mq" = (
/atom/movable/effect/landmark/lv624/fog_blocker,
/turf/closed/mineral/smooth/bigred,
/area/bigredv2/caves/rock)
"mS" = (
/obj/machinery/floodlight/landing,
/turf/open/floor/plating/asteroidplating,
/area/shuttle/drop2/lz2)
"mU" = (
/turf/open/floor/plating/ground/mars/random/dirt,
/area/shuttle/drop2/lz2)
"nb" = (
/atom/movable/effect/landmark/weed_node,
/turf/open/floor/plating/ground/mars/random/cave,
/area/shuttle/drop2/lz2)
"nq" = (
/obj/machinery/landinglight/ds2/delaythree,
/turf/open/floor/marking/asteroidwarning,
/area/shuttle/drop2/lz2)
"nJ" = (
/turf/open/floor/plating/ground/mars/random/cave,
/area/bigredv2/caves/west)
"ol" = (
/obj/machinery/landinglight/ds2{
	dir = 8
	},
/turf/open/floor/marking/asteroidwarning{
	dir = 8
	},
/area/shuttle/drop2/lz2)
"pu" = (
/obj/structure/toilet{
	dir = 8
	},
/obj/machinery/light{
	dir = 4
	},
/turf/open/floor/freezer,
/area/bigredv2/outside/virology)
"qa" = (
/obj/machinery/door/poddoor/timed_late/containment/landing_zone/lz2{
	dir = 2
	},
/turf/closed/wall/r_wall,
/area/bigredv2/outside/w)
"qM" = (
/turf/closed/wall/r_wall,
/area/bigredv2/outside/virology)
"qY" = (
/obj/structure/cable,
/turf/open/floor/marking/asteroidwarning{
	dir = 1
	},
/area/shuttle/drop2/lz2)
"rf" = (
/turf/open/floor/plating/ground/mars/dirttosand{
	dir = 1
	},
/area/shuttle/drop2/lz2)
"ri" = (
/obj/structure/prop/mainship/hangar_stencil/two,
/turf/open/floor/marking/asteroidwarning{
	dir = 10
	},
/area/shuttle/drop2/lz2)
"rw" = (
/obj/structure/window/framed/colony/reinforced,
/obj/machinery/door/poddoor/timed_late/containment/landing_zone/lz2,
/turf/open/floor/marking/asteroidwarning{
	dir = 5
	},
/area/shuttle/drop2/lz2)
"rN" = (
/turf/open/floor/marking/asteroidwarning{
	dir = 9
	},
/area/shuttle/drop2/lz2)
"sm" = (
/turf/open/space/basic,
/area/space)
"sY" = (
/atom/movable/effect/decal/cleanable/dirt,
/obj/machinery/door/poddoor/timed_late/containment/landing_zone/lz2,
/turf/open/floor/asteroidfloor,
/area/bigredv2/outside/w)
"sZ" = (
/turf/open/floor/marking/asteroidwarning{
	dir = 1
	},
/area/shuttle/drop2/lz2)
"tr" = (
/atom/movable/effect/landmark/lv624/fog_blocker,
/turf/open/floor/plating/ground/mars/random/cave,
/area/bigredv2/caves/west)
"tR" = (
/turf/open/floor/plating,
/area/shuttle/drop2/lz2)
"tY" = (
/atom/movable/effect/ai_node,
/turf/open/floor/plating/ground/mars/random/sand,
/area/shuttle/drop2/lz2)
"ul" = (
/atom/movable/effect/decal/cleanable/dirt,
/obj/machinery/landinglight/ds2/delaythree{
	dir = 8
	},
/turf/open/floor/marking/asteroidwarning{
	dir = 8
	},
/area/shuttle/drop2/lz2)
"vJ" = (
/atom/movable/effect/decal/cleanable/dirt,
/turf/open/floor/marking/asteroidwarning{
	dir = 1
	},
/area/shuttle/drop2/lz2)
"vL" = (
/atom/movable/effect/attach_point/electronics/dropship1,
/turf/open/floor/plating,
/area/shuttle/drop2/lz2)
"wn" = (
/turf/open/floor/plating/ground/mars/random/cave/rock,
/area/bigredv2/caves/southwest)
"wE" = (
/obj/structure/cable,
/turf/open/floor/marking/asteroidwarning{
	dir = 5
	},
/area/shuttle/drop2/lz2)
"wR" = (
/obj/structure/cable,
/turf/open/floor/marking/asteroidwarning{
	dir = 4
	},
/area/shuttle/drop2/lz2)
"xp" = (
/atom/movable/effect/decal/cleanable/dirt,
/obj/machinery/landinglight/ds2/delayone,
/turf/open/floor/marking/asteroidwarning,
/area/shuttle/drop2/lz2)
"yh" = (
/turf/open/floor/plating/icefloor/warnplate{
	dir = 9
	},
/area/shuttle/drop2/lz2)
"ym" = (
/obj/machinery/landinglight/ds2/delayone{
	dir = 8
	},
/turf/open/floor/marking/asteroidwarning{
	dir = 8
	},
/area/shuttle/drop2/lz2)
"yu" = (
/atom/movable/effect/ai_node,
/turf/open/floor/plating/ground/mars/random/cave,
/area/bigredv2/caves/west)
"yQ" = (
/obj/machinery/door/poddoor/timed_late/containment/landing_zone/lz2,
/turf/closed/mineral/smooth/bigred,
/area/bigredv2/outside/w)
"yR" = (
/turf/open/floor/marking/asteroidwarning{
	dir = 6
	},
/area/shuttle/drop2/lz2)
"ze" = (
/obj/item/stack/sheet/metal,
/turf/open/floor/plating/ground/mars/random/sand,
/area/shuttle/drop2/lz2)
"zk" = (
/atom/movable/effect/decal/cleanable/dirt,
/turf/open/floor/asteroidfloor,
/area/shuttle/drop2/lz2)
"zl" = (
/obj/machinery/button/door/open_only/landing_zone/lz2{
	dir = 8
	},
/obj/structure/window/reinforced,
/obj/structure/window/reinforced{
	dir = 1
	},
/obj/structure/window/reinforced{
	dir = 8
	},
/turf/open/floor/plating/ground/mars/random/dirt,
/area/shuttle/drop2/lz2)
"zI" = (
/atom/movable/effect/ai_node,
/turf/open/floor/asteroidfloor,
/area/shuttle/drop2/lz2)
"Aa" = (
/turf/open/floor/plating/ground/mars/dirttosand{
	dir = 8
	},
/area/shuttle/drop2/lz2)
"AD" = (
/obj/machinery/door/airlock/multi_tile/mainship/generic{
	dir = 1;
	name = "\improper Engineering Complex"
	},
/obj/machinery/door/poddoor/timed_late/containment/landing_zone/lz2,
/turf/open/floor/asteroidfloor,
/area/shuttle/drop2/lz2)
"AW" = (
/obj/machinery/landinglight/ds2/delaytwo{
	dir = 4
	},
/turf/open/floor/marking/asteroidwarning{
	dir = 4
	},
/area/shuttle/drop2/lz2)
"BT" = (
/turf/open/floor/asteroidfloor,
/area/shuttle/drop2/lz2)
"CK" = (
/obj/structure/cable,
/obj/machinery/door/airlock/multi_tile/mainship/generic{
	dir = 1;
	name = "\improper Engineering Complex"
	},
/turf/open/floor,
/area/bigredv2/outside/engineering)
"CN" = (
/obj/machinery/door/poddoor/timed_late/containment/landing_zone/lz2{
	dir = 2
	},
/turf/open/floor/plating/ground/mars/random/dirt,
/area/bigredv2/outside/w)
"DJ" = (
/obj/structure/cable,
/obj/machinery/door/poddoor/timed_late/containment/landing_zone/lz2,
/turf/open/floor,
/area/bigredv2/outside/cargo)
"DY" = (
/obj/structure/cable,
/turf/open/floor,
/area/bigredv2/outside/cargo)
"Eh" = (
/turf/open/floor/marking/asteroidwarning{
	dir = 4
	},
/area/shuttle/drop2/lz2)
"EN" = (
/obj/machinery/door/poddoor/shutters/mainship{
	dir = 2;
	id = "Engineering";
	name = "\improper Engineering Shutters"
	},
/obj/machinery/door/poddoor/timed_late/containment/landing_zone/lz2,
/turf/open/floor/plating,
/area/bigredv2/outside/engineering)
"ES" = (
/atom/movable/effect/decal/cleanable/dirt,
/turf/open/floor/marking/asteroidwarning,
/area/shuttle/drop2/lz2)
"EV" = (
/atom/movable/effect/decal/cleanable/dirt,
/obj/machinery/landinglight/ds2/delaythree,
/turf/open/floor/marking/asteroidwarning,
/area/shuttle/drop2/lz2)
"EZ" = (
/atom/movable/effect/attach_point/weapon/dropship1,
/turf/open/floor/plating,
/area/shuttle/drop2/lz2)
"FR" = (
/atom/movable/effect/landmark/weed_node,
/turf/open/floor/plating/ground/mars/random/cave,
/area/bigredv2/caves/west)
"Gx" = (
/obj/machinery/door/poddoor/timed_late/containment/landing_zone/lz2,
/turf/open/floor,
/area/bigredv2/outside/cargo)
"GA" = (
/obj/machinery/landinglight/ds2/delayone{
	dir = 1
	},
/turf/open/floor/marking/asteroidwarning{
	dir = 1
	},
/area/shuttle/drop2/lz2)
"GB" = (
/obj/machinery/door/poddoor/timed_late/containment/landing_zone/lz2{
	dir = 2
	},
/turf/closed/mineral/smooth/bigred,
/area/bigredv2/caves/west)
"GC" = (
/atom/movable/effect/ai_node,
/atom/movable/effect/landmark/weed_node,
/turf/open/floor/plating/ground/mars/random/cave,
/area/bigredv2/caves/west)
"GZ" = (
/turf/open/floor/plating/ground/mars/dirttosand{
	dir = 9
	},
/area/shuttle/drop2/lz2)
"Hl" = (
/obj/structure/cable,
/obj/machinery/button/door/open_only/landing_zone/lz2{
	dir = 8
	},
/turf/open/floor/marking/asteroidwarning{
	dir = 4
	},
/area/shuttle/drop2/lz2)
"HG" = (
/turf/open/floor/plating/icefloor/warnplate{
	dir = 10
	},
/area/shuttle/drop2/lz2)
"Id" = (
/obj/machinery/door/poddoor/timed_late/containment/landing_zone/lz2,
/turf/closed/wall/r_wall,
/area/bigredv2/outside/w)
"IQ" = (
/turf/open/floor/plating/ground/mars/random/cave,
/area/bigredv2/caves/southwest)
"Jk" = (
/obj/machinery/door/poddoor/timed_late/containment/landing_zone/lz2,
/turf/open/floor/plating/ground/mars/random/dirt,
/area/bigredv2/outside/w)
"Jq" = (
/obj/machinery/landinglight/ds2/delaythree{
	dir = 4
	},
/turf/open/floor/marking/asteroidwarning{
	dir = 4
	},
/area/shuttle/drop2/lz2)
"Kd" = (
/obj/machinery/camera/autoname/lz_camera,
/turf/open/floor/plating/icefloor/warnplate{
	dir = 4
	},
/area/shuttle/drop2/lz2)
"Kk" = (
/obj/machinery/door/airlock/mainship/research/glass/free_access{
	name = "\improper Virology Lab Cell"
	},
/turf/open/floor/freezer,
/area/bigredv2/outside/virology)
"KX" = (
/obj/machinery/landinglight/ds2{
	dir = 1
	},
/turf/open/floor/marking/asteroidwarning{
	dir = 1
	},
/area/shuttle/drop2/lz2)
"Lb" = (
/obj/machinery/floodlight/landing,
/turf/open/floor/marking/asteroidwarning{
	dir = 9
	},
/area/shuttle/drop2/lz2)
"LR" = (
/atom/movable/effect/ai_node,
/turf/open/floor/plating/ground/mars/random/dirt,
/area/shuttle/drop2/lz2)
"LT" = (
/obj/machinery/door/poddoor/timed_late/containment/landing_zone/lz2,
/turf/closed/wall/r_wall,
/area/shuttle/drop2/lz2)
"LY" = (
/obj/structure/window/framed/colony/reinforced,
/obj/machinery/door/poddoor/timed_late/containment/landing_zone/lz2,
/turf/open/floor/marking/asteroidwarning{
	dir = 6
	},
/area/shuttle/drop2/lz2)
"Mh" = (
/obj/machinery/door/poddoor/timed_late/containment/landing_zone/lz2,
/turf/closed/wall,
/area/bigredv2/outside/cargo)
"Mi" = (
/turf/open/floor/freezer,
/area/bigredv2/outside/virology)
"MH" = (
/obj/machinery/camera/autoname/lz_camera,
/turf/open/floor/plating/icefloor/warnplate{
	dir = 8
	},
/area/shuttle/drop2/lz2)
"MM" = (
/obj/machinery/landinglight/ds2/delaytwo{
	dir = 8
	},
/obj/structure/prop/mainship/hangar_stencil/two,
/turf/open/floor/marking/asteroidwarning{
	dir = 10
	},
/area/shuttle/drop2/lz2)
"MO" = (
/turf/open/floor/marking/asteroidwarning,
/area/shuttle/drop2/lz2)
"Nb" = (
/obj/structure/cable,
/turf/open/floor/asteroidfloor,
/area/shuttle/drop2/lz2)
"Nd" = (
/obj/machinery/door/poddoor/timed_late/containment/landing_zone/lz2,
/turf/open/floor/marking/asteroidwarning{
	dir = 1
	},
/area/bigredv2/outside/w)
"Ng" = (
/turf/closed/mineral/smooth/bigred,
/area/bigredv2/caves/rock)
"Nu" = (
/turf/open/floor/plating/icefloor/warnplate{
	dir = 6
	},
/area/shuttle/drop2/lz2)
"Nx" = (
/obj/structure/table/reinforced,
/obj/machinery/computer/shuttle/shuttle_control/dropship/two,
/turf/open/floor/marking/asteroidwarning{
	dir = 4
	},
/area/lv624/lazarus/console)
"NM" = (
/turf/open/floor/plating/ground/mars/random/cave/rock,
/area/bigredv2/caves/west)
"NX" = (
/turf/open/floor/plating/icefloor/warnplate{
	dir = 4
	},
/area/shuttle/drop2/lz2)
"Og" = (
/obj/structure/cable,
/obj/machinery/door/poddoor/timed_late/containment/landing_zone/lz2,
/turf/open/floor/marking/asteroidwarning{
	dir = 1
	},
/area/bigredv2/outside/sw)
"Ou" = (
/obj/machinery/landinglight/ds2/delayone{
	dir = 4
	},
/atom/movable/effect/ai_node,
/turf/open/floor/marking/asteroidwarning{
	dir = 4
	},
/area/shuttle/drop2/lz2)
"OQ" = (
/atom/movable/effect/decal/cleanable/dirt,
/obj/structure/cable,
/atom/movable/effect/ai_node,
/turf/open/floor/marking/asteroidwarning{
	dir = 4
	},
/area/shuttle/drop2/lz2)
"OW" = (
/obj/structure/table,
/atom/movable/effect/spawner/random/technology_scanner,
/obj/machinery/door/poddoor/timed_late/containment/landing_zone/lz2,
/turf/open/floor,
/area/bigredv2/outside/cargo)
"Pc" = (
/turf/open/floor/plating/icefloor/warnplate,
/area/shuttle/drop2/lz2)
"Qt" = (
/obj/machinery/landinglight/ds2,
/turf/open/floor/marking/asteroidwarning,
/area/shuttle/drop2/lz2)
"QV" = (
/obj/machinery/landinglight/ds2/delayone,
/turf/open/floor/marking/asteroidwarning,
/area/shuttle/drop2/lz2)
"RF" = (
/obj/machinery/landinglight/ds2/delaytwo{
	dir = 8
	},
/turf/open/floor/marking/asteroidwarning{
	dir = 8
	},
/area/shuttle/drop2/lz2)
"RR" = (
/obj/machinery/landinglight/ds2/delaytwo{
	dir = 1
	},
/turf/open/floor/marking/asteroidwarning{
	dir = 1
	},
/area/shuttle/drop2/lz2)
"RW" = (
/turf/open/floor/marking/asteroidwarning{
	dir = 10
	},
/area/shuttle/drop2/lz2)
"Sc" = (
/obj/machinery/landinglight/ds2{
	dir = 4
	},
/turf/open/floor/marking/asteroidwarning{
	dir = 4
	},
/area/shuttle/drop2/lz2)
"Sg" = (
/obj/structure/cable,
/obj/machinery/door/poddoor/timed_late/containment/landing_zone/lz2,
/turf/open/floor,
/area/bigredv2/outside/engineering)
"Sp" = (
/obj/machinery/door/poddoor/timed_late/containment/landing_zone/lz2{
	dir = 2
	},
/turf/closed/mineral/smooth/bigred,
/area/bigredv2/outside/sw)
"SF" = (
/atom/movable/effect/decal/cleanable/dirt,
/obj/machinery/landinglight/ds2{
	dir = 8
	},
/turf/open/floor/marking/asteroidwarning{
	dir = 8
	},
/area/shuttle/drop2/lz2)
"Ti" = (
/turf/open/floor/plating/icefloor/warnplate{
	dir = 5
	},
/area/shuttle/drop2/lz2)
"Tx" = (
/turf/closed/wall/r_wall,
/area/shuttle/drop2/lz2)
"TZ" = (
/turf/closed/mineral/smooth/bigred/indestructible,
/area/space)
"Ua" = (
/obj/structure/table,
/atom/movable/effect/spawner/random/tool,
/obj/machinery/door/poddoor/timed_late/containment/landing_zone/lz2,
/turf/open/floor,
/area/bigredv2/outside/cargo)
"Uj" = (
/obj/docking_port/stationary/marine_dropship/lz2,
/turf/open/floor/plating,
/area/shuttle/drop2/lz2)
"UA" = (
/obj/machinery/door/poddoor/timed_late/containment/landing_zone/lz2,
/turf/open/floor/plating/ground/mars/random/dirt,
/area/bigredv2/outside/sw)
"UF" = (
/obj/machinery/landinglight/ds2/delayone{
	dir = 4
	},
/turf/open/floor/marking/asteroidwarning{
	dir = 4
	},
/area/shuttle/drop2/lz2)
"UJ" = (
/atom/movable/effect/landmark/weed_node,
/turf/open/floor/tile/white,
/area/bigredv2/outside/virology)
"UT" = (
/atom/movable/effect/ai_node,
/turf/open/floor/marking/asteroidwarning{
	dir = 1
	},
/area/shuttle/drop2/lz2)
"VC" = (
/atom/movable/effect/ai_node,
/turf/open/floor/plating/ground/mars/random/cave/rock,
/area/bigredv2/caves/southwest)
"VI" = (
/turf/open/floor/tile/white,
/area/bigredv2/outside/virology)
"Wq" = (
/obj/machinery/power/apc/drained{
	dir = 8
	},
/obj/structure/cable,
/turf/open/floor/marking/asteroidwarning{
	dir = 4
	},
/area/shuttle/drop2/lz2)
"Wv" = (
/obj/machinery/door/poddoor/timed_late/containment/landing_zone/lz2,
/turf/closed/mineral/smooth/bigred,
/area/bigredv2/outside/sw)
"Xm" = (
/obj/machinery/door/poddoor/timed_late/containment/landing_zone/lz2{
	dir = 2
	},
/turf/open/floor/marking/asteroidwarning{
	dir = 8
	},
/area/bigredv2/outside/w)
"Xs" = (
/obj/structure/table,
/obj/machinery/door/poddoor/timed_late/containment/landing_zone/lz2,
/turf/open/floor,
/area/bigredv2/outside/cargo)
"Yb" = (
/obj/machinery/door/poddoor/timed_late/containment/landing_zone/lz2,
/turf/open/floor,
/area/bigredv2/outside/engineering)
"Yh" = (
/turf/open/floor/plating/ground/mars/random/cave,
/area/shuttle/drop2/lz2)
"Yx" = (
/obj/machinery/landinglight/ds2/delaythree{
	dir = 4
	},
/atom/movable/effect/ai_node,
/turf/open/floor/marking/asteroidwarning{
	dir = 4
	},
/area/shuttle/drop2/lz2)
"YN" = (
/turf/open/floor,
/area/bigredv2/outside/engineering)
"Zi" = (
/turf/closed/mineral/smooth/bigred,
/area/shuttle/drop2/lz2)
"ZF" = (
/atom/movable/effect/decal/cleanable/dirt,
/obj/structure/cable,
/obj/machinery/door/poddoor/timed_late/containment/landing_zone/lz2{
	dir = 2
	},
/turf/open/floor/marking/asteroidwarning{
	dir = 4
	},
/area/bigredv2/outside/w)

(1,1,1) = {"
TZ
TZ
TZ
TZ
TZ
TZ
TZ
TZ
TZ
TZ
TZ
TZ
TZ
TZ
TZ
TZ
TZ
TZ
TZ
TZ
TZ
TZ
sm
sm
sm
sm
sm
sm
sm
sm
sm
sm
sm
sm
sm
sm
sm
sm
"}
(2,1,1) = {"
Ng
Ng
Ng
Ng
mq
Ng
Ng
Ng
Ng
Ng
Ng
Ng
Ng
Ng
Ng
Ng
Ng
Ng
Ng
Ng
Ng
TZ
sm
sm
sm
sm
sm
sm
sm
sm
sm
sm
sm
sm
sm
sm
sm
sm
"}
(3,1,1) = {"
Ng
Ng
Ng
Ng
mq
Ng
Ng
Ng
Ng
Ng
Ng
Ng
Ng
Ng
Ng
Ng
Ng
Ng
Ng
Ng
Ng
TZ
TZ
TZ
TZ
TZ
TZ
TZ
TZ
TZ
TZ
TZ
TZ
TZ
TZ
TZ
TZ
TZ
"}
(4,1,1) = {"
Ng
Ng
Ng
Ng
mq
Ng
Ng
Ng
Ng
Ng
Ng
Ng
Ng
Ng
Ng
Ng
Ng
Ng
Ng
Ng
Ng
Ng
Ng
Ng
Ng
Ng
Ng
Ng
Ng
Ng
Ng
Ng
Ng
Ng
Ng
Ng
Ng
Ng
"}
(5,1,1) = {"
nJ
Ng
NM
NM
mq
NM
al
NM
NM
NM
al
NM
NM
NM
NM
Ng
Ng
Ng
Ng
Ng
Ng
Ng
Ng
Ng
Ng
Ng
Ng
Ng
Ng
Ng
Ng
Ng
Ng
Ng
Ng
Ng
Ng
Ng
"}
(6,1,1) = {"
nJ
NM
nJ
nJ
ey
nJ
nJ
nJ
FR
nJ
nJ
nJ
nJ
nJ
nJ
NM
Ng
Ng
Ng
Ng
Ng
Ng
Ng
Ng
Ng
Ng
Ng
Ng
Ng
Ng
Ng
Ng
Ng
Ng
Ng
Ng
Ng
Ng
"}
(7,1,1) = {"
nJ
nJ
FR
yu
nJ
tr
nJ
nJ
nJ
nJ
nJ
yu
nJ
nJ
FR
nJ
NM
NM
fW
wn
wn
wn
wn
Ng
Ng
Ng
Ng
Ng
Ng
Ng
Ng
Ng
Ng
Ng
Ng
Ng
Ng
Ng
"}
(8,1,1) = {"
nJ
FR
nJ
nJ
nJ
tr
nJ
FR
nJ
nJ
nJ
nJ
FR
nJ
nJ
nJ
nJ
nJ
nJ
IQ
mi
IQ
IQ
wn
wn
wn
Ng
Ng
Ng
Ng
Ng
Ng
Ng
Ng
Ng
Ng
Ng
Ng
"}
(9,1,1) = {"
nJ
nJ
NM
nJ
nJ
nJ
tr
nJ
nJ
nJ
NM
nJ
nJ
nJ
nJ
nJ
nJ
FR
nJ
IQ
IQ
IQ
IQ
IQ
IQ
wn
Ng
Ng
Ng
Ng
Ng
Ng
Ng
Ng
Ng
Ng
Ng
Ng
"}
(10,1,1) = {"
nJ
NM
nJ
nJ
FR
nJ
tr
nJ
nJ
Ng
Ng
Ng
nJ
Ng
Ng
Ng
Ng
NM
yu
IQ
IQ
mi
IQ
IQ
IQ
IQ
IQ
gF
IQ
IQ
IQ
Ng
Ng
Ng
Ng
Ng
Ng
Ng
"}
(11,1,1) = {"
nJ
NM
nJ
yu
nJ
yu
nJ
tr
mq
mq
mq
Ng
Ng
Ng
Ng
Ng
Ng
Ng
Ng
Ng
Ng
Ng
wn
IQ
IQ
mi
IQ
wn
fT
wn
IQ
IQ
IQ
IQ
IQ
Ng
Ng
Ng
"}
(12,1,1) = {"
FR
NM
nJ
nJ
nJ
nJ
nJ
FR
nJ
Ng
Ng
mq
Ng
Ng
Ng
Ng
Ng
Ng
Ng
Ng
Ng
Ng
Ng
IQ
IQ
IQ
IQ
IQ
IQ
IQ
IQ
IQ
fT
wn
IQ
mi
IQ
IQ
"}
(13,1,1) = {"
NM
Ng
Ng
Ng
nJ
nJ
nJ
nJ
nJ
nJ
Ng
mq
Ng
Ng
Ng
Ng
FR
nJ
Ng
Ng
IQ
IQ
IQ
IQ
IQ
IQ
IQ
IQ
IQ
IQ
IQ
mi
mi
IQ
IQ
IQ
IQ
wn
"}
(14,1,1) = {"
Ng
Ng
Ng
Ng
Ng
nJ
nJ
nJ
nJ
nJ
nJ
mq
Ng
Ng
nJ
nJ
nJ
nJ
Ng
IQ
IQ
wn
wn
mi
IQ
IQ
IQ
mi
IQ
IQ
IQ
IQ
IQ
IQ
IQ
IQ
IQ
IQ
"}
(15,1,1) = {"
Ng
Ng
Ng
Ng
Ng
yu
FR
nJ
nJ
nJ
GC
tr
nJ
nJ
nJ
nJ
nJ
nJ
yu
IQ
mi
IQ
IQ
IQ
IQ
IQ
IQ
VC
IQ
IQ
IQ
IQ
IQ
IQ
mi
IQ
gF
IQ
"}
(16,1,1) = {"
Ng
Ng
Ng
nJ
nJ
nJ
nJ
nJ
nJ
nJ
nJ
tr
nJ
nJ
nJ
nJ
nJ
nJ
nJ
wn
IQ
IQ
mi
IQ
IQ
IQ
wn
Ng
Ng
Ng
Ng
Ng
wn
IQ
IQ
IQ
mi
IQ
"}
(17,1,1) = {"
Ng
Ng
Ng
nJ
nJ
nJ
nJ
nJ
nJ
nJ
Ng
mq
nJ
NM
FR
nJ
nJ
nJ
nJ
mi
IQ
IQ
wn
Ng
Ng
Ng
Ng
Ng
Ng
Ng
Ng
Ng
Ng
Ng
Ng
IQ
IQ
IQ
"}
(18,1,1) = {"
Ng
Ng
Ng
nb
rN
kH
kH
RW
nb
Ng
Ng
Ng
mq
ey
tr
ey
ey
ey
tr
IQ
IQ
IQ
wn
Ng
Ng
Ng
Ng
Ng
Ng
Ng
Ng
Ng
Ng
Ng
Ng
wn
IQ
IQ
"}
(19,1,1) = {"
Ng
Ng
Ng
Yh
sZ
BT
BT
MO
Yh
Ng
Ng
Ng
Ng
Ng
Ng
Ng
Ng
Ng
Ng
mq
Ng
Ng
Ng
Ng
Ng
Ng
Ng
Ng
Ng
Ng
Ng
Ng
Ng
Ng
Ng
Ng
Ng
Ng
"}
(20,1,1) = {"
qM
Ng
Ng
am
rw
db
AD
LY
LT
LT
LT
LT
LT
LT
LT
LT
LT
LT
LT
GB
mq
Ng
Ng
Ng
Ng
Ng
Ng
Ng
Ng
Ng
Ng
Ng
Ng
Ng
Ng
Ng
Ng
Ng
"}
(21,1,1) = {"
qM
Ng
Ng
am
mU
sZ
MO
fz
fz
fz
fz
fz
fz
fz
fz
fz
fz
fz
Zi
GB
Ng
mq
mq
mq
mq
mq
mq
mq
mq
mq
mq
mq
mq
mq
mq
mq
Ng
Ng
"}
(22,1,1) = {"
qM
Ng
Ng
am
mU
UT
MO
fz
fz
ze
fz
fz
fz
fz
fz
tY
fz
fz
Zi
GB
Wv
Wv
Wv
Wv
Wv
Wv
Wv
Wv
Wv
Wv
Wv
Wv
Wv
Wv
Wv
Ng
mq
Ng
"}
(23,1,1) = {"
qM
Ng
Ng
am
mU
sZ
MO
fz
fz
fz
fz
fz
fz
GZ
aX
fz
fz
fz
Zi
Zi
Zi
Zi
Zi
Zi
Zi
Zi
Zi
Zi
Zi
Zi
Zi
Zi
Zi
Zi
Sp
Ng
Ng
mq
"}
(24,1,1) = {"
qM
Ng
Ng
am
mU
sZ
MO
fz
GZ
aX
fz
GZ
Aa
mU
mU
Aa
Aa
Aa
mU
mU
mU
mU
mU
mU
mU
mU
kM
fz
fz
rf
mU
kM
fz
Zi
Sp
Wv
Wv
Wv
"}
(25,1,1) = {"
qM
qM
Ng
am
mU
sZ
MO
fz
mU
rN
rN
kH
ri
kH
kH
kH
kH
kH
kH
kH
mS
kH
kH
kH
kH
kH
kH
kH
kH
kH
kH
kH
kH
Zi
Zi
Zi
Zi
Sp
"}
(26,1,1) = {"
VI
qM
Ng
am
mU
sZ
MO
fz
mU
sZ
sZ
BT
MO
BT
BT
BT
BT
BT
BT
BT
BT
BT
BT
BT
BT
BT
BT
BT
BT
BT
BT
BT
BT
BT
BT
BT
Zi
Sp
"}
(27,1,1) = {"
UJ
qM
Ng
am
mU
sZ
MO
fz
mU
sZ
aP
Jq
mf
UF
AW
Yx
Sc
UF
AW
Jq
Sc
UF
AW
Jq
Sc
Ou
AW
Jq
Sc
UF
AW
Yx
mS
BT
BT
BT
Zi
Sp
"}
(28,1,1) = {"
VI
qM
Ng
am
mU
sZ
MO
fz
mU
sZ
kW
yh
hO
hO
hO
hO
hO
hO
kC
hO
hO
MH
hO
hO
hO
hO
hO
hO
hO
hO
hO
HG
KX
BT
BT
BT
Zi
Sp
"}
(29,1,1) = {"
Kk
qM
Ng
am
mU
sZ
BT
kH
RW
sZ
QV
it
tR
gW
EZ
tR
tR
tR
tR
tR
tR
tR
tR
tR
tR
tR
tR
tR
tR
gW
tR
Pc
GA
BT
BT
BT
Zi
Sp
"}
(30,1,1) = {"
Mi
qM
Ng
am
mU
UT
BT
Eh
yR
sZ
Qt
it
tR
tR
vL
tR
tR
tR
tR
tR
tR
tR
tR
tR
tR
tR
tR
tR
tR
tR
tR
Pc
RR
BT
BT
BT
Zi
Sp
"}
(31,1,1) = {"
Mi
qM
Ng
am
mU
sZ
MO
fz
mU
sZ
nq
it
tR
tR
tR
tR
tR
tR
tR
tR
tR
tR
tR
tR
tR
tR
tR
tR
tR
tR
tR
Pc
eg
BT
BT
BT
Zi
Sp
"}
(32,1,1) = {"
pu
qM
Ng
am
mU
sZ
MO
fz
rf
sZ
kW
it
tR
tR
tR
tR
tR
tR
tR
tR
tR
tR
tR
tR
tR
tR
tR
tR
tR
tR
tR
Pc
KX
BT
BT
BT
Zi
Sp
"}
(33,1,1) = {"
qa
Id
Id
am
mU
sZ
MO
fz
mU
sZ
xp
it
tR
tR
tR
tR
tR
tR
tR
tR
tR
Uj
tR
tR
tR
tR
tR
tR
tR
tR
tR
Pc
GA
BT
BT
BT
Zi
Sp
"}
(34,1,1) = {"
CN
mU
mU
mU
mU
sZ
MO
Aa
mU
sZ
Qt
it
tR
tR
tR
tR
tR
tR
tR
tR
tR
tR
tR
tR
tR
tR
tR
tR
tR
tR
tR
Pc
RR
BT
BT
BT
Zi
Sp
"}
(35,1,1) = {"
CN
rN
bV
bV
kH
BT
BT
kH
kH
sZ
EV
it
tR
tR
tR
tR
tR
tR
tR
tR
tR
tR
tR
tR
tR
tR
tR
tR
tR
tR
tR
Pc
eg
BT
BT
BT
Zi
Sp
"}
(36,1,1) = {"
Xm
sZ
zk
BT
BT
zk
zk
BT
BT
sZ
kW
it
tR
tR
vL
tR
tR
tR
tR
tR
tR
tR
tR
tR
tR
tR
tR
tR
tR
tR
tR
Pc
KX
BT
BT
BT
Zi
Sp
"}
(37,1,1) = {"
ZF
qY
Nb
Nb
Nb
OQ
wR
wR
wR
qY
QV
it
tR
gW
EZ
tR
tR
tR
tR
tR
tR
tR
tR
tR
tR
tR
tR
tR
tR
gW
tR
Pc
GA
BT
BT
BT
Zi
Sp
"}
(38,1,1) = {"
CN
sZ
BT
BT
ES
mU
mU
mU
mU
qY
Qt
Ti
NX
NX
NX
NX
NX
NX
NX
NX
NX
Kd
NX
NX
NX
NX
NX
NX
NX
NX
NX
Nu
RR
BT
BT
BT
Zi
Sp
"}
(39,1,1) = {"
CN
vJ
BT
zk
ES
mU
mU
mU
mU
qY
Lb
cI
MM
ym
SF
ul
RF
ym
ol
cI
RF
ym
ol
cI
RF
ym
ol
cI
RF
ym
ol
cI
Lb
kH
ri
BT
Zi
Sp
"}
(40,1,1) = {"
CN
vJ
BT
zk
ES
LR
mU
mU
mU
qY
sZ
BT
MO
BT
BT
zI
BT
BT
BT
BT
BT
BT
BT
BT
BT
zI
BT
BT
BT
BT
BT
zI
sZ
BT
MO
BT
Zi
Sp
"}
(41,1,1) = {"
CN
vJ
BT
zk
MO
mU
mU
mU
zl
qY
wE
cW
dU
BT
BT
BT
BT
BT
BT
BT
mS
Nx
Wq
wR
wR
wR
Hl
wR
wR
wR
Eh
Eh
mo
Eh
yR
Eh
Zi
Sp
"}
(42,1,1) = {"
CN
sZ
BT
zk
MO
Tx
Tx
Tx
dx
dx
dx
DY
av
dx
lJ
lJ
lJ
lJ
lJ
dx
Tx
Tx
Tx
Tx
YN
CK
Tx
mU
mU
qY
MO
mU
mU
Zi
Zi
Zi
Zi
Sp
"}
(43,1,1) = {"
CN
Nd
jz
sY
bS
Jk
Jk
yQ
jR
OW
OW
DJ
Gx
Gx
Gx
dJ
Ua
Ua
Xs
Mh
Wv
Wv
Wv
EN
Yb
Sg
gQ
UA
UA
Og
eh
UA
UA
Wv
Wv
Wv
Wv
Wv
"}
