//MAP CONVERTED BY dmm2tgm.py THIS HEADER COMMENT PREVENTS RECONVERSION, DO NOT REMOVE
"c" = (
/turf/open/floor/plating/ground/mars/random/cave,
/area/bigredv2/caves/southwest)
"f" = (
/atom/movable/effect/landmark/weed_node,
/turf/open/floor/plating/ground/mars/random/cave/rock,
/area/bigredv2/caves/south)
"j" = (
/atom/movable/effect/ai_node,
/turf/open/floor/plating/ground/mars/random/cave/rock,
/area/bigredv2/caves/southwest)
"k" = (
/turf/open/floor/plating,
/area/bigredv2/caves/south)
"m" = (
/atom/movable/effect/landmark/lv624/fog_blocker,
/atom/movable/effect/landmark/weed_node,
/turf/open/floor/plating/ground/mars/random/cave/rock,
/area/bigredv2/caves/southwest)
"q" = (
/turf/open/floor/plating/ground/mars/random/cave/rock,
/area/bigredv2/caves/south)
"t" = (
/turf/open/floor/plating/ground/mars/random/cave/rock,
/area/bigredv2/caves/southwest)
"u" = (
/atom/movable/effect/ai_node,
/turf/open/floor/plating/ground/mars/random/cave,
/area/bigredv2/caves/south)
"w" = (
/obj/machinery/miner/damaged/platinum,
/turf/open/floor/plating/ground/mars/random/cave,
/area/bigredv2/caves/south)
"x" = (
/atom/movable/effect/ai_node,
/turf/open/floor/plating/ground/mars/random/cave/rock,
/area/bigredv2/caves/south)
"y" = (
/atom/movable/effect/landmark/weed_node,
/turf/open/floor/plating/ground/mars/random/cave,
/area/bigredv2/caves/southwest)
"z" = (
/atom/movable/effect/landmark/lv624/fog_blocker,
/turf/open/floor/plating/ground/mars/random/cave,
/area/bigredv2/caves/south)
"E" = (
/atom/movable/effect/landmark/excavation_site_spawner,
/turf/open/floor/plating/ground/mars/random/cave,
/area/bigredv2/caves/south)
"G" = (
/turf/closed/mineral/smooth/bigred,
/area/bigredv2/caves/rock)
"H" = (
/atom/movable/effect/landmark/weed_node,
/turf/open/floor/plating/ground/mars/random/cave/rock,
/area/bigredv2/caves/southwest)
"I" = (
/turf/open/floor/plating/ground/mars/random/cave,
/area/bigredv2/caves/south)
"K" = (
/atom/movable/effect/landmark/lv624/fog_blocker,
/turf/open/floor/plating/ground/mars/random/cave,
/area/bigredv2/caves/southwest)
"N" = (
/atom/movable/effect/landmark/lv624/fog_blocker,
/turf/closed/mineral/smooth/bigred,
/area/bigredv2/caves/rock)
"O" = (
/atom/movable/effect/landmark/weed_node,
/turf/open/floor/plating/ground/mars/random/cave,
/area/bigredv2/caves/south)
"X" = (
/atom/movable/effect/ai_node,
/turf/open/floor/plating/ground/mars/random/cave,
/area/bigredv2/caves/southwest)
"Z" = (
/atom/movable/effect/landmark/weed_node,
/atom/movable/effect/ai_node,
/turf/open/floor/plating/ground/mars/random/cave,
/area/bigredv2/caves/south)

(1,1,1) = {"
N
G
G
G
G
G
t
c
c
c
t
G
G
G
G
c
y
G
G
G
G
G
"}
(2,1,1) = {"
K
G
G
G
G
G
G
c
X
y
t
G
G
G
G
c
c
c
G
G
G
G
"}
(3,1,1) = {"
K
G
G
G
G
G
G
c
c
c
t
G
G
G
t
c
c
G
G
G
G
G
"}
(4,1,1) = {"
K
G
G
G
G
G
c
c
y
c
t
G
G
G
t
c
y
G
G
G
G
G
"}
(5,1,1) = {"
K
t
G
G
G
G
c
c
c
c
c
G
G
t
c
c
c
G
G
G
G
G
"}
(6,1,1) = {"
K
t
G
G
t
t
c
y
c
c
c
G
G
c
y
X
G
G
G
G
G
G
"}
(7,1,1) = {"
K
y
t
j
c
c
c
c
X
c
G
G
G
c
X
G
G
G
G
G
G
G
"}
(8,1,1) = {"
K
c
c
t
c
c
c
c
c
G
G
G
c
y
c
G
G
G
G
G
G
G
"}
(9,1,1) = {"
K
H
c
c
y
c
c
G
G
G
G
G
c
c
c
G
G
G
G
G
G
G
"}
(10,1,1) = {"
m
c
c
X
G
G
G
G
G
G
G
G
c
c
c
G
G
c
G
G
G
G
"}
(11,1,1) = {"
K
c
c
G
G
G
G
G
G
G
G
G
c
y
c
c
c
c
G
G
G
G
"}
(12,1,1) = {"
c
K
c
G
G
G
G
G
G
G
G
G
c
c
c
c
y
c
G
G
G
G
"}
(13,1,1) = {"
c
c
K
N
G
G
G
G
G
G
G
G
c
c
y
c
c
G
G
G
G
G
"}
(14,1,1) = {"
c
c
G
G
N
G
G
G
G
G
G
G
c
c
c
c
G
G
G
G
G
G
"}
(15,1,1) = {"
c
c
G
G
G
N
G
G
G
G
G
G
G
c
c
t
G
G
G
G
G
G
"}
(16,1,1) = {"
c
c
G
G
G
G
N
G
G
G
G
G
G
c
X
t
t
G
G
G
G
G
"}
(17,1,1) = {"
c
c
G
G
G
G
N
G
G
G
G
G
G
c
H
t
G
G
G
G
G
G
"}
(18,1,1) = {"
y
X
G
G
G
G
N
G
G
G
G
G
G
c
c
c
G
G
G
G
G
G
"}
(19,1,1) = {"
c
c
c
G
G
G
N
G
G
G
G
G
c
c
c
c
c
G
G
G
G
G
"}
(20,1,1) = {"
t
c
c
c
G
G
N
G
G
G
c
c
c
c
y
t
y
G
G
G
G
G
"}
(21,1,1) = {"
t
c
c
c
G
G
N
G
G
G
c
c
c
c
c
t
c
G
G
G
G
G
"}
(22,1,1) = {"
y
c
c
c
y
G
N
G
G
G
y
c
c
c
c
G
G
G
G
G
G
G
"}
(23,1,1) = {"
c
c
c
c
c
G
N
G
G
G
c
c
y
c
c
G
G
G
G
G
G
G
"}
(24,1,1) = {"
c
c
c
c
c
G
N
G
G
G
c
c
c
c
c
G
G
G
G
G
G
G
"}
(25,1,1) = {"
c
c
c
c
c
G
N
G
G
G
G
t
y
c
X
c
G
G
G
G
G
G
"}
(26,1,1) = {"
O
I
I
I
O
G
N
G
G
G
G
I
I
q
I
E
G
G
G
G
G
G
"}
(27,1,1) = {"
I
u
I
I
I
I
N
G
G
G
G
G
I
I
I
O
I
G
G
G
G
G
"}
(28,1,1) = {"
q
I
u
I
I
I
z
u
G
G
G
G
G
I
I
I
I
I
I
G
G
G
"}
(29,1,1) = {"
q
O
I
I
I
I
z
I
I
G
G
G
G
I
u
f
I
u
I
I
G
G
"}
(30,1,1) = {"
I
I
I
I
O
G
z
I
I
I
G
G
G
G
I
I
I
I
O
I
I
G
"}
(31,1,1) = {"
I
I
O
I
G
G
N
I
I
I
G
G
G
G
G
I
I
I
I
I
I
G
"}
(32,1,1) = {"
I
I
I
G
G
G
N
I
I
I
G
G
G
G
G
I
I
O
I
I
I
I
"}
(33,1,1) = {"
I
I
G
G
G
G
N
u
I
I
u
G
G
G
G
I
I
I
I
I
O
I
"}
(34,1,1) = {"
q
I
G
G
G
G
N
G
I
I
I
I
G
G
G
I
I
u
I
I
u
I
"}
(35,1,1) = {"
q
I
G
G
G
G
N
G
I
I
I
I
I
G
I
I
I
I
I
I
q
I
"}
(36,1,1) = {"
q
I
G
G
G
G
N
I
I
I
I
I
I
I
I
I
I
I
I
O
I
I
"}
(37,1,1) = {"
I
I
G
G
G
G
N
u
I
I
u
I
I
I
I
I
I
u
I
I
I
I
"}
(38,1,1) = {"
I
u
I
G
G
G
z
I
I
I
G
I
I
I
I
I
I
O
I
I
I
I
"}
(39,1,1) = {"
I
I
O
G
G
I
z
I
I
G
G
G
I
I
I
I
I
I
I
I
I
I
"}
(40,1,1) = {"
I
u
I
I
I
I
z
u
G
G
G
G
G
I
O
I
I
I
w
I
Z
I
"}
(41,1,1) = {"
I
I
I
I
I
I
z
G
G
G
G
G
G
I
I
I
I
I
x
I
I
u
"}
(42,1,1) = {"
I
I
I
I
I
I
N
G
G
G
G
G
I
I
I
I
I
I
I
E
I
I
"}
(43,1,1) = {"
I
G
G
G
G
G
N
G
G
G
G
I
u
I
q
Z
I
I
u
f
G
G
"}
(44,1,1) = {"
G
G
G
G
G
G
N
G
G
G
G
G
I
q
k
I
I
x
G
G
G
G
"}
