//MAP CONVERTED BY dmm2tgm.py THIS HEADER COMMENT PREVENTS RECONVERSION, DO NOT REMOVE
"a" = (
/turf/closed/mineral/bigred,
/area/bigredv2/caves/rock)
"b" = (
/obj/effect/landmark/start/job/xenomorph,
/obj/effect/landmark/weed_node,
/turf/open/floor/plating/ground/mars/random/cave,
/area/bigredv2/caves/east)
"d" = (
/obj/effect/ai_node,
/turf/open/floor/plating/ground/mars/random/cave/rock,
/area/bigredv2/caves/east)
"l" = (
/turf/open/floor/plating/ground/mars/random/cave/rock,
/area/bigredv2/caves/east)
"r" = (
/obj/effect/landmark/weed_node,
/turf/open/floor/plating/ground/mars/random/cave,
/area/bigredv2/caves/northeast)
"s" = (
/turf/open/floor/plating/ground/mars/random/cave,
/area/bigredv2/caves/east)
"B" = (
/obj/effect/landmark/lv624/fog_blocker,
/turf/open/floor/plating/ground/mars/random/cave,
/area/bigredv2/caves/east)
"D" = (
/obj/effect/landmark/weed_node,
/turf/open/floor/plating/ground/mars/random/cave,
/area/bigredv2/caves/east)
"L" = (
/obj/effect/landmark/lv624/fog_blocker,
/obj/effect/ai_node,
/turf/open/floor/plating/ground/mars/random/cave,
/area/bigredv2/caves/east)
"O" = (
/obj/effect/ai_node,
/turf/open/floor/plating/ground/mars/random/cave,
/area/bigredv2/caves/east)
"Q" = (
/turf/open/floor/plating/ground/mars/random/cave,
/area/bigredv2/caves/northeast)
"T" = (
/obj/effect/ai_node,
/turf/open/floor/plating/ground/mars/random/cave/rock,
/area/bigredv2/caves/northeast)
"V" = (
/obj/effect/landmark/lv624/fog_blocker,
/turf/closed/mineral/bigred,
/area/bigredv2/caves/rock)
"W" = (
/obj/effect/ai_node,
/turf/open/floor/plating/ground/mars/random/cave,
/area/bigredv2/caves/northeast)

(1,1,1) = {"
a
a
a
a
a
a
a
a
a
a
a
"}
(2,1,1) = {"
a
a
a
a
a
a
a
a
a
a
a
"}
(3,1,1) = {"
a
a
a
a
a
a
a
a
a
a
a
"}
(4,1,1) = {"
a
a
a
a
a
a
a
a
a
a
a
"}
(5,1,1) = {"
T
a
a
a
a
a
a
a
a
a
a
"}
(6,1,1) = {"
Q
a
a
a
a
a
a
a
a
a
a
"}
(7,1,1) = {"
Q
s
a
a
a
a
a
a
a
l
l
"}
(8,1,1) = {"
Q
D
s
a
a
a
a
a
s
D
B
"}
(9,1,1) = {"
Q
s
s
a
a
a
D
s
s
B
O
"}
(10,1,1) = {"
W
s
D
s
O
s
s
d
s
L
s
"}
(11,1,1) = {"
r
s
D
s
s
s
s
B
B
s
b
"}
(12,1,1) = {"
Q
s
s
s
D
s
B
l
s
s
O
"}
(13,1,1) = {"
W
D
s
s
s
B
s
s
s
a
a
"}
(14,1,1) = {"
a
s
s
s
D
B
s
D
s
a
a
"}
(15,1,1) = {"
a
a
a
s
O
B
s
O
a
a
a
"}
(16,1,1) = {"
a
a
a
a
s
B
s
a
a
a
a
"}
(17,1,1) = {"
a
a
a
a
a
V
a
a
a
a
a
"}
(18,1,1) = {"
a
a
a
a
a
V
a
a
a
a
a
"}
(19,1,1) = {"
a
a
a
a
a
V
a
a
a
a
a
"}
(20,1,1) = {"
a
a
a
a
a
V
a
a
a
a
a
"}
(21,1,1) = {"
a
a
a
a
a
V
a
a
a
a
a
"}
(22,1,1) = {"
V
V
V
V
V
a
a
a
a
a
a
"}
