//MAP CONVERTED BY dmm2tgm.py THIS HEADER COMMENT PREVENTS RECONVERSION, DO NOT REMOVE
"aj" = (
/obj/machinery/light{
	dir = 1
	},
/turf/open/floor/tile/dark/red2{
	dir = 9
	},
/area/bigredv2/outside/nanotrasen_lab/inside)
"aY" = (
/obj/structure/table,
/atom/movable/effect/spawner/random/technology_scanner,
/turf/open/floor/tile/dark/red2/corner{
	dir = 8
	},
/area/bigredv2/outside/nanotrasen_lab/inside)
"br" = (
/obj/structure/window/framed/colony/reinforced,
/turf/open/floor/plating,
/area/bigredv2/outside/nanotrasen_lab/inside)
"cg" = (
/turf/open/floor/plating/ground/mars/random/sand,
/area/bigredv2/outside/nanotrasen_lab/inside)
"cB" = (
/obj/structure/table,
/obj/item/tool/pen,
/turf/open/floor/tile/dark/red2/corner{
	dir = 4
	},
/area/bigredv2/outside/nanotrasen_lab/inside)
"cS" = (
/atom/movable/effect/landmark/weed_node,
/atom/movable/effect/landmark/lv624/fog_blocker/xeno_spawn,
/turf/open/floor/plating/ground/mars/random/cave,
/area/bigredv2/caves/south)
"dk" = (
/obj/machinery/computer/security,
/turf/open/floor/tile/dark/red2/corner{
	dir = 4
	},
/area/bigredv2/outside/nanotrasen_lab/inside)
"dP" = (
/obj/machinery/atmospherics/pipe/simple/green/hidden{
	dir = 4
	},
/atom/movable/effect/ai_node,
/turf/open/floor/tile/dark,
/area/bigredv2/outside/nanotrasen_lab/inside)
"dQ" = (
/atom/movable/effect/landmark/xeno_resin_wall,
/turf/open/floor/plating/ground/mars/random/cave,
/area/bigredv2/caves/south)
"eI" = (
/atom/movable/effect/decal/cleanable/dirt,
/atom/movable/effect/ai_node,
/turf/open/floor/tile/dark,
/area/bigredv2/outside/nanotrasen_lab/inside)
"fU" = (
/obj/structure/table,
/obj/structure/xenoautopsy,
/turf/open/floor/tile/dark/red2/corner{
	dir = 4
	},
/area/bigredv2/outside/nanotrasen_lab/inside)
"gh" = (
/obj/machinery/light{
	dir = 8
	},
/turf/open/floor/tile/dark/red2/corner{
	dir = 8
	},
/area/bigredv2/outside/nanotrasen_lab/inside)
"gA" = (
/obj/structure/bed/chair{
	dir = 8
	},
/turf/open/floor/tile/dark/red2{
	dir = 8
	},
/area/bigredv2/outside/nanotrasen_lab/inside)
"gG" = (
/obj/structure/cable,
/obj/machinery/power/apc{
	dir = 1
	},
/turf/open/floor/plating,
/area/bigredv2/outside/nanotrasen_lab/inside)
"gP" = (
/atom/movable/effect/decal/cleanable/dirt,
/turf/open/floor/tile/dark/red2/corner{
	dir = 8
	},
/area/bigredv2/outside/nanotrasen_lab/inside)
"jv" = (
/atom/movable/effect/ai_node,
/turf/open/floor/plating/ground/mars/random/cave/rock,
/area/bigredv2/caves/south)
"jN" = (
/atom/movable/effect/landmark/weed_node,
/turf/open/floor/plating/ground/mars/random/cave/rock,
/area/bigredv2/caves/south)
"kj" = (
/obj/machinery/atmospherics/components/unary/vent_pump{
	dir = 4;
	on = 1
	},
/turf/open/floor/tile/dark,
/area/bigredv2/outside/nanotrasen_lab/inside)
"kA" = (
/obj/structure/cable,
/atom/movable/effect/ai_node,
/turf/open/floor/plating,
/area/bigredv2/outside/nanotrasen_lab/inside)
"ls" = (
/atom/movable/effect/landmark/start/job/xenomorph,
/turf/open/floor/tile/dark,
/area/bigredv2/outside/nanotrasen_lab/inside)
"lQ" = (
/turf/open/floor/plating/ground/mars/random/cave/rock,
/area/bigredv2/caves/south)
"mt" = (
/turf/open/space/basic,
/area/space)
"mL" = (
/atom/movable/effect/landmark/weed_node,
/atom/movable/effect/ai_node,
/turf/open/floor/plating/ground/mars/random/sand,
/area/bigredv2/outside/nanotrasen_lab/inside)
"mS" = (
/turf/open/floor/tile/darkgreen/darkgreen2{
	dir = 6
	},
/area/bigredv2/outside/nanotrasen_lab/inside)
"oL" = (
/obj/structure/xenoautopsy/tank/hugger,
/turf/open/floor/tile/dark/red2/corner{
	dir = 8
	},
/area/bigredv2/outside/nanotrasen_lab/inside)
"pt" = (
/atom/movable/effect/landmark/excavation_site_spawner,
/turf/open/floor/plating/ground/mars/random/cave,
/area/bigredv2/caves/south)
"qZ" = (
/turf/open/floor/tile/dark/red2{
	dir = 8
	},
/area/bigredv2/outside/nanotrasen_lab/inside)
"rh" = (
/obj/machinery/atmospherics/pipe/simple/green/hidden{
	dir = 4
	},
/turf/open/floor/tile/dark,
/area/bigredv2/outside/nanotrasen_lab/inside)
"rp" = (
/atom/movable/effect/landmark/lv624/fog_blocker,
/turf/closed/mineral/bigred,
/area/bigredv2/caves/rock)
"rx" = (
/obj/structure/closet/toolcloset,
/turf/open/floor/plating,
/area/bigredv2/outside/nanotrasen_lab/inside)
"ry" = (
/obj/machinery/atmospherics/pipe/manifold/green/hidden{
	dir = 1
	},
/atom/movable/effect/ai_node,
/turf/open/floor/tile/dark,
/area/bigredv2/outside/nanotrasen_lab/inside)
"rU" = (
/atom/movable/effect/landmark/lv624/fog_blocker/xeno_spawn,
/turf/open/floor/plating/ground/mars/random/cave,
/area/bigredv2/caves/south)
"tI" = (
/turf/open/floor/tile/darkgreen/darkgreen2{
	dir = 8
	},
/area/bigredv2/outside/nanotrasen_lab/inside)
"tQ" = (
/turf/open/floor/tile/dark,
/area/bigredv2/outside/nanotrasen_lab/inside)
"uB" = (
/atom/movable/effect/landmark/lv624/fog_blocker/xeno_spawn,
/turf/open/floor/plating/ground/mars/random/cave/rock,
/area/bigredv2/caves/south)
"uH" = (
/turf/open/floor/plating/ground/mars/random/cave,
/area/bigredv2/caves/south)
"uL" = (
/turf/open/floor/tile/dark/red2/corner,
/area/bigredv2/outside/nanotrasen_lab/inside)
"uM" = (
/turf/open/ground/jungle/clear,
/area/bigredv2/outside/nanotrasen_lab/inside)
"vm" = (
/obj/structure/table,
/obj/item/alienjar,
/turf/open/floor/tile/dark/red2/corner{
	dir = 4
	},
/area/bigredv2/outside/nanotrasen_lab/inside)
"wt" = (
/atom/movable/effect/landmark/lv624/fog_blocker/xeno_spawn,
/turf/closed/mineral/bigred,
/area/bigredv2/caves/rock)
"xk" = (
/obj/structure/bed/chair{
	dir = 4
	},
/turf/open/floor/tile/dark/red2{
	dir = 4
	},
/area/bigredv2/outside/nanotrasen_lab/inside)
"yU" = (
/obj/machinery/miner/damaged/platinum,
/turf/open/floor/plating/ground/mars/random/cave/rock,
/area/bigredv2/caves/south)
"zf" = (
/turf/open/floor/tile/darkgreen/darkgreen2{
	dir = 4
	},
/area/bigredv2/outside/nanotrasen_lab/inside)
"zp" = (
/atom/movable/effect/landmark/weed_node,
/turf/open/floor/plating/ground/mars/random/cave,
/area/bigredv2/caves/south)
"zr" = (
/obj/structure/closet/l3closet/scientist,
/turf/open/floor/tile/darkgreen/darkgreen2{
	dir = 1
	},
/area/bigredv2/outside/nanotrasen_lab/inside)
"zC" = (
/atom/movable/effect/landmark/weed_node,
/atom/movable/effect/landmark/xeno_resin_wall,
/turf/open/floor/plating/ground/mars/random/cave,
/area/bigredv2/caves/south)
"zV" = (
/turf/open/floor/tile/dark/red2,
/area/bigredv2/outside/nanotrasen_lab/inside)
"An" = (
/atom/movable/effect/decal/cleanable/blood/gibs,
/turf/open/floor/plating/ground/mars/random/cave,
/area/bigredv2/caves/south)
"Aq" = (
/turf/open/floor/tile/dark/red2{
	dir = 1
	},
/area/bigredv2/outside/nanotrasen_lab/inside)
"Ar" = (
/obj/structure/bed/chair{
	dir = 4
	},
/atom/movable/effect/landmark/excavation_site_spawner,
/turf/open/floor/tile/dark/red2{
	dir = 4
	},
/area/bigredv2/outside/nanotrasen_lab/inside)
"AF" = (
/obj/machinery/light{
	dir = 1
	},
/turf/open/floor/tile/dark/red2{
	dir = 5
	},
/area/bigredv2/outside/nanotrasen_lab/inside)
"AQ" = (
/obj/structure/table,
/obj/item/paper,
/turf/open/floor/tile/dark/red2/corner,
/area/bigredv2/outside/nanotrasen_lab/inside)
"AZ" = (
/obj/machinery/light{
	dir = 4
	},
/atom/movable/effect/decal/cleanable/dirt,
/atom/movable/effect/ai_node,
/turf/open/floor/tile/dark/red2/corner,
/area/bigredv2/outside/nanotrasen_lab/inside)
"Bp" = (
/obj/machinery/atmospherics/pipe/simple/green/hidden{
	dir = 4
	},
/obj/machinery/door/airlock/mainship/research/glass/free_access{
	name = "\improper Eta Lab Xenobiology Lab"
	},
/turf/open/floor/tile/dark,
/area/bigredv2/outside/nanotrasen_lab/inside)
"DA" = (
/atom/movable/effect/landmark/weed_node,
/turf/open/floor/plating,
/area/bigredv2/outside/nanotrasen_lab/inside)
"DB" = (
/obj/machinery/door/airlock/mainship/research/glass/free_access{
	dir = 1;
	name = "\improper Eta Lab Cell"
	},
/turf/open/floor/tile/dark,
/area/bigredv2/outside/nanotrasen_lab/inside)
"DP" = (
/obj/structure/table,
/atom/movable/effect/spawner/random/technology_scanner,
/turf/open/floor/tile/dark/red2/corner{
	dir = 4
	},
/area/bigredv2/outside/nanotrasen_lab/inside)
"En" = (
/obj/structure/xenoautopsy/tank/broken,
/turf/open/floor/tile/dark/red2/corner{
	dir = 8
	},
/area/bigredv2/outside/nanotrasen_lab/inside)
"EC" = (
/turf/open/floor/tile/dark/red2{
	dir = 4
	},
/area/bigredv2/outside/nanotrasen_lab/inside)
"EW" = (
/turf/closed/wall/r_wall,
/area/bigredv2/outside/nanotrasen_lab/inside)
"GX" = (
/atom/movable/effect/landmark/xeno_resin_wall,
/atom/movable/effect/landmark/excavation_site_spawner,
/turf/open/floor/plating/ground/mars/random/cave,
/area/bigredv2/caves/south)
"Hc" = (
/turf/open/floor/tile/dark/red2/corner{
	dir = 4
	},
/area/bigredv2/outside/nanotrasen_lab/inside)
"IX" = (
/atom/movable/effect/landmark/lv624/fog_blocker,
/turf/closed/wall/r_wall,
/area/bigredv2/outside/nanotrasen_lab/inside)
"Jw" = (
/obj/structure/table,
/obj/machinery/light,
/atom/movable/effect/spawner/random/technology_scanner,
/obj/item/xenos_claw,
/turf/open/floor/tile/dark/red2/corner{
	dir = 8
	},
/area/bigredv2/outside/nanotrasen_lab/inside)
"JI" = (
/obj/item/target,
/turf/open/floor/tile/dark/red2{
	dir = 1
	},
/area/bigredv2/outside/nanotrasen_lab/inside)
"KI" = (
/turf/open/floor/tile/dark/red2{
	dir = 6
	},
/area/bigredv2/outside/nanotrasen_lab/inside)
"KO" = (
/obj/machinery/light,
/turf/open/floor/tile/darkgreen/darkgreen2,
/area/bigredv2/outside/nanotrasen_lab/inside)
"KR" = (
/obj/machinery/door/airlock/mainship/research/glass/free_access{
	locked = 1;
	name = "\improper Eta Lab Cell"
	},
/turf/open/floor/tile/dark,
/area/bigredv2/outside/nanotrasen_lab/inside)
"Lv" = (
/obj/machinery/light{
	dir = 4
	},
/turf/open/ground/jungle/clear,
/area/bigredv2/outside/nanotrasen_lab/inside)
"LR" = (
/obj/structure/closet/l3closet/scientist,
/turf/open/floor/tile/darkgreen/darkgreen2{
	dir = 9
	},
/area/bigredv2/outside/nanotrasen_lab/inside)
"MK" = (
/obj/structure/cable,
/turf/open/floor/plating,
/area/bigredv2/outside/nanotrasen_lab/inside)
"NA" = (
/turf/closed/wall/indestructible/mineral,
/area/space)
"NF" = (
/atom/movable/effect/ai_node,
/turf/open/floor/plating/ground/mars/random/cave,
/area/bigredv2/caves/south)
"NW" = (
/turf/closed/wall,
/area/bigredv2/outside/nanotrasen_lab/inside)
"Og" = (
/obj/machinery/atmospherics/components/unary/vent_pump{
	dir = 1;
	on = 1
	},
/turf/open/floor/tile/dark,
/area/bigredv2/outside/nanotrasen_lab/inside)
"OF" = (
/obj/machinery/door/airlock/mainship/research/glass/free_access{
	name = "\improper Eta Lab Cell"
	},
/turf/open/floor/tile/dark,
/area/bigredv2/outside/nanotrasen_lab/inside)
"OL" = (
/atom/movable/effect/decal/cleanable/dirt,
/turf/open/floor/tile/dark/red2/corner,
/area/bigredv2/outside/nanotrasen_lab/inside)
"OP" = (
/turf/open/floor/tile/darkgreen/darkgreen2{
	dir = 10
	},
/area/bigredv2/outside/nanotrasen_lab/inside)
"Pq" = (
/atom/movable/effect/landmark/xeno_silo_spawn,
/turf/open/floor/plating/ground/mars/random/cave,
/area/bigredv2/caves/south)
"PJ" = (
/obj/structure/window/framed/colony,
/turf/open/floor/plating,
/area/bigredv2/outside/nanotrasen_lab/inside)
"RH" = (
/atom/movable/effect/ai_node,
/turf/open/floor/tile/dark,
/area/bigredv2/outside/nanotrasen_lab/inside)
"RQ" = (
/atom/movable/effect/decal/cleanable/dirt,
/turf/open/floor/tile/dark,
/area/bigredv2/outside/nanotrasen_lab/inside)
"Sq" = (
/obj/structure/closet/l3closet/scientist,
/turf/open/floor/tile/darkgreen/darkgreen2{
	dir = 5
	},
/area/bigredv2/outside/nanotrasen_lab/inside)
"TD" = (
/turf/closed/mineral/bigred,
/area/bigredv2/caves/rock)
"Un" = (
/turf/open/floor/tile/dark/red2/corner{
	dir = 8
	},
/area/bigredv2/outside/nanotrasen_lab/inside)
"Uo" = (
/obj/structure/closet/crate/secure,
/turf/open/floor/tile/dark/red2/corner,
/area/bigredv2/outside/nanotrasen_lab/inside)
"VX" = (
/obj/structure/reagent_dispensers/fueltank,
/turf/open/floor/plating,
/area/bigredv2/outside/nanotrasen_lab/inside)
"Wn" = (
/obj/structure/closet/firecloset,
/turf/open/floor/plating,
/area/bigredv2/outside/nanotrasen_lab/inside)
"WC" = (
/atom/movable/effect/landmark/xeno_resin_door,
/turf/open/floor/plating/ground/mars/random/cave,
/area/bigredv2/caves/south)
"WG" = (
/atom/movable/effect/landmark/start/job/xenomorph,
/turf/open/floor/plating/ground/mars/random/sand,
/area/bigredv2/outside/nanotrasen_lab/inside)
"Xl" = (
/turf/open/floor/plating,
/area/bigredv2/outside/nanotrasen_lab/inside)
"XD" = (
/turf/open/floor/tile/dark/red2{
	dir = 10
	},
/area/bigredv2/outside/nanotrasen_lab/inside)
"Yz" = (
/obj/structure/cable,
/obj/machinery/door/airlock/mainship/maint/free_access{
	name = "\improper Eta Lab Maintenance Storage"
	},
/turf/open/floor/tile/dark,
/area/bigredv2/outside/nanotrasen_lab/inside)
"YO" = (
/obj/machinery/light{
	dir = 8
	},
/turf/open/floor/plating/ground/mars/random/sand,
/area/bigredv2/outside/nanotrasen_lab/inside)
"YU" = (
/obj/structure/xenoautopsy/tank,
/turf/open/floor/tile/dark/red2/corner{
	dir = 8
	},
/area/bigredv2/outside/nanotrasen_lab/inside)
"YW" = (
/atom/movable/effect/ai_node,
/turf/open/ground/jungle/clear,
/area/bigredv2/outside/nanotrasen_lab/inside)

(1,1,1) = {"
NA
mt
mt
mt
mt
mt
mt
mt
mt
mt
mt
mt
mt
mt
mt
mt
mt
mt
mt
mt
mt
mt
mt
mt
mt
mt
mt
mt
mt
mt
mt
mt
mt
mt
mt
mt
mt
mt
"}
(2,1,1) = {"
NA
mt
mt
mt
mt
mt
mt
mt
mt
mt
mt
mt
mt
mt
mt
mt
mt
mt
mt
mt
mt
mt
mt
mt
mt
mt
mt
mt
mt
mt
mt
mt
mt
mt
mt
mt
mt
mt
"}
(3,1,1) = {"
NA
mt
mt
mt
mt
mt
mt
mt
mt
mt
mt
mt
mt
mt
mt
mt
mt
mt
mt
mt
mt
mt
mt
mt
mt
mt
mt
mt
mt
mt
mt
mt
mt
mt
mt
mt
mt
mt
"}
(4,1,1) = {"
NA
mt
mt
mt
mt
mt
mt
mt
mt
mt
mt
mt
mt
mt
mt
mt
mt
mt
mt
mt
mt
mt
mt
mt
mt
mt
mt
mt
mt
mt
mt
mt
mt
mt
mt
mt
mt
mt
"}
(5,1,1) = {"
NA
mt
mt
mt
mt
mt
mt
mt
mt
mt
mt
mt
mt
mt
mt
mt
mt
mt
mt
mt
mt
mt
mt
mt
mt
mt
mt
mt
mt
mt
mt
mt
mt
mt
mt
mt
mt
mt
"}
(6,1,1) = {"
NA
mt
mt
mt
mt
mt
mt
mt
mt
mt
mt
mt
mt
mt
mt
mt
mt
mt
mt
mt
mt
mt
mt
mt
mt
mt
mt
mt
mt
mt
mt
mt
mt
mt
mt
mt
mt
mt
"}
(7,1,1) = {"
NA
mt
mt
mt
mt
mt
mt
mt
mt
mt
mt
mt
mt
mt
mt
mt
mt
mt
mt
mt
mt
mt
mt
mt
mt
mt
mt
mt
mt
mt
mt
mt
mt
mt
mt
mt
mt
mt
"}
(8,1,1) = {"
NA
mt
mt
mt
mt
mt
mt
mt
mt
mt
mt
mt
mt
mt
mt
mt
mt
mt
mt
mt
mt
mt
mt
mt
mt
mt
mt
mt
mt
mt
mt
mt
mt
mt
mt
mt
mt
mt
"}
(9,1,1) = {"
NA
mt
mt
mt
mt
mt
mt
mt
mt
mt
mt
mt
mt
mt
mt
mt
mt
mt
mt
mt
mt
mt
mt
mt
mt
mt
mt
mt
mt
mt
mt
mt
mt
mt
mt
mt
mt
mt
"}
(10,1,1) = {"
NA
mt
mt
mt
mt
mt
mt
mt
mt
mt
mt
mt
mt
mt
mt
mt
mt
mt
mt
mt
mt
mt
mt
mt
mt
mt
mt
mt
mt
mt
mt
mt
mt
mt
mt
mt
mt
mt
"}
(11,1,1) = {"
NA
mt
mt
mt
mt
mt
mt
mt
mt
mt
mt
mt
mt
mt
mt
mt
mt
mt
mt
mt
mt
mt
mt
mt
mt
mt
mt
mt
mt
mt
mt
mt
mt
mt
mt
mt
mt
mt
"}
(12,1,1) = {"
NA
mt
mt
mt
mt
mt
mt
mt
mt
mt
mt
mt
mt
mt
mt
mt
mt
mt
mt
mt
mt
mt
mt
mt
mt
mt
mt
mt
mt
mt
mt
mt
mt
mt
mt
mt
mt
mt
"}
(13,1,1) = {"
NA
mt
mt
mt
mt
mt
mt
mt
mt
mt
mt
mt
mt
mt
mt
mt
mt
mt
mt
mt
mt
mt
mt
mt
mt
mt
mt
mt
mt
mt
mt
mt
mt
mt
mt
mt
mt
mt
"}
(14,1,1) = {"
NA
mt
mt
mt
mt
mt
mt
mt
mt
mt
mt
mt
mt
mt
mt
mt
mt
mt
mt
mt
mt
mt
mt
mt
mt
mt
mt
mt
mt
mt
mt
mt
mt
mt
mt
mt
mt
mt
"}
(15,1,1) = {"
NA
mt
mt
mt
mt
mt
mt
mt
mt
mt
mt
mt
mt
mt
mt
mt
mt
mt
mt
mt
mt
mt
mt
mt
mt
mt
mt
mt
mt
mt
mt
mt
mt
mt
mt
mt
mt
mt
"}
(16,1,1) = {"
NA
mt
mt
mt
mt
mt
mt
mt
mt
mt
mt
mt
mt
mt
mt
mt
mt
mt
mt
mt
mt
mt
mt
mt
mt
mt
mt
mt
mt
mt
mt
mt
mt
mt
mt
mt
mt
mt
"}
(17,1,1) = {"
NA
mt
mt
mt
mt
mt
mt
mt
mt
mt
mt
mt
mt
mt
mt
mt
mt
mt
mt
mt
mt
mt
mt
mt
mt
mt
mt
mt
mt
mt
mt
mt
mt
mt
mt
mt
mt
mt
"}
(18,1,1) = {"
NA
mt
mt
mt
mt
mt
mt
mt
mt
mt
mt
mt
mt
mt
mt
mt
mt
mt
mt
mt
mt
mt
mt
mt
mt
mt
mt
mt
mt
mt
mt
mt
mt
mt
mt
mt
mt
mt
"}
(19,1,1) = {"
NA
mt
mt
mt
mt
mt
mt
mt
mt
mt
mt
mt
mt
mt
mt
mt
mt
mt
mt
mt
mt
mt
mt
mt
mt
mt
mt
mt
mt
mt
mt
mt
mt
mt
mt
mt
mt
mt
"}
(20,1,1) = {"
NA
mt
mt
mt
mt
mt
mt
mt
mt
mt
mt
mt
mt
mt
mt
mt
mt
mt
mt
mt
mt
mt
mt
mt
mt
mt
mt
mt
mt
mt
mt
mt
mt
mt
mt
mt
mt
mt
"}
(21,1,1) = {"
NA
mt
mt
mt
mt
mt
mt
mt
mt
mt
mt
mt
mt
mt
mt
mt
mt
mt
mt
mt
mt
mt
mt
mt
mt
mt
mt
mt
mt
mt
mt
mt
mt
mt
mt
mt
mt
mt
"}
(22,1,1) = {"
NA
mt
mt
mt
mt
mt
mt
mt
mt
mt
mt
mt
mt
mt
mt
mt
mt
mt
mt
mt
mt
mt
mt
mt
mt
mt
mt
mt
mt
mt
mt
mt
mt
mt
mt
mt
mt
mt
"}
(23,1,1) = {"
NA
mt
mt
mt
mt
mt
mt
mt
mt
mt
mt
mt
mt
mt
mt
mt
mt
mt
mt
mt
mt
mt
mt
mt
mt
mt
mt
mt
mt
mt
mt
mt
mt
mt
mt
mt
mt
mt
"}
(24,1,1) = {"
NA
mt
mt
mt
mt
mt
mt
mt
mt
mt
mt
mt
mt
mt
mt
mt
mt
mt
mt
mt
mt
mt
mt
mt
mt
mt
mt
mt
mt
mt
mt
mt
mt
mt
mt
mt
mt
mt
"}
(25,1,1) = {"
NA
mt
mt
mt
mt
mt
mt
mt
mt
mt
mt
mt
mt
mt
mt
mt
mt
mt
mt
mt
mt
mt
mt
mt
mt
mt
mt
mt
mt
mt
mt
mt
mt
mt
mt
mt
mt
mt
"}
(26,1,1) = {"
NA
mt
mt
mt
mt
mt
mt
mt
mt
mt
mt
mt
mt
mt
mt
mt
mt
mt
mt
mt
mt
mt
mt
mt
mt
mt
mt
mt
mt
mt
mt
mt
mt
mt
mt
mt
mt
mt
"}
(27,1,1) = {"
NA
mt
mt
mt
mt
mt
mt
mt
mt
mt
mt
mt
mt
mt
mt
mt
mt
mt
mt
mt
mt
mt
mt
mt
mt
mt
mt
mt
mt
mt
mt
mt
mt
mt
mt
mt
mt
mt
"}
(28,1,1) = {"
NA
mt
mt
mt
mt
mt
mt
mt
mt
mt
mt
mt
mt
mt
mt
mt
mt
mt
mt
mt
mt
mt
mt
mt
mt
mt
mt
mt
mt
mt
mt
mt
mt
mt
mt
mt
mt
mt
"}
(29,1,1) = {"
NA
NA
NA
NA
NA
NA
NA
NA
NA
NA
NA
NA
NA
NA
NA
NA
NA
NA
NA
NA
NA
NA
NA
NA
NA
NA
NA
NA
NA
NA
NA
NA
NA
NA
NA
NA
NA
NA
"}
(30,1,1) = {"
TD
TD
TD
TD
TD
TD
TD
TD
TD
TD
TD
TD
TD
TD
TD
TD
TD
TD
TD
TD
TD
TD
TD
TD
TD
TD
TD
TD
TD
TD
TD
TD
TD
TD
TD
TD
TD
NA
"}
(31,1,1) = {"
TD
TD
wt
wt
wt
wt
wt
wt
wt
wt
wt
wt
wt
wt
wt
TD
TD
TD
TD
TD
TD
TD
TD
TD
TD
TD
TD
TD
TD
TD
TD
TD
TD
TD
TD
TD
TD
NA
"}
(32,1,1) = {"
TD
TD
wt
TD
TD
TD
TD
TD
TD
lQ
lQ
TD
TD
TD
wt
TD
TD
TD
TD
TD
TD
TD
TD
TD
TD
TD
TD
TD
TD
TD
TD
TD
TD
TD
TD
TD
TD
NA
"}
(33,1,1) = {"
TD
TD
wt
TD
TD
TD
TD
TD
lQ
uH
uH
lQ
TD
TD
wt
TD
TD
TD
TD
TD
TD
TD
TD
TD
TD
TD
TD
TD
TD
TD
TD
TD
TD
TD
TD
TD
TD
NA
"}
(34,1,1) = {"
TD
TD
wt
TD
TD
TD
TD
lQ
uH
zp
Pq
uH
lQ
lQ
wt
TD
TD
TD
TD
TD
TD
TD
TD
TD
TD
TD
TD
TD
TD
TD
TD
TD
TD
TD
TD
TD
TD
NA
"}
(35,1,1) = {"
TD
TD
wt
TD
TD
TD
lQ
uH
uH
NF
uH
uH
uH
lQ
wt
TD
TD
TD
TD
TD
TD
TD
TD
TD
TD
TD
TD
TD
TD
TD
TD
TD
TD
TD
TD
TD
TD
NA
"}
(36,1,1) = {"
TD
TD
wt
TD
TD
TD
uH
uH
uH
uH
uH
uH
uH
uH
wt
TD
TD
TD
TD
TD
TD
TD
TD
TD
TD
TD
TD
TD
TD
TD
TD
TD
TD
TD
TD
TD
TD
NA
"}
(37,1,1) = {"
TD
TD
wt
TD
dQ
dQ
dQ
GX
dQ
WC
WC
dQ
zC
dQ
wt
TD
TD
TD
TD
TD
TD
TD
TD
TD
TD
TD
TD
TD
TD
TD
TD
TD
TD
TD
TD
TD
TD
NA
"}
(38,1,1) = {"
TD
TD
wt
uH
uH
uH
uH
zp
uH
uH
uH
uH
zp
uH
rU
uH
TD
TD
TD
TD
TD
TD
TD
TD
TD
TD
TD
TD
TD
TD
TD
TD
TD
TD
TD
TD
TD
NA
"}
(39,1,1) = {"
uH
uH
rU
uH
uH
uH
uH
uH
uH
uH
uH
uH
uH
uH
rU
uH
zp
uH
uH
uH
uH
zp
TD
TD
TD
TD
TD
TD
TD
TD
TD
TD
TD
TD
TD
TD
TD
NA
"}
(40,1,1) = {"
uH
lQ
rU
uH
jN
lQ
uH
uH
uH
uH
zp
lQ
uH
uH
rU
uH
uH
uH
uH
uH
uH
uH
uH
TD
TD
TD
TD
TD
TD
TD
TD
TD
TD
TD
TD
TD
TD
NA
"}
(41,1,1) = {"
uH
uH
rU
uH
uH
uH
uH
uH
uH
NF
uH
uH
lQ
lQ
uB
lQ
lQ
lQ
zp
lQ
jv
lQ
uH
zp
uH
NF
TD
TD
TD
TD
TD
TD
TD
TD
TD
TD
TD
NA
"}
(42,1,1) = {"
uH
zp
rU
uH
uH
uH
uH
zp
uH
uH
uH
uH
uH
uH
rU
uH
uH
uH
uH
uH
uH
uH
lQ
uH
uH
uH
uH
TD
TD
TD
TD
TD
TD
TD
TD
TD
TD
NA
"}
(43,1,1) = {"
uH
TD
wt
TD
TD
TD
TD
lQ
uH
uH
uH
uH
zp
uH
cS
uH
zp
uH
uH
uH
uH
uH
uH
uH
uH
uH
uH
zp
TD
TD
TD
TD
TD
TD
TD
TD
TD
NA
"}
(44,1,1) = {"
TD
TD
wt
wt
wt
wt
wt
wt
wt
wt
wt
wt
wt
wt
wt
TD
TD
uH
TD
TD
lQ
lQ
TD
lQ
uH
zp
uH
uH
TD
TD
TD
TD
TD
TD
TD
TD
TD
NA
"}
(45,1,1) = {"
TD
TD
TD
TD
TD
TD
TD
TD
TD
TD
TD
TD
TD
TD
TD
TD
TD
TD
TD
TD
TD
TD
TD
TD
uH
uH
uH
uH
uH
TD
TD
TD
TD
TD
TD
TD
TD
NA
"}
(46,1,1) = {"
rp
rp
rp
rp
rp
rp
rp
rp
rp
rp
rp
rp
rp
rp
rp
rp
rp
rp
rp
rp
rp
rp
TD
TD
TD
uH
uH
uH
uH
zp
TD
TD
TD
TD
TD
TD
TD
NA
"}
(47,1,1) = {"
EW
EW
EW
EW
EW
EW
EW
EW
EW
EW
EW
EW
EW
EW
EW
EW
EW
EW
EW
EW
EW
EW
IX
TD
TD
uH
uH
uH
uH
uH
uH
TD
TD
TD
TD
TD
TD
NA
"}
(48,1,1) = {"
aj
qZ
qZ
XD
EW
YU
En
oL
oL
oL
EW
cg
YO
cg
EW
cg
YO
cg
EW
cg
YO
cg
IX
TD
TD
NF
zp
pt
uH
uH
uH
TD
TD
TD
TD
TD
TD
NA
"}
(49,1,1) = {"
Aq
RH
ls
tQ
DB
tQ
tQ
RH
tQ
gP
EW
cg
mL
cg
EW
cg
mL
cg
EW
cg
mL
cg
IX
TD
TD
uH
uH
uH
uH
uH
uH
TD
TD
TD
TD
TD
TD
NA
"}
(50,1,1) = {"
Aq
tQ
tQ
zV
EW
Hc
RQ
RQ
RQ
aY
EW
cg
cg
cg
EW
cg
WG
cg
EW
cg
cg
cg
IX
TD
TD
uH
zp
uH
uH
uH
zp
TD
TD
TD
TD
TD
TD
NA
"}
(51,1,1) = {"
JI
tQ
tQ
zV
br
dk
RQ
RQ
tQ
Jw
EW
br
KR
br
EW
br
OF
br
EW
br
KR
br
IX
TD
TD
uH
uH
lQ
uH
uH
uH
zp
TD
TD
TD
TD
TD
NA
"}
(52,1,1) = {"
Aq
tQ
tQ
zV
br
DP
RQ
RQ
tQ
Un
NW
gA
RQ
gA
NW
gA
tQ
gA
NW
gA
tQ
gA
IX
TD
TD
uH
uH
yU
uH
uH
uH
uH
uH
TD
TD
TD
TD
NA
"}
(53,1,1) = {"
JI
tQ
tQ
zV
br
vm
tQ
RQ
RQ
tQ
Un
gP
tQ
Un
gh
Un
tQ
Un
Un
Un
RQ
Un
IX
TD
uH
uH
uH
lQ
uH
uH
uH
uH
uH
TD
TD
TD
TD
NA
"}
(54,1,1) = {"
Aq
RH
tQ
zV
br
fU
tQ
kj
RQ
RQ
tQ
RQ
RQ
RQ
tQ
RQ
RQ
RQ
tQ
RQ
tQ
RQ
IX
uH
uH
uH
uH
lQ
uH
zp
uH
uH
uH
TD
TD
TD
TD
NA
"}
(55,1,1) = {"
Aq
ls
tQ
zV
br
cB
tQ
dP
RQ
RQ
AZ
OL
eI
OL
OL
OL
eI
OL
AZ
uL
RH
uL
IX
uH
zp
NF
uH
uH
uH
uH
uH
uH
NF
TD
TD
TD
TD
NA
"}
(56,1,1) = {"
AF
EC
EC
KI
br
AQ
uL
rh
uL
Uo
NW
xk
tQ
Ar
NW
xk
tQ
xk
NW
xk
RQ
xk
IX
TD
lQ
uH
uH
uH
uH
zp
uH
uH
uH
uH
TD
TD
TD
NA
"}
(57,1,1) = {"
EW
EW
EW
EW
EW
NW
PJ
Bp
PJ
NW
EW
br
KR
br
EW
br
KR
br
EW
br
KR
br
IX
TD
TD
TD
TD
uH
uH
uH
uH
uH
zp
uH
TD
TD
TD
NA
"}
(58,1,1) = {"
VX
MK
MK
gG
NW
LR
tI
rh
tI
OP
EW
uM
uM
uM
EW
uM
uM
uM
EW
uM
uM
uM
IX
TD
TD
TD
TD
uH
TD
TD
uH
uH
uH
uH
uH
TD
TD
NA
"}
(59,1,1) = {"
VX
kA
DA
Wn
NW
zr
tQ
ry
Og
KO
EW
uM
YW
uM
EW
uM
YW
uM
EW
uM
YW
uM
IX
TD
TD
TD
TD
TD
TD
TD
TD
uH
uH
zp
uH
TD
TD
NA
"}
(60,1,1) = {"
VX
MK
Xl
rx
NW
Sq
zf
rh
zf
mS
EW
uM
Lv
uM
EW
uM
Lv
uM
EW
uM
Lv
uM
IX
rp
rp
rp
rp
rp
rp
rp
TD
uH
NF
An
uH
TD
TD
NA
"}
(61,1,1) = {"
NW
Yz
NW
NW
NW
NW
PJ
Bp
PJ
NW
EW
EW
EW
EW
EW
EW
EW
EW
EW
EW
EW
EW
EW
EW
EW
EW
EW
EW
EW
rp
TD
uH
zp
uH
uH
TD
TD
NA
"}
