//MAP CONVERTED BY dmm2tgm.py THIS HEADER COMMENT PREVENTS RECONVERSION, DO NOT REMOVE
"d" = (
/atom/movable/effect/ai_node,
/turf/open/floor/plating/ground/mars/random/cave,
/area/bigredv2/caves/northeast)
"f" = (
/atom/movable/effect/landmark/lv624/fog_blocker,
/turf/open/floor/plating/ground/mars/random/cave,
/area/bigredv2/caves/northeast)
"g" = (
/turf/open/floor/plating,
/area/bigredv2/caves/lambda_lab)
"i" = (
/atom/movable/effect/landmark/weed_node,
/atom/movable/effect/ai_node,
/turf/open/floor/plating/ground/mars/random/cave,
/area/bigredv2/caves/northeast)
"m" = (
/turf/open/space/basic,
/area/space)
"o" = (
/atom/movable/effect/landmark/lv624/fog_blocker,
/turf/closed/mineral/smooth/bigred,
/area/bigredv2/caves/rock)
"p" = (
/obj/machinery/miner/damaged/platinum,
/turf/open/floor/plating/ground/mars/random/cave,
/area/bigredv2/caves/northeast)
"q" = (
/turf/closed/mineral/smooth/bigred,
/area/bigredv2/caves/rock)
"r" = (
/atom/movable/effect/landmark/weed_node,
/turf/open/floor/plating/ground/mars/random/cave,
/area/bigredv2/caves/northeast)
"s" = (
/turf/open/floor/plating/ground/mars/random/cave,
/area/bigredv2/caves/northeast)
"v" = (
/turf/closed/mineral/smooth/bigred/indestructible,
/area/space)
"y" = (
/atom/movable/effect/landmark/weed_node,
/turf/open/floor/plating/ground/mars/random/cave/rock,
/area/bigredv2/caves/northeast)
"A" = (
/obj/machinery/chem_dispenser,
/turf/open/floor/tile/whiteyellow{
	dir = 1
	},
/area/bigredv2/caves/lambda_lab)
"E" = (
/turf/open/floor/plating/ground/mars/random/cave/rock,
/area/bigredv2/caves/northeast)
"I" = (
/turf/closed/wall/r_wall,
/area/bigredv2/caves/rock)
"L" = (
/obj/structure/closet/crate/internals,
/turf/open/floor/plating,
/area/bigredv2/caves/lambda_lab)
"M" = (
/turf/closed/wall/r_wall,
/area/bigredv2/caves/lambda_lab)
"N" = (
/obj/structure/closet/crate/freezer/rations,
/turf/open/floor/plating,
/area/bigredv2/caves/lambda_lab)
"Q" = (
/obj/machinery/chem_master,
/turf/open/floor/tile/whiteyellow{
	dir = 5
	},
/area/bigredv2/caves/lambda_lab)
"R" = (
/atom/movable/effect/ai_node,
/atom/movable/effect/landmark/excavation_site_spawner,
/turf/open/floor/plating/ground/mars/random/cave,
/area/bigredv2/caves/northeast)
"S" = (
/obj/machinery/chem_dispenser,
/turf/open/floor/tile/whiteyellow{
	dir = 9
	},
/area/bigredv2/caves/lambda_lab)
"T" = (
/atom/movable/effect/landmark/xeno_resin_wall,
/turf/open/floor/plating/ground/mars/random/cave,
/area/bigredv2/caves/northeast)

(1,1,1) = {"
m
m
m
m
m
m
m
m
m
v
v
v
v
v
v
v
v
v
v
v
q
q
q
q
q
s
s
s
s
E
q
q
"}
(2,1,1) = {"
m
m
m
m
m
m
m
m
m
v
q
q
q
q
q
q
q
q
q
q
q
q
q
E
E
r
s
s
s
E
q
q
"}
(3,1,1) = {"
m
m
m
m
m
m
m
m
m
v
q
q
q
q
q
q
q
q
q
q
q
q
s
s
s
s
s
s
s
E
q
q
"}
(4,1,1) = {"
m
m
m
m
m
m
m
m
m
v
q
q
q
q
q
q
q
q
q
q
q
s
s
s
s
s
s
s
s
s
E
q
"}
(5,1,1) = {"
m
m
m
m
m
m
m
m
m
v
q
q
q
q
q
q
q
q
q
q
s
s
d
s
d
s
s
r
s
d
E
q
"}
(6,1,1) = {"
m
m
m
m
m
m
m
m
m
v
q
q
q
q
q
q
q
d
s
s
s
d
s
y
s
s
s
s
s
s
E
q
"}
(7,1,1) = {"
m
m
m
m
m
m
m
m
m
v
q
q
q
q
q
q
s
s
s
s
s
s
s
q
q
E
s
s
s
s
E
q
"}
(8,1,1) = {"
m
m
m
m
m
m
m
m
m
v
q
q
q
q
q
q
s
s
s
q
s
s
q
q
q
q
s
s
s
s
r
E
"}
(9,1,1) = {"
m
m
m
m
m
m
m
m
m
v
q
q
q
q
q
q
s
d
s
q
q
q
q
q
q
q
y
s
s
s
s
s
"}
(10,1,1) = {"
m
m
m
m
m
m
m
m
m
v
q
q
q
q
q
s
d
s
s
q
q
q
q
q
q
q
q
E
s
d
s
s
"}
(11,1,1) = {"
m
m
m
m
m
m
m
m
m
v
q
q
q
q
s
s
s
s
s
q
q
q
q
q
q
q
q
q
q
s
d
s
"}
(12,1,1) = {"
m
m
m
m
m
m
m
m
m
v
q
q
q
q
s
s
s
s
s
q
q
q
q
q
q
q
q
q
q
E
s
d
"}
(13,1,1) = {"
m
m
m
m
m
m
m
m
m
v
q
q
q
s
s
s
s
s
q
q
q
q
q
q
q
q
q
q
q
q
q
q
"}
(14,1,1) = {"
m
m
m
m
m
m
m
m
m
v
q
q
d
s
s
s
d
q
q
q
q
q
q
q
q
q
q
q
q
q
q
q
"}
(15,1,1) = {"
m
m
m
m
m
m
m
m
m
v
q
q
s
s
s
q
q
q
q
q
q
q
q
q
q
q
q
I
I
I
I
I
"}
(16,1,1) = {"
m
m
m
m
m
m
m
m
m
v
q
q
s
s
s
q
q
q
q
q
q
q
q
q
q
q
q
I
q
T
T
T
"}
(17,1,1) = {"
m
m
m
m
m
m
m
m
m
v
q
s
s
s
q
q
q
q
q
q
q
q
q
q
q
q
q
I
q
s
s
s
"}
(18,1,1) = {"
m
m
m
m
m
m
m
m
m
v
q
s
d
s
q
q
q
q
q
q
q
q
q
q
q
q
q
I
q
s
s
d
"}
(19,1,1) = {"
m
m
m
m
m
m
m
m
m
v
q
d
s
s
s
q
q
q
q
q
q
q
q
q
q
q
q
q
q
s
s
s
"}
(20,1,1) = {"
m
m
m
m
m
m
m
m
m
v
q
q
s
s
s
s
s
q
q
q
q
q
q
q
q
q
q
q
q
s
s
s
"}
(21,1,1) = {"
m
m
m
m
m
m
m
m
m
v
q
q
s
s
s
s
s
s
s
q
q
q
q
q
q
q
q
q
q
q
s
s
"}
(22,1,1) = {"
m
m
m
m
m
m
m
m
m
v
q
q
d
s
s
s
d
s
s
q
q
q
q
q
q
q
q
q
q
q
s
s
"}
(23,1,1) = {"
m
m
m
m
m
m
m
m
m
v
q
q
q
s
s
s
s
s
s
q
q
q
q
q
q
q
q
q
q
q
s
d
"}
(24,1,1) = {"
m
m
m
m
m
m
m
m
m
v
q
q
q
q
s
s
s
s
s
s
q
q
q
q
q
q
q
q
q
q
r
s
"}
(25,1,1) = {"
m
m
m
m
m
m
m
m
m
v
q
q
q
q
s
s
s
q
s
s
q
q
q
q
q
q
q
q
q
q
q
s
"}
(26,1,1) = {"
m
m
m
m
m
m
m
m
m
v
q
q
q
q
s
s
s
q
s
s
s
q
q
q
q
s
q
q
q
q
q
q
"}
(27,1,1) = {"
m
m
m
m
m
m
m
m
m
v
q
q
q
q
q
s
s
s
s
s
s
s
s
s
s
s
s
q
q
q
q
q
"}
(28,1,1) = {"
m
m
m
m
m
m
m
m
m
v
q
q
q
q
q
s
d
s
s
s
s
s
d
s
s
s
i
q
q
q
q
o
"}
(29,1,1) = {"
m
m
m
m
m
m
m
m
m
v
q
q
q
q
q
q
s
s
s
s
s
s
s
s
s
s
s
q
q
q
o
q
"}
(30,1,1) = {"
m
m
m
m
m
m
m
m
m
v
q
q
q
q
q
q
q
q
q
s
s
s
s
s
s
s
s
q
q
o
q
q
"}
(31,1,1) = {"
m
m
m
m
m
m
m
m
m
v
q
q
q
q
q
q
q
q
q
q
q
q
q
s
s
s
s
q
q
o
q
M
"}
(32,1,1) = {"
m
m
m
m
m
m
m
m
m
v
q
q
q
q
q
q
q
q
q
q
q
q
q
s
s
s
s
q
q
o
q
M
"}
(33,1,1) = {"
m
m
m
m
m
m
m
m
m
v
q
q
q
q
q
q
q
q
q
q
q
q
q
d
s
s
i
q
q
o
q
M
"}
(34,1,1) = {"
m
m
m
m
m
m
m
m
m
v
q
q
q
q
q
q
q
q
q
q
q
q
q
s
s
s
s
q
q
o
q
M
"}
(35,1,1) = {"
m
m
m
m
m
m
m
m
m
v
q
q
q
q
q
q
q
q
q
q
q
q
q
s
s
s
s
q
q
o
q
M
"}
(36,1,1) = {"
m
m
m
m
m
m
m
m
m
v
q
q
q
q
q
q
q
q
q
q
q
q
q
s
s
r
s
s
q
o
q
q
"}
(37,1,1) = {"
m
m
m
m
m
m
m
m
m
v
q
q
q
q
q
q
q
q
q
q
q
q
q
s
s
s
s
s
q
o
q
q
"}
(38,1,1) = {"
m
m
m
m
m
m
m
m
m
v
q
q
q
q
q
q
q
q
q
q
q
q
q
s
s
s
s
s
q
o
q
q
"}
(39,1,1) = {"
m
m
m
m
m
m
m
m
m
v
q
q
q
q
q
q
q
q
q
q
q
q
q
s
s
s
s
s
q
o
M
M
"}
(40,1,1) = {"
m
m
m
m
m
m
m
m
m
v
v
v
v
v
v
v
v
v
v
v
q
q
q
s
s
s
r
s
q
o
M
g
"}
(41,1,1) = {"
m
m
m
m
m
m
m
m
m
m
m
m
m
m
m
m
m
m
m
v
q
q
q
s
s
s
r
s
q
o
M
L
"}
(42,1,1) = {"
m
m
m
m
m
m
m
m
m
m
m
m
m
m
m
m
m
m
m
v
q
q
q
s
s
s
s
s
q
o
M
N
"}
(43,1,1) = {"
m
m
m
m
m
m
m
m
m
m
m
m
m
m
m
m
m
m
m
v
q
q
q
d
r
s
d
s
q
o
M
M
"}
(44,1,1) = {"
m
m
m
m
m
m
m
m
m
m
m
m
m
m
m
m
m
m
m
v
q
q
q
s
s
s
s
s
s
o
M
S
"}
(45,1,1) = {"
m
m
m
m
m
m
m
m
m
m
m
m
m
m
m
m
m
m
m
v
q
q
q
s
s
s
s
s
s
f
M
A
"}
(46,1,1) = {"
m
m
m
m
m
m
m
m
m
m
m
m
m
m
m
m
m
m
m
v
q
q
q
s
s
s
s
s
s
f
M
A
"}
(47,1,1) = {"
m
m
m
m
m
m
m
m
m
m
m
m
m
m
m
m
m
m
m
v
q
q
q
s
s
s
s
s
q
o
M
Q
"}
(48,1,1) = {"
m
m
m
m
m
m
m
m
m
m
m
m
m
m
m
m
m
m
m
v
q
q
q
q
s
s
s
r
q
o
M
M
"}
(49,1,1) = {"
m
m
m
m
m
m
m
m
m
m
m
m
m
m
m
m
m
m
m
v
q
q
q
q
s
s
s
s
q
q
o
M
"}
(50,1,1) = {"
m
m
m
m
m
m
m
m
m
m
m
m
m
m
m
m
m
m
m
v
q
q
q
q
s
s
s
s
s
s
q
o
"}
(51,1,1) = {"
m
m
m
m
m
m
m
m
m
m
m
m
m
m
m
m
m
m
m
v
q
q
q
q
q
s
s
R
s
s
s
E
"}
(52,1,1) = {"
m
m
m
m
m
m
m
m
m
m
m
m
m
m
m
m
m
m
m
v
q
q
q
q
q
s
d
s
s
s
d
s
"}
(53,1,1) = {"
m
m
m
m
m
m
m
m
m
m
m
m
m
m
m
m
m
m
m
v
q
q
q
q
q
q
s
s
r
s
s
s
"}
(54,1,1) = {"
m
m
m
m
m
m
m
m
m
m
m
m
m
m
m
m
m
m
m
v
q
q
q
q
q
q
s
s
s
s
s
s
"}
(55,1,1) = {"
m
m
m
m
m
m
m
m
m
m
m
m
m
m
m
m
m
m
m
v
q
q
q
q
q
q
q
s
p
s
s
s
"}
(56,1,1) = {"
m
m
m
m
m
m
m
m
m
m
m
m
m
m
m
m
m
m
m
v
q
q
q
q
q
q
q
s
s
s
r
s
"}
(57,1,1) = {"
m
m
m
m
m
m
m
m
m
m
m
m
m
m
m
m
m
m
m
v
q
q
q
q
q
q
q
s
s
s
s
s
"}
(58,1,1) = {"
m
m
m
m
m
m
m
m
m
m
m
m
m
m
m
m
m
m
m
v
q
q
q
q
q
q
q
s
s
s
d
s
"}
(59,1,1) = {"
m
m
m
m
m
m
m
m
m
m
m
m
m
m
m
m
m
m
m
v
q
q
q
q
q
q
q
s
s
s
s
s
"}
(60,1,1) = {"
m
m
m
m
m
m
m
m
m
m
m
m
m
m
m
m
m
m
m
v
q
q
q
q
q
q
q
q
s
s
d
s
"}
(61,1,1) = {"
m
m
m
m
m
m
m
m
m
m
m
m
m
m
m
m
m
m
m
v
q
q
q
q
q
q
q
q
q
s
r
s
"}
(62,1,1) = {"
m
m
m
m
m
m
m
m
m
m
m
m
m
m
m
m
m
m
m
v
q
q
q
q
q
q
q
q
q
s
s
s
"}
(63,1,1) = {"
m
m
m
m
m
m
m
m
m
m
m
m
m
m
m
m
m
m
m
v
q
q
q
q
q
q
q
q
q
s
s
s
"}
(64,1,1) = {"
m
m
m
m
m
m
m
m
m
m
m
m
m
m
m
m
m
m
m
v
q
q
q
q
q
q
q
q
q
s
s
s
"}
(65,1,1) = {"
m
m
m
m
m
m
m
m
m
m
m
m
m
m
m
m
m
m
m
v
q
q
q
q
q
q
q
q
q
s
r
s
"}
