//MAP CONVERTED BY dmm2tgm.py THIS HEADER COMMENT PREVENTS RECONVERSION, DO NOT REMOVE
"b" = (
/obj/effect/landmark/weed_node,
/turf/open/floor/plating/ground/mars/random/cave/rock,
/area/bigredv2/caves/south/garbledradio)
"c" = (
/turf/open/floor/plating/ground/mars/random/cave/rock,
/area/bigredv2/caves/southwest)
"d" = (
/obj/effect/landmark/weed_node,
/obj/effect/ai_node,
/turf/open/floor/plating/ground/mars/random/cave,
/area/bigredv2/caves/south/garbledradio)
"h" = (
/obj/effect/ai_node,
/turf/open/floor/plating/ground/mars/random/cave/rock,
/area/bigredv2/caves/southwest)
"i" = (
/obj/effect/landmark/lv624/fog_blocker,
/turf/closed/mineral/smooth/bigred,
/area/bigredv2/caves/rock)
"j" = (
/turf/closed/mineral/smooth/bigred,
/area/bigredv2/caves/rock)
"k" = (
/turf/open/floor/plating,
/area/bigredv2/caves/south/garbledradio)
"l" = (
/obj/effect/landmark/lv624/fog_blocker,
/obj/effect/landmark/weed_node,
/turf/open/floor/plating/ground/mars/random/cave/rock,
/area/bigredv2/caves/southwest)
"q" = (
/obj/effect/ai_node,
/turf/open/floor/plating/ground/mars/random/cave,
/area/bigredv2/caves/southwest)
"s" = (
/obj/effect/landmark/weed_node,
/turf/open/floor/plating/ground/mars/random/cave,
/area/bigredv2/caves/southwest)
"t" = (
/turf/open/floor/plating/ground/mars/random/cave,
/area/bigredv2/caves/southwest)
"u" = (
/obj/effect/landmark/weed_node,
/turf/open/floor/plating/ground/mars/random/cave,
/area/bigredv2/caves/south)
"v" = (
/turf/open/floor/plating/ground/mars/random/cave/rock,
/area/bigredv2/caves/south/garbledradio)
"A" = (
/obj/effect/landmark/excavation_site_spawner,
/turf/open/floor/plating/ground/mars/random/cave,
/area/bigredv2/caves/south/garbledradio)
"E" = (
/obj/effect/ai_node,
/turf/open/floor/plating/ground/mars/random/cave/rock,
/area/bigredv2/caves/south/garbledradio)
"F" = (
/obj/effect/ai_node,
/turf/open/floor/plating/ground/mars/random/cave,
/area/bigredv2/caves/south/garbledradio)
"M" = (
/turf/open/floor/plating/ground/mars/random/cave,
/area/bigredv2/caves/south/garbledradio)
"N" = (
/obj/effect/landmark/lv624/fog_blocker,
/turf/open/floor/plating/ground/mars/random/cave,
/area/bigredv2/caves/southwest)
"O" = (
/obj/effect/landmark/weed_node,
/turf/open/floor/plating/ground/mars/random/cave,
/area/bigredv2/caves/south/garbledradio)
"V" = (
/obj/effect/landmark/weed_node,
/turf/open/floor/plating/ground/mars/random/cave/rock,
/area/bigredv2/caves/southwest)
"W" = (
/obj/effect/ai_node,
/turf/open/floor/plating/ground/mars/random/cave,
/area/bigredv2/caves/south)
"Z" = (
/turf/open/floor/plating/ground/mars/random/cave,
/area/bigredv2/caves/south)

(1,1,1) = {"
i
j
j
j
j
j
c
t
t
t
c
j
j
j
j
t
s
j
j
j
j
j
"}
(2,1,1) = {"
N
j
j
j
j
j
j
t
q
s
c
j
j
j
j
t
t
t
j
j
j
j
"}
(3,1,1) = {"
N
j
j
j
j
j
j
t
t
t
c
j
j
j
c
t
t
j
j
j
j
j
"}
(4,1,1) = {"
N
j
j
j
j
j
t
t
s
t
c
j
j
j
c
t
s
j
j
j
j
j
"}
(5,1,1) = {"
N
c
j
j
j
j
t
t
t
t
t
j
j
c
t
t
t
j
j
j
j
j
"}
(6,1,1) = {"
N
c
j
j
c
c
t
s
t
t
t
j
j
t
s
q
j
j
j
j
j
j
"}
(7,1,1) = {"
N
s
c
h
t
t
t
t
q
t
t
t
t
t
q
j
j
j
j
j
j
j
"}
(8,1,1) = {"
N
t
t
c
t
t
t
t
t
t
t
t
t
s
t
j
j
j
j
j
j
j
"}
(9,1,1) = {"
N
V
t
t
s
t
t
j
j
j
t
t
t
t
t
j
j
j
j
j
j
j
"}
(10,1,1) = {"
l
t
t
q
j
j
j
j
j
j
j
t
t
t
t
j
j
t
j
j
j
j
"}
(11,1,1) = {"
i
j
j
j
j
j
j
j
j
j
j
j
t
s
t
t
t
t
j
j
j
j
"}
(12,1,1) = {"
j
i
j
j
j
j
j
j
j
j
j
j
t
t
t
t
s
t
j
j
j
j
"}
(13,1,1) = {"
j
j
i
i
j
j
j
j
j
j
j
j
t
t
s
t
t
j
j
j
j
j
"}
(14,1,1) = {"
j
j
j
j
i
j
j
j
j
j
j
j
t
t
t
t
j
j
j
j
j
j
"}
(15,1,1) = {"
j
j
j
j
j
i
j
j
j
j
j
j
j
t
t
c
j
j
j
j
j
j
"}
(16,1,1) = {"
j
j
j
j
j
j
i
j
j
j
j
j
j
t
q
c
c
j
j
j
j
j
"}
(17,1,1) = {"
t
j
j
j
j
j
i
j
j
j
j
j
j
t
V
c
j
j
j
j
j
j
"}
(18,1,1) = {"
s
q
j
j
j
j
i
j
j
j
j
j
j
t
t
t
j
j
j
j
j
j
"}
(19,1,1) = {"
t
t
j
j
j
j
i
j
j
j
j
j
t
t
t
t
t
j
j
j
j
j
"}
(20,1,1) = {"
c
t
j
j
j
j
i
j
j
j
t
t
t
t
s
c
s
j
j
j
j
j
"}
(21,1,1) = {"
c
t
t
j
j
j
i
j
j
j
t
t
t
t
t
c
t
j
j
j
j
j
"}
(22,1,1) = {"
s
t
t
t
s
t
N
j
j
j
s
t
t
t
t
j
j
j
j
j
j
j
"}
(23,1,1) = {"
t
t
t
t
t
t
N
t
t
j
t
t
s
t
t
j
j
j
j
j
j
j
"}
(24,1,1) = {"
t
t
t
t
t
t
N
t
t
t
t
t
t
t
t
j
j
j
j
j
j
j
"}
(25,1,1) = {"
t
t
t
t
t
j
i
t
t
t
t
c
s
t
q
t
j
j
j
j
j
j
"}
(26,1,1) = {"
O
M
M
M
O
j
i
j
j
M
M
M
M
v
M
A
j
j
j
j
j
j
"}
(27,1,1) = {"
M
F
M
M
M
j
i
j
j
j
j
j
M
M
M
O
M
j
j
j
j
j
"}
(28,1,1) = {"
v
M
M
M
M
j
i
j
j
j
j
j
j
M
M
M
M
M
M
j
j
j
"}
(29,1,1) = {"
v
O
M
M
M
j
i
j
j
j
j
j
j
M
F
b
M
F
M
M
j
j
"}
(30,1,1) = {"
M
M
M
M
O
j
i
j
j
j
j
j
j
j
M
M
M
M
O
M
M
j
"}
(31,1,1) = {"
M
M
O
M
M
j
i
j
j
j
j
j
j
j
j
M
M
M
M
M
M
j
"}
(32,1,1) = {"
M
M
M
M
M
j
i
j
j
j
j
j
j
j
j
M
M
O
M
M
M
Z
"}
(33,1,1) = {"
M
M
M
M
M
j
i
j
j
j
j
j
j
j
j
j
M
M
M
M
u
Z
"}
(34,1,1) = {"
v
M
M
M
j
j
i
j
j
j
j
j
j
j
j
j
j
F
M
M
W
Z
"}
(35,1,1) = {"
v
M
O
M
j
j
i
j
j
j
j
j
j
j
j
j
j
M
M
M
v
Z
"}
(36,1,1) = {"
v
M
M
M
j
j
i
j
j
j
j
j
j
j
j
j
j
j
M
O
M
Z
"}
(37,1,1) = {"
M
M
M
M
j
j
i
j
j
j
j
j
j
j
j
j
j
j
M
M
M
Z
"}
(38,1,1) = {"
M
F
M
M
j
j
i
j
j
j
j
j
j
j
j
j
j
O
M
M
Z
Z
"}
(39,1,1) = {"
M
M
O
j
j
j
i
j
j
j
j
j
j
j
j
M
M
M
M
M
Z
Z
"}
(40,1,1) = {"
M
M
M
j
j
j
i
j
j
j
j
j
j
j
O
M
M
M
M
M
d
Z
"}
(41,1,1) = {"
M
M
M
j
j
j
i
j
j
j
j
j
j
M
M
M
M
M
E
M
M
W
"}
(42,1,1) = {"
M
M
j
j
j
j
i
j
j
j
j
j
M
M
M
M
M
M
M
A
M
Z
"}
(43,1,1) = {"
M
j
j
j
j
j
i
j
j
j
j
M
F
M
v
d
M
M
F
b
j
j
"}
(44,1,1) = {"
j
j
j
j
j
j
i
j
j
j
j
j
M
v
k
M
M
v
j
j
j
j
"}
