//MAP CONVERTED BY dmm2tgm.py THIS HEADER COMMENT PREVENTS RECONVERSION, DO NOT REMOVE
"a" = (
/turf/closed/mineral/bigred,
/area/bigredv2/caves/rock)
"e" = (
/obj/structure/curtain/medical,
/turf/open/floor/tile/darkgreen/darkgreen2{
	dir = 10
	},
/area/bigredv2/caves/lambda_lab)
"h" = (
/obj/structure/bed,
/obj/item/bedsheet/medical,
/turf/open/floor/tile/green/whitegreen{
	dir = 10
	},
/area/bigredv2/caves/lambda_lab)
"k" = (
/atom/movable/effect/landmark/lv624/fog_blocker,
/turf/closed/mineral/bigred,
/area/bigredv2/caves/rock)
"n" = (
/obj/structure/bed,
/obj/item/bedsheet/medical,
/turf/open/floor/tile/green/whitegreen{
	dir = 9
	},
/area/bigredv2/caves/lambda_lab)
"p" = (
/turf/open/floor/tile/darkgreen/darkgreen2{
	dir = 10
	},
/area/bigredv2/caves/lambda_lab)
"q" = (
/turf/open/floor/plating/ground/mars/random/cave,
/area/bigredv2/caves/northeast)
"r" = (
/atom/movable/effect/landmark/xeno_resin_door,
/atom/movable/effect/decal/sandedge{
	dir = 4
	},
/turf/open/floor/plating/dmg2,
/area/bigredv2/caves/lambda_lab)
"u" = (
/obj/structure/table/reinforced,
/obj/machinery/microwave,
/obj/machinery/light,
/turf/open/floor/tile/green/whitegreen{
	dir = 10
	},
/area/bigredv2/caves/lambda_lab)
"w" = (
/turf/closed/wall/r_wall,
/area/bigredv2/caves/lambda_lab)
"y" = (
/atom/movable/effect/landmark/xeno_resin_door,
/turf/open/floor/plating/ground/mars/random/cave,
/area/bigredv2/caves/northeast)
"D" = (
/obj/structure/curtain/medical,
/obj/machinery/alarm{
	dir = 1
	},
/turf/open/floor/tile/green/whitegreen{
	dir = 10
	},
/area/bigredv2/caves/lambda_lab)
"J" = (
/atom/movable/effect/landmark/corpsespawner/doctor,
/turf/open/floor/tile/darkgreen/darkgreen2/corner{
	dir = 8
	},
/area/bigredv2/caves/lambda_lab)
"K" = (
/atom/movable/effect/decal/cleanable/vomit,
/turf/open/floor/tile/darkgreen/darkgreen2/corner{
	dir = 1
	},
/area/bigredv2/caves/lambda_lab)
"N" = (
/obj/structure/curtain/medical,
/turf/open/floor/tile/darkgreen/darkgreen2{
	dir = 9
	},
/area/bigredv2/caves/lambda_lab)
"Q" = (
/atom/movable/effect/landmark/lv624/fog_blocker,
/turf/open/floor/plating/ground/mars/random/cave,
/area/bigredv2/caves/northeast)
"S" = (
/atom/movable/effect/landmark/weed_node,
/turf/open/floor/plating/ground/mars/random/cave,
/area/bigredv2/caves/northeast)
"Y" = (
/turf/open/floor/plating/ground/mars/random/cave/rock,
/area/bigredv2/caves/northeast)

(1,1,1) = {"
Y
q
Y
q
a
a
"}
(2,1,1) = {"
a
a
y
y
a
a
"}
(3,1,1) = {"
a
a
q
q
q
a
"}
(4,1,1) = {"
a
a
q
q
q
S
"}
(5,1,1) = {"
a
q
q
q
q
q
"}
(6,1,1) = {"
a
a
q
S
q
a
"}
(7,1,1) = {"
a
a
q
q
q
a
"}
(8,1,1) = {"
a
a
q
q
q
q
"}
(9,1,1) = {"
a
q
q
q
S
Q
"}
(10,1,1) = {"
q
q
S
q
q
Q
"}
(11,1,1) = {"
q
q
q
q
q
Q
"}
(12,1,1) = {"
a
q
q
q
S
Q
"}
(13,1,1) = {"
a
a
q
q
q
Q
"}
(14,1,1) = {"
a
a
q
q
q
Q
"}
(15,1,1) = {"
a
a
q
q
q
k
"}
(16,1,1) = {"
a
S
q
S
a
k
"}
(17,1,1) = {"
a
q
q
q
a
k
"}
(18,1,1) = {"
a
q
q
q
a
k
"}
(19,1,1) = {"
q
q
S
q
a
k
"}
(20,1,1) = {"
q
S
q
a
a
k
"}
(21,1,1) = {"
q
q
a
a
a
k
"}
(22,1,1) = {"
r
r
w
a
a
k
"}
(23,1,1) = {"
n
h
w
w
a
k
"}
(24,1,1) = {"
N
e
D
w
w
k
"}
(25,1,1) = {"
K
J
p
u
w
k
"}
