//MAP CONVERTED BY dmm2tgm.py THIS HEADER COMMENT PREVENTS RECONVERSION, DO NOT REMOVE
"ab" = (
/turf/open/floor/tile/dark/red2/corner{
	dir = 8
	},
/area/bigredv2/outside/nanotrasen_lab/inside)
"ac" = (
/obj/effect/ai_node,
/turf/open/floor/plating/ground/mars/random/cave,
/area/bigredv2/caves/south)
"ad" = (
/obj/effect/decal/cleanable/dirt,
/turf/open/floor/tile/dark/red2/corner,
/area/bigredv2/outside/nanotrasen_lab/inside)
"ae" = (
/obj/structure/closet/secure_closet/security,
/turf/open/floor/tile/dark/red2/corner{
	dir = 8
	},
/area/bigredv2/outside/nanotrasen_lab/inside)
"ag" = (
/obj/effect/landmark/weed_node,
/obj/effect/ai_node,
/turf/open/floor/tile/dark/red2/corner{
	dir = 8
	},
/area/bigredv2/outside/nanotrasen_lab/inside)
"ah" = (
/turf/closed/mineral/smooth/bigred/indestructible,
/area/space)
"ai" = (
/obj/structure/rack,
/obj/item/storage/holster/belt/revolver,
/obj/item/storage/holster/belt/pistol/m4a3/officer,
/turf/open/floor/tile/dark/red2/corner{
	dir = 8
	},
/area/bigredv2/outside/nanotrasen_lab/inside)
"aj" = (
/obj/effect/decal/cleanable/dirt,
/turf/closed/wall/r_wall,
/area/bigredv2/outside/nanotrasen_lab/inside)
"ak" = (
/obj/effect/landmark/weed_node,
/turf/open/floor/tile/dark/yellow2/corner,
/area/bigredv2/outside/nanotrasen_lab/inside)
"al" = (
/obj/effect/turf_decal/sandedge{
	dir = 8
	},
/turf/open/floor/tile/dark/red2/corner{
	dir = 8
	},
/area/bigredv2/outside/nanotrasen_lab/inside)
"am" = (
/obj/effect/landmark/weed_node,
/turf/open/floor/tile/dark/red2/corner{
	dir = 8
	},
/area/bigredv2/outside/nanotrasen_lab/inside)
"an" = (
/obj/effect/landmark/lv624/fog_blocker,
/turf/open/floor/tile/dark/yellow2/corner,
/area/bigredv2/outside/nanotrasen_lab/inside)
"ao" = (
/obj/machinery/door/airlock/multi_tile/mainship/generic{
	dir = 2
	},
/obj/effect/turf_decal/sandedge{
	dir = 8
	},
/turf/open/floor/tile/dark/red2/corner{
	dir = 8
	},
/area/bigredv2/outside/nanotrasen_lab/inside)
"at" = (
/obj/machinery/door/airlock/multi_tile/mainship/generic,
/obj/effect/ai_node,
/turf/open/floor/tile/dark/yellow2/corner,
/area/bigredv2/outside/nanotrasen_lab/inside)
"au" = (
/obj/machinery/light,
/obj/effect/landmark/weed_node,
/turf/open/floor/tile/dark/red2/corner,
/area/bigredv2/outside/nanotrasen_lab/inside)
"av" = (
/obj/effect/decal/cleanable/dirt,
/turf/closed/wall/r_wall/unmeltable,
/area/bigredv2/outside/nanotrasen_lab/inside)
"aw" = (
/obj/effect/landmark/corpsespawner/colonist,
/obj/effect/decal/cleanable/blood/oil,
/turf/open/floor/plating/ground/mars/random/cave,
/area/bigredv2/caves/south)
"ax" = (
/obj/effect/decal/cleanable/dirt,
/obj/structure/rack,
/obj/item/storage/holster/belt/pistol/m4a3/full,
/obj/item/storage/holster/belt/pistol/m4a3/officer,
/turf/open/floor/tile/dark/red2/corner,
/area/bigredv2/outside/nanotrasen_lab/inside)
"az" = (
/turf/closed/wall/r_wall/unmeltable,
/area/bigredv2/outside/nanotrasen_lab/inside)
"aA" = (
/turf/open/floor/plating/ground/mars/random/cave,
/area/bigredv2/caves/south)
"aB" = (
/obj/effect/landmark/corpsespawner/colonist,
/obj/effect/decal/cleanable/blood/oil,
/turf/open/floor/tile/dark/red2/corner,
/area/bigredv2/outside/nanotrasen_lab/inside)
"aD" = (
/obj/effect/decal/cleanable/dirt,
/obj/effect/turf_decal/sandedge{
	dir = 4
	},
/turf/open/floor/tile/dark/red2/corner{
	dir = 8
	},
/area/bigredv2/outside/nanotrasen_lab/inside)
"aF" = (
/turf/open/floor/tile/dark/red2/corner,
/area/bigredv2/outside/nanotrasen_lab/inside)
"aI" = (
/turf/closed/mineral/smooth/bigred,
/area/bigredv2/caves/rock)
"aJ" = (
/obj/effect/landmark/weed_node,
/turf/open/floor/plating/ground/mars/random/cave,
/area/bigredv2/caves/south)
"aL" = (
/turf/open/floor/tile/dark/yellow2/corner,
/area/bigredv2/outside/nanotrasen_lab/inside)
"aM" = (
/obj/structure/bed/chair/office/light{
	dir = 1
	},
/turf/open/floor/tile/dark/red2/corner{
	dir = 8
	},
/area/bigredv2/outside/nanotrasen_lab/inside)
"aO" = (
/obj/effect/landmark/lv624/fog_blocker,
/turf/open/floor/plating/ground/mars/random/cave,
/area/bigredv2/caves/south)
"aP" = (
/obj/effect/landmark/lv624/fog_blocker,
/turf/closed/wall/r_wall,
/area/bigredv2/outside/nanotrasen_lab/inside)
"aQ" = (
/obj/structure/table,
/obj/item/storage/holster/belt/pistol,
/turf/open/floor/tile/dark/red2/corner,
/area/bigredv2/outside/nanotrasen_lab/inside)
"aR" = (
/turf/closed/wall/r_wall,
/area/bigredv2/outside/nanotrasen_lab/inside)
"aW" = (
/obj/effect/decal/cleanable/dirt,
/obj/machinery/door/airlock/multi_tile/mainship/generic{
	dir = 2
	},
/obj/effect/turf_decal/sandedge{
	dir = 4
	},
/turf/open/floor/tile/dark/red2/corner{
	dir = 8
	},
/area/bigredv2/outside/nanotrasen_lab/inside)
"aZ" = (
/obj/structure/table,
/obj/machinery/computer/security,
/turf/open/floor/tile/dark/red2/corner{
	dir = 8
	},
/area/bigredv2/outside/nanotrasen_lab/inside)
"JO" = (
/obj/effect/landmark/lv624/fog_blocker,
/turf/closed/mineral/smooth/bigred,
/area/bigredv2/caves/rock)
"KO" = (
/obj/machinery/light{
	dir = 4
	},
/turf/open/floor/tile/dark/red2/corner{
	dir = 8
	},
/area/bigredv2/outside/nanotrasen_lab/inside)

(1,1,1) = {"
aR
JO
aR
aj
aD
aW
aj
av
aI
ah
"}
(2,1,1) = {"
aR
JO
aR
aZ
aM
ab
ab
av
aI
ah
"}
(3,1,1) = {"
aR
aP
aR
aQ
aF
aB
au
av
aI
ah
"}
(4,1,1) = {"
at
an
aL
ab
ag
ab
aR
av
aI
ah
"}
(5,1,1) = {"
aL
an
ak
ad
ad
ad
ax
av
aI
ah
"}
(6,1,1) = {"
aR
JO
aR
ae
ab
ab
ai
az
aI
ah
"}
(7,1,1) = {"
aR
JO
aR
ae
ab
ab
aR
az
aI
ah
"}
(8,1,1) = {"
aR
JO
aR
KO
am
ab
ab
az
aI
ah
"}
(9,1,1) = {"
aR
JO
aR
aR
al
ao
aR
az
aI
ah
"}
(10,1,1) = {"
aR
JO
aI
aA
aA
aA
aA
aA
aI
ah
"}
(11,1,1) = {"
aR
JO
aI
aA
aA
aA
aA
aw
aI
ah
"}
(12,1,1) = {"
aR
JO
aI
aA
ac
aJ
aJ
aA
aI
ah
"}
(13,1,1) = {"
aR
JO
aI
aI
aA
ac
aA
aA
aI
ah
"}
(14,1,1) = {"
aR
JO
aI
aA
aA
aA
aA
aA
aI
ah
"}
(15,1,1) = {"
aR
aO
aA
aA
aA
aA
aA
aJ
aI
ah
"}
(16,1,1) = {"
aR
aO
aA
aA
aA
aJ
aA
aA
aI
ah
"}
(17,1,1) = {"
aR
aO
aA
aA
aA
aA
aA
aA
aI
ah
"}
(18,1,1) = {"
aR
JO
aI
aA
aA
aA
aA
aA
aI
ah
"}
(19,1,1) = {"
aR
JO
aI
aA
aA
aA
aA
aA
aI
ah
"}
(20,1,1) = {"
aR
JO
aA
aA
aA
aA
aA
aA
aI
ah
"}
(21,1,1) = {"
aR
aO
aA
aA
aA
ac
aA
aI
aI
ah
"}
(22,1,1) = {"
aR
aO
aA
aA
aA
aJ
aA
aI
aI
ah
"}
(23,1,1) = {"
aP
JO
aI
aI
aA
aA
aA
aI
aI
ah
"}
