//MAP CONVERTED BY dmm2tgm.py THIS HEADER COMMENT PREVENTS RECONVERSION, DO NOT REMOVE
"b" = (
/obj/effect/landmark/patrol_point/som/som_13,
/turf/open/floor/plating/ground/mars/random/cave/rock,
/area/bigredv2/caves/southwest)
"c" = (
/obj/effect/landmark/lv624/fog_blocker/xeno_spawn,
/turf/open/floor/plating/ground/mars/random/cave,
/area/bigredv2/caves/southwest)
"d" = (
/obj/effect/ai_node,
/turf/open/floor/plating/ground/mars/random/cave/rock,
/area/bigredv2/caves/southwest)
"g" = (
/obj/effect/landmark/weed_node,
/turf/open/floor/plating/ground/mars/random/cave,
/area/bigredv2/caves/southwest)
"h" = (
/obj/effect/landmark/excavation_site_spawner,
/obj/effect/ai_node,
/turf/open/floor/plating/ground/mars/random/cave,
/area/bigredv2/caves/southwest)
"j" = (
/turf/closed/mineral/smooth/bigred,
/area/bigredv2/caves/rock)
"k" = (
/obj/effect/landmark/excavation_site_spawner,
/turf/open/floor/plating/ground/mars/random/cave,
/area/bigredv2/caves/southwest)
"l" = (
/turf/closed/mineral/smooth/bigred/indestructible,
/area/space)
"m" = (
/obj/effect/landmark/weed_node,
/obj/effect/landmark/weed_node,
/turf/open/floor/plating/ground/mars/random/cave,
/area/bigredv2/caves/southwest)
"q" = (
/obj/effect/landmark/xeno_resin_wall,
/turf/open/floor/plating/ground/mars/random/cave,
/area/bigredv2/caves/southwest)
"t" = (
/obj/effect/landmark/lv624/fog_blocker/xeno_spawn,
/turf/closed/mineral/smooth/bigred,
/area/bigredv2/caves/rock)
"u" = (
/obj/effect/landmark/lv624/fog_blocker/xeno_spawn,
/turf/open/floor/plating/ground/mars/random/cave/rock,
/area/bigredv2/caves/southwest)
"v" = (
/obj/effect/landmark/xeno_tunnel_spawn,
/turf/open/floor/plating/ground/mars/random/cave,
/area/bigredv2/caves/southwest)
"w" = (
/obj/effect/landmark/xeno_resin_door,
/turf/open/floor/plating/ground/mars/random/cave,
/area/bigredv2/caves/southwest)
"x" = (
/obj/effect/landmark/weed_node,
/obj/effect/landmark/xeno_resin_wall,
/turf/open/floor/plating/ground/mars/random/cave,
/area/bigredv2/caves/southwest)
"z" = (
/obj/effect/landmark/lv624/fog_blocker,
/turf/open/floor/plating/ground/mars/random/cave,
/area/bigredv2/caves/southwest)
"D" = (
/turf/open/floor/plating/ground/mars/random/cave/rock,
/area/bigredv2/caves/southwest)
"F" = (
/obj/effect/landmark/weed_node,
/obj/effect/ai_node,
/turf/open/floor/plating/ground/mars/random/cave,
/area/bigredv2/caves/southwest)
"J" = (
/obj/effect/landmark/xeno_resin_wall,
/turf/open/floor/plating/ground/mars/random/cave/rock,
/area/bigredv2/caves/southwest)
"M" = (
/obj/effect/ai_node,
/turf/open/floor/plating/ground/mars/random/cave,
/area/bigredv2/caves/southwest)
"N" = (
/obj/effect/landmark/patrol_point/som/som_14,
/turf/open/floor/plating/ground/mars/random/cave,
/area/bigredv2/caves/southwest)
"O" = (
/obj/effect/landmark/lv624/fog_blocker,
/turf/closed/mineral/smooth/bigred,
/area/bigredv2/caves/rock)
"Q" = (
/obj/effect/landmark/weed_node,
/turf/open/floor/plating/ground/mars/random/cave/rock,
/area/bigredv2/caves/southwest)
"R" = (
/obj/effect/landmark/patrol_point/som/som_11,
/turf/open/floor/plating/ground/mars/random/cave,
/area/bigredv2/caves/southwest)
"S" = (
/turf/open/floor/plating/ground/mars/random/cave,
/area/bigredv2/caves/southwest)
"W" = (
/obj/effect/landmark/patrol_point/som/som_12,
/turf/open/floor/plating/ground/mars/random/cave,
/area/bigredv2/caves/southwest)
"Y" = (
/obj/effect/landmark/xeno_silo_spawn,
/turf/open/floor/plating/ground/mars/random/cave,
/area/bigredv2/caves/southwest)

(1,1,1) = {"
l
l
l
l
l
l
l
l
l
l
l
l
l
l
l
l
l
l
l
l
l
l
l
l
l
l
l
l
l
l
l
l
l
l
l
l
l
l
l
l
l
l
l
"}
(2,1,1) = {"
j
j
j
j
j
j
j
j
j
j
j
j
j
j
j
j
j
j
j
j
j
j
j
j
j
j
j
j
j
j
j
j
j
j
j
l
l
l
l
l
l
l
l
"}
(3,1,1) = {"
j
j
j
j
j
j
j
j
j
j
j
j
j
j
j
j
j
j
j
j
j
j
j
j
j
j
j
j
j
j
j
j
j
j
j
l
l
l
l
l
l
l
l
"}
(4,1,1) = {"
j
j
j
j
j
j
j
j
j
j
j
j
j
j
j
j
j
j
j
j
j
j
j
j
j
j
j
j
j
j
j
j
j
j
j
l
l
l
l
l
l
l
l
"}
(5,1,1) = {"
j
j
j
j
j
j
j
j
j
j
j
j
j
j
j
j
j
j
j
j
j
j
j
j
j
j
j
j
j
j
j
j
j
j
j
l
l
l
l
l
l
l
l
"}
(6,1,1) = {"
j
j
j
j
j
j
j
j
j
j
j
j
j
j
j
j
j
j
j
j
j
j
j
j
j
j
j
j
j
j
j
j
j
j
j
l
l
l
l
l
l
l
l
"}
(7,1,1) = {"
j
j
j
j
j
j
j
j
j
j
j
j
j
j
j
j
j
j
j
j
j
j
j
j
j
j
j
j
j
j
j
j
j
j
j
l
l
l
l
l
l
l
l
"}
(8,1,1) = {"
j
j
j
j
j
j
j
j
j
j
j
j
j
j
j
j
j
j
j
j
j
j
j
j
j
j
j
j
j
j
j
j
j
j
j
l
l
l
l
l
l
l
l
"}
(9,1,1) = {"
j
j
j
j
j
j
j
j
j
j
j
j
j
j
j
j
j
j
j
j
j
R
S
j
j
j
j
j
j
j
j
j
j
j
j
l
l
l
l
l
l
l
l
"}
(10,1,1) = {"
S
S
j
j
j
j
j
j
j
j
j
j
j
j
j
j
j
S
S
g
S
S
S
j
j
j
j
j
j
j
j
j
j
j
j
l
l
l
l
l
l
l
l
"}
(11,1,1) = {"
g
S
S
j
j
j
j
j
j
j
j
j
j
j
j
j
S
S
S
S
S
S
S
S
j
j
j
j
j
j
j
j
j
j
j
l
l
l
l
l
l
l
l
"}
(12,1,1) = {"
S
S
S
D
D
j
j
j
j
j
j
j
j
j
j
j
S
S
j
j
S
S
S
S
j
j
j
j
j
j
j
j
j
j
j
l
l
l
l
l
l
l
l
"}
(13,1,1) = {"
S
D
d
S
D
j
j
j
j
j
j
j
j
j
j
g
S
S
j
j
j
j
S
S
g
j
j
j
j
j
j
j
j
j
j
l
l
l
l
l
l
l
l
"}
(14,1,1) = {"
S
S
D
S
D
j
j
j
j
j
j
j
j
j
j
S
S
S
S
j
j
j
S
S
S
j
j
j
j
j
j
j
j
j
j
l
l
l
l
l
l
l
l
"}
(15,1,1) = {"
S
S
S
S
D
j
j
j
j
j
j
j
j
j
j
S
S
S
S
g
j
j
j
S
S
j
j
j
j
j
j
j
j
j
j
l
l
l
l
l
l
l
l
"}
(16,1,1) = {"
S
S
m
S
d
j
j
j
j
j
j
j
j
j
j
S
g
S
S
S
S
j
j
S
W
j
j
j
j
j
j
j
j
j
j
l
l
l
l
l
l
l
l
"}
(17,1,1) = {"
S
g
S
S
g
d
j
j
j
j
j
D
D
D
S
S
S
S
S
k
S
S
S
S
S
j
j
j
j
j
j
j
j
j
j
l
l
l
l
l
l
l
l
"}
(18,1,1) = {"
S
S
S
S
S
D
j
j
j
j
j
D
S
S
S
S
S
S
S
S
g
S
S
m
S
j
j
j
j
j
j
j
j
j
j
l
l
l
l
l
l
l
l
"}
(19,1,1) = {"
S
g
M
g
S
S
D
S
j
j
j
S
M
S
S
S
S
S
S
S
S
g
S
D
S
S
j
j
j
j
j
j
j
j
j
l
l
l
l
l
l
l
l
"}
(20,1,1) = {"
j
S
S
S
S
S
S
S
S
j
S
S
S
S
S
S
S
S
S
S
S
S
S
D
S
S
S
j
j
j
j
j
j
j
j
l
l
l
l
l
l
l
l
"}
(21,1,1) = {"
j
j
j
S
S
S
S
S
S
S
S
S
S
S
S
g
S
S
S
S
S
S
D
S
S
g
S
j
j
j
j
j
j
j
j
l
l
l
l
l
l
l
l
"}
(22,1,1) = {"
j
j
j
S
S
M
S
S
S
S
S
S
M
S
S
M
D
j
b
S
S
S
D
j
j
S
S
j
j
j
j
j
j
j
j
l
l
l
l
l
l
l
l
"}
(23,1,1) = {"
j
j
j
S
S
S
S
S
S
S
S
S
S
S
S
D
j
j
j
j
j
j
j
j
j
S
S
S
j
j
j
j
j
j
j
l
l
l
l
l
l
l
l
"}
(24,1,1) = {"
j
j
j
S
S
g
S
S
D
S
S
D
S
g
S
D
j
j
j
j
j
j
j
j
N
S
S
S
j
j
j
j
j
j
j
l
l
l
l
l
l
l
l
"}
(25,1,1) = {"
j
j
j
D
S
S
S
g
S
S
Q
S
S
S
S
j
j
j
j
j
j
j
j
j
S
F
S
S
j
j
j
j
j
j
j
l
l
l
l
l
l
l
l
"}
(26,1,1) = {"
j
j
j
j
M
S
S
S
S
S
S
g
D
S
S
t
t
t
t
t
t
t
t
t
t
S
M
S
j
j
j
j
j
j
j
l
l
l
l
l
l
l
l
"}
(27,1,1) = {"
j
j
j
S
g
M
S
S
S
S
S
S
M
S
S
t
j
j
j
j
j
j
j
j
t
S
S
g
S
j
j
j
j
j
j
l
l
l
l
l
l
l
l
"}
(28,1,1) = {"
j
j
S
S
S
S
S
S
S
S
S
S
g
S
D
t
j
j
j
S
g
v
j
j
t
j
S
S
S
j
j
j
j
j
j
l
l
l
l
l
l
l
l
"}
(29,1,1) = {"
j
j
S
S
S
S
S
g
S
S
S
S
S
g
S
t
j
j
S
S
S
Y
S
j
t
j
S
g
S
j
j
j
j
j
j
l
l
l
l
l
l
l
l
"}
(30,1,1) = {"
j
j
S
g
S
S
S
S
g
D
j
D
M
S
F
c
j
j
S
g
S
S
g
j
t
j
S
g
S
S
j
j
j
j
j
l
l
l
l
l
l
l
l
"}
(31,1,1) = {"
j
S
S
S
S
S
S
S
S
D
j
j
D
M
g
c
q
j
M
S
S
S
S
j
t
j
d
S
S
S
j
j
j
j
j
l
l
l
l
l
l
l
l
"}
(32,1,1) = {"
j
S
M
S
S
M
j
S
S
D
j
j
j
S
S
c
q
M
S
S
S
S
j
j
t
j
D
d
g
S
j
j
j
j
j
l
l
l
l
l
l
l
l
"}
(33,1,1) = {"
j
S
S
S
j
j
j
D
D
j
j
j
j
S
S
c
x
S
g
S
D
g
j
j
t
j
j
D
M
S
S
j
j
j
j
l
l
l
l
l
l
l
l
"}
(34,1,1) = {"
j
S
S
S
j
j
j
j
j
j
j
j
j
j
S
c
q
w
w
w
q
J
j
j
t
j
j
j
S
S
S
S
j
j
j
l
l
l
l
l
l
l
l
"}
(35,1,1) = {"
j
S
S
j
j
j
j
j
j
j
j
j
j
S
S
c
c
c
c
c
u
t
t
t
t
j
j
j
S
S
S
j
j
j
j
l
l
l
l
l
l
l
l
"}
(36,1,1) = {"
j
S
S
j
j
j
j
j
j
j
j
j
j
D
F
S
S
g
F
S
D
j
j
j
j
j
j
j
S
g
S
j
j
j
j
l
l
l
l
l
l
l
l
"}
(37,1,1) = {"
S
S
S
j
j
j
j
j
j
j
j
j
j
j
j
j
S
h
S
M
S
d
j
j
j
j
j
j
S
k
S
j
j
j
j
l
l
l
l
l
l
l
l
"}
(38,1,1) = {"
S
S
S
j
j
j
j
j
j
j
j
j
j
j
j
j
S
S
S
S
S
D
j
j
j
j
D
Q
S
g
S
j
j
j
j
l
l
l
l
l
l
l
l
"}
(39,1,1) = {"
S
S
S
j
j
j
j
j
j
j
j
j
j
j
j
j
D
S
S
S
S
D
j
j
j
j
D
D
S
S
j
j
j
j
j
l
l
l
l
l
l
l
l
"}
(40,1,1) = {"
S
g
S
j
j
j
j
j
j
j
j
j
j
j
j
j
j
j
j
g
g
S
D
D
j
j
j
j
S
S
j
j
j
j
j
l
l
l
l
l
l
l
l
"}
(41,1,1) = {"
z
z
z
O
O
O
O
O
O
O
O
O
O
O
j
j
j
j
j
S
S
S
S
D
j
j
j
j
S
g
j
j
j
j
j
l
l
l
l
l
l
l
l
"}
