//MAP CONVERTED BY dmm2tgm.py THIS HEADER COMMENT PREVENTS RECONVERSION, DO NOT REMOVE
"a" = (
/turf/closed/wall/indestructible/mineral,
/area/space)
"h" = (
/turf/closed/wall/r_wall,
/area/bigredv2/outside/nanotrasen_lab/inside)
"n" = (
/turf/closed/mineral/bigred,
/area/bigredv2/caves/rock)
"o" = (
/atom/movable/effect/landmark/lv624/fog_blocker,
/turf/open/floor/plating/ground/mars/random/cave,
/area/bigredv2/caves/south)
"p" = (
/atom/movable/effect/landmark/lv624/fog_blocker,
/atom/movable/effect/landmark/weed_node,
/turf/open/floor/plating/ground/mars/random/cave,
/area/bigredv2/caves/south)
"z" = (
/atom/movable/effect/landmark/weed_node,
/turf/open/floor/plating/ground/mars/random/cave,
/area/bigredv2/caves/south)
"F" = (
/atom/movable/effect/landmark/lv624/fog_blocker,
/turf/closed/mineral/bigred,
/area/bigredv2/caves/rock)
"O" = (
/atom/movable/effect/landmark/lv624/fog_blocker,
/turf/closed/wall/r_wall,
/area/bigredv2/outside/nanotrasen_lab/inside)
"P" = (
/turf/open/floor/plating/ground/mars/random/cave,
/area/bigredv2/caves/south)
"Q" = (
/atom/movable/effect/landmark/lv624/fog_blocker,
/atom/movable/effect/ai_node,
/turf/open/floor/plating/ground/mars/random/cave,
/area/bigredv2/caves/south)
"X" = (
/atom/movable/effect/ai_node,
/turf/open/floor/plating/ground/mars/random/cave,
/area/bigredv2/caves/south)

(1,1,1) = {"
h
F
n
z
P
X
z
n
n
a
"}
(2,1,1) = {"
h
F
n
P
P
P
P
n
n
a
"}
(3,1,1) = {"
h
F
n
P
z
P
P
n
n
a
"}
(4,1,1) = {"
h
F
n
n
P
P
P
P
n
a
"}
(5,1,1) = {"
h
F
n
n
z
P
z
P
n
a
"}
(6,1,1) = {"
h
F
n
n
P
X
P
X
n
a
"}
(7,1,1) = {"
h
F
n
n
P
z
P
z
n
a
"}
(8,1,1) = {"
h
F
n
P
P
P
P
P
n
a
"}
(9,1,1) = {"
h
F
n
z
P
z
P
P
n
a
"}
(10,1,1) = {"
h
F
n
P
P
P
P
n
n
a
"}
(11,1,1) = {"
h
F
n
P
P
X
P
n
n
a
"}
(12,1,1) = {"
h
F
n
P
z
P
z
n
n
a
"}
(13,1,1) = {"
h
F
P
P
P
P
P
n
n
a
"}
(14,1,1) = {"
h
o
P
z
z
P
z
n
n
a
"}
(15,1,1) = {"
h
Q
P
P
P
X
n
n
n
a
"}
(16,1,1) = {"
h
p
P
P
z
P
n
n
n
a
"}
(17,1,1) = {"
h
F
P
z
P
z
n
n
n
a
"}
(18,1,1) = {"
h
F
n
P
P
P
P
n
n
a
"}
(19,1,1) = {"
h
F
n
n
z
X
z
n
n
a
"}
(20,1,1) = {"
h
F
n
n
P
P
P
n
n
a
"}
(21,1,1) = {"
h
F
n
n
z
P
n
n
n
a
"}
(22,1,1) = {"
h
F
n
P
P
P
n
n
n
a
"}
(23,1,1) = {"
O
F
n
P
z
X
n
n
n
a
"}
