//MAP CONVERTED BY dmm2tgm.py THIS HEADER COMMENT PREVENTS RECONVERSION, DO NOT REMOVE
"g" = (
/atom/movable/effect/landmark/lv624/fog_blocker/xeno_spawn,
/turf/open/floor/plating/ground/mars/random/cave,
/area/bigredv2/caves/northeast)
"h" = (
/atom/movable/effect/landmark/lv624/fog_blocker/xeno_spawn,
/atom/movable/effect/landmark/lv624/fog_blocker/xeno_spawn,
/turf/closed/mineral/smooth/bigred,
/area/bigredv2/caves/rock)
"I" = (
/atom/movable/effect/landmark/weed_node,
/turf/open/floor/plating/ground/mars/random/cave,
/area/bigredv2/caves/northeast)
"K" = (
/turf/open/floor/plating/ground/mars/random/cave,
/area/bigredv2/caves/northeast)
"L" = (
/turf/closed/mineral/smooth/bigred,
/area/bigredv2/caves/rock)
"R" = (
/atom/movable/effect/landmark/lv624/fog_blocker/xeno_spawn,
/turf/closed/mineral/smooth/bigred,
/area/bigredv2/caves/rock)

(1,1,1) = {"
g
K
K
K
K
K
L
L
L
L
L
R
L
L
L
"}
(2,1,1) = {"
R
L
L
L
L
L
L
L
L
L
L
R
L
L
L
"}
(3,1,1) = {"
R
L
L
L
L
L
L
L
L
L
L
R
L
K
K
"}
(4,1,1) = {"
R
L
L
L
L
L
L
L
L
L
L
R
K
K
I
"}
(5,1,1) = {"
R
L
L
L
L
L
L
L
L
L
L
R
K
K
K
"}
(6,1,1) = {"
R
L
L
L
L
L
L
L
L
L
L
R
K
K
K
"}
(7,1,1) = {"
R
L
L
L
L
L
L
L
L
L
L
R
K
K
K
"}
(8,1,1) = {"
R
L
L
L
L
L
L
L
L
L
L
R
K
K
K
"}
(9,1,1) = {"
R
L
L
L
L
L
L
L
L
L
L
h
K
K
I
"}
(10,1,1) = {"
R
L
L
L
L
L
L
L
L
L
L
h
K
K
K
"}
(11,1,1) = {"
R
L
L
L
L
L
L
L
L
L
L
R
L
K
K
"}
(12,1,1) = {"
R
L
L
L
L
L
L
L
L
L
L
R
L
L
K
"}
(13,1,1) = {"
R
L
L
L
L
L
L
L
L
L
L
R
L
L
L
"}
(14,1,1) = {"
R
L
L
L
L
L
L
L
L
L
L
R
R
R
R
"}
(15,1,1) = {"
R
L
L
L
L
L
L
L
L
L
L
L
L
L
R
"}
