//MAP CONVERTED BY dmm2tgm.py THIS HEADER COMMENT PREVENTS RECONVERSION, DO NOT REMOVE
"h" = (
/obj/effect/landmark/excavation_site_spawner,
/turf/open/floor/plating/ground/mars/random/cave,
/area/bigredv2/caves/south)
"k" = (
/turf/open/floor/plating/ground/mars/random/cave/rock,
/area/bigredv2/caves/south)
"q" = (
/turf/open/floor/plating/ground/mars/random/cave/rock,
/area/bigredv2/caves/southwest)
"u" = (
/turf/open/floor/plating/ground/mars/random/cave,
/area/bigredv2/caves/south)
"w" = (
/obj/effect/landmark/weed_node,
/turf/open/floor/plating/ground/mars/random/cave/rock,
/area/bigredv2/caves/south)
"z" = (
/obj/effect/landmark/weed_node,
/turf/open/floor/plating/ground/mars/random/cave,
/area/bigredv2/caves/southwest)
"A" = (
/turf/open/floor/plating,
/area/bigredv2/caves/south)
"D" = (
/obj/effect/landmark/lv624/fog_blocker,
/turf/open/floor/plating/ground/mars/random/cave,
/area/bigredv2/caves/southwest)
"H" = (
/obj/effect/landmark/lv624/fog_blocker,
/turf/closed/mineral/smooth/bigred,
/area/bigredv2/caves/rock)
"I" = (
/obj/effect/ai_node,
/turf/open/floor/plating/ground/mars/random/cave/rock,
/area/bigredv2/caves/south)
"K" = (
/obj/effect/landmark/weed_node,
/turf/open/floor/plating/ground/mars/random/cave,
/area/bigredv2/caves/south)
"M" = (
/obj/effect/ai_node,
/turf/open/floor/plating/ground/mars/random/cave,
/area/bigredv2/caves/southwest)
"P" = (
/obj/effect/landmark/weed_node,
/turf/open/floor/plating/ground/mars/random/cave/rock,
/area/bigredv2/caves/southwest)
"R" = (
/obj/effect/ai_node,
/turf/open/floor/plating/ground/mars/random/cave/rock,
/area/bigredv2/caves/southwest)
"S" = (
/turf/closed/mineral/smooth/bigred,
/area/bigredv2/caves/rock)
"T" = (
/obj/effect/ai_node,
/turf/open/floor/plating/ground/mars/random/cave,
/area/bigredv2/caves/south)
"U" = (
/obj/effect/landmark/lv624/fog_blocker,
/obj/effect/landmark/weed_node,
/turf/open/floor/plating/ground/mars/random/cave/rock,
/area/bigredv2/caves/southwest)
"V" = (
/turf/open/floor/plating/ground/mars/random/cave,
/area/bigredv2/caves/southwest)
"Y" = (
/obj/machinery/miner/damaged/platinum,
/turf/open/floor/plating/ground/mars/random/cave,
/area/bigredv2/caves/south)
"Z" = (
/obj/effect/landmark/weed_node,
/obj/effect/ai_node,
/turf/open/floor/plating/ground/mars/random/cave,
/area/bigredv2/caves/south)

(1,1,1) = {"
H
S
S
S
S
S
q
V
V
V
q
S
S
S
S
V
z
S
S
S
S
S
"}
(2,1,1) = {"
D
S
S
S
S
S
S
V
M
z
q
S
S
S
S
V
V
V
S
S
S
S
"}
(3,1,1) = {"
D
S
S
S
S
S
S
V
V
V
q
S
S
S
q
V
V
S
S
S
S
S
"}
(4,1,1) = {"
D
S
S
S
S
S
V
V
z
V
q
S
S
S
q
V
z
S
S
S
S
S
"}
(5,1,1) = {"
D
q
S
S
S
S
V
V
V
V
V
S
S
q
V
V
V
S
S
S
S
S
"}
(6,1,1) = {"
D
q
S
S
q
q
V
z
V
V
V
S
S
V
z
M
S
S
S
S
S
S
"}
(7,1,1) = {"
D
z
q
R
V
V
V
V
M
V
S
S
S
V
M
S
S
S
S
S
S
S
"}
(8,1,1) = {"
D
V
V
q
V
V
V
V
V
S
S
S
V
z
V
S
S
S
S
S
S
S
"}
(9,1,1) = {"
D
P
V
V
z
V
V
S
S
S
S
S
V
V
V
S
S
S
S
S
S
S
"}
(10,1,1) = {"
U
V
V
M
S
S
S
S
S
S
S
S
V
V
V
S
S
V
S
S
S
S
"}
(11,1,1) = {"
H
S
S
S
S
S
S
S
S
S
S
S
V
z
V
V
V
V
S
S
S
S
"}
(12,1,1) = {"
S
H
S
S
S
S
S
S
S
S
S
S
V
V
V
V
z
V
S
S
S
S
"}
(13,1,1) = {"
S
S
H
H
S
S
S
S
S
S
S
S
V
V
z
V
V
S
S
S
S
S
"}
(14,1,1) = {"
S
S
S
S
H
S
S
S
S
S
S
S
V
V
V
V
S
S
S
S
S
S
"}
(15,1,1) = {"
S
S
S
S
S
H
S
S
S
S
S
S
S
V
V
q
S
S
S
S
S
S
"}
(16,1,1) = {"
S
S
S
S
S
S
H
S
S
S
S
S
S
V
M
q
q
S
S
S
S
S
"}
(17,1,1) = {"
V
S
S
S
S
S
H
S
S
S
S
S
S
V
P
q
S
S
S
S
S
S
"}
(18,1,1) = {"
z
M
S
S
S
S
H
S
S
S
S
S
S
V
V
V
S
S
S
S
S
S
"}
(19,1,1) = {"
V
V
S
S
S
S
H
S
S
S
S
S
V
V
V
V
V
S
S
S
S
S
"}
(20,1,1) = {"
q
V
S
S
S
S
H
S
S
S
V
V
V
V
z
q
z
S
S
S
S
S
"}
(21,1,1) = {"
q
V
V
S
S
S
H
S
S
S
V
V
V
V
V
q
V
S
S
S
S
S
"}
(22,1,1) = {"
z
V
V
V
z
S
H
S
S
S
z
V
V
V
V
S
S
S
S
S
S
S
"}
(23,1,1) = {"
V
V
V
V
V
S
H
S
S
S
V
V
z
V
V
S
S
S
S
S
S
S
"}
(24,1,1) = {"
V
V
V
V
V
S
H
S
S
S
V
V
V
V
V
S
S
S
S
S
S
S
"}
(25,1,1) = {"
V
V
V
V
V
S
H
S
S
V
V
q
z
V
M
V
S
S
S
S
S
S
"}
(26,1,1) = {"
K
u
u
u
K
S
H
S
S
u
u
u
u
k
u
h
S
S
S
S
S
S
"}
(27,1,1) = {"
u
T
u
u
u
S
H
S
S
S
S
S
u
u
u
K
u
S
S
S
S
S
"}
(28,1,1) = {"
k
u
u
u
u
S
H
S
S
S
S
S
S
u
u
u
u
u
u
S
S
S
"}
(29,1,1) = {"
k
K
u
u
u
S
H
S
S
S
S
S
S
u
T
w
u
T
u
u
S
S
"}
(30,1,1) = {"
u
u
u
u
K
S
H
S
S
S
S
S
S
S
u
u
u
u
K
u
u
S
"}
(31,1,1) = {"
u
u
K
u
u
S
H
S
S
S
S
S
S
S
S
u
u
u
u
u
u
S
"}
(32,1,1) = {"
u
u
u
u
u
S
H
S
S
S
S
S
S
S
S
u
u
K
u
u
u
u
"}
(33,1,1) = {"
u
u
u
u
u
S
H
S
S
S
S
S
S
S
S
S
u
u
u
u
K
u
"}
(34,1,1) = {"
k
u
u
u
S
S
H
S
S
S
S
S
S
S
S
S
S
T
u
u
T
u
"}
(35,1,1) = {"
k
u
K
u
S
S
H
S
S
S
S
S
S
S
S
S
S
u
u
u
k
u
"}
(36,1,1) = {"
k
u
u
u
S
S
H
S
S
S
S
S
S
S
S
S
S
S
u
K
u
u
"}
(37,1,1) = {"
u
u
u
u
S
S
H
S
S
S
S
S
S
S
S
S
S
S
u
u
u
u
"}
(38,1,1) = {"
u
T
u
u
S
S
H
S
S
S
S
S
S
S
S
S
S
K
u
u
u
u
"}
(39,1,1) = {"
u
u
K
S
S
S
H
S
S
S
S
S
S
S
S
u
u
u
u
u
u
u
"}
(40,1,1) = {"
u
u
u
S
S
S
H
S
S
S
S
S
S
S
K
u
u
u
Y
u
Z
u
"}
(41,1,1) = {"
u
u
u
S
S
S
H
S
S
S
S
S
S
u
u
u
u
u
I
u
u
T
"}
(42,1,1) = {"
u
u
S
S
S
S
H
S
S
S
S
S
u
u
u
u
u
u
u
h
u
u
"}
(43,1,1) = {"
u
S
S
S
S
S
H
S
S
S
S
u
T
u
k
Z
u
u
T
w
S
S
"}
(44,1,1) = {"
S
S
S
S
S
S
H
S
S
S
S
S
u
k
A
u
u
k
S
S
S
S
"}
