//MAP CONVERTED BY dmm2tgm.py THIS HEADER COMMENT PREVENTS RECONVERSION, DO NOT REMOVE
"bm" = (
/obj/effect/landmark/weed_node,
/turf/open/floor/plating/ground/mars/random/cave/rock,
/area/bigredv2/caves/south)
"bT" = (
/obj/structure/table,
/obj/machinery/light,
/obj/effect/spawner/random/technology_scanner,
/obj/item/xenos_claw,
/turf/open/floor/tile/dark/red2/corner{
	dir = 8
	},
/area/bigredv2/outside/nanotrasen_lab/inside)
"cg" = (
/obj/machinery/light{
	dir = 4
	},
/obj/effect/decal/cleanable/dirt,
/obj/effect/landmark/weed_node,
/obj/effect/ai_node,
/turf/open/floor/tile/dark/red2/corner,
/area/bigredv2/outside/nanotrasen_lab/inside)
"ci" = (
/obj/structure/cable,
/obj/effect/ai_node,
/turf/open/floor/plating,
/area/bigredv2/outside/nanotrasen_lab/inside)
"cG" = (
/obj/structure/closet/l3closet/scientist,
/turf/open/floor/tile/darkgreen/darkgreen2{
	dir = 9
	},
/area/bigredv2/outside/nanotrasen_lab/inside)
"cQ" = (
/obj/structure/xenoautopsy/tank/broken,
/turf/open/floor/tile/dark/red2/corner{
	dir = 8
	},
/area/bigredv2/outside/nanotrasen_lab/inside)
"cU" = (
/turf/open/floor/plating,
/area/bigredv2/outside/nanotrasen_lab/inside)
"ey" = (
/obj/effect/landmark/weed_node,
/turf/open/ground/jungle/clear,
/area/bigredv2/outside/nanotrasen_lab/inside)
"eA" = (
/obj/effect/ai_node,
/obj/effect/landmark/lv624/fog_blocker/xeno_spawn,
/turf/open/floor/plating/ground/mars/random/cave,
/area/bigredv2/caves/south)
"eQ" = (
/obj/effect/ai_node,
/turf/open/floor/tile/dark,
/area/bigredv2/outside/nanotrasen_lab/inside)
"eZ" = (
/obj/effect/decal/cleanable/dirt,
/turf/open/floor/tile/dark,
/area/bigredv2/outside/nanotrasen_lab/inside)
"fk" = (
/obj/structure/bed/chair{
	dir = 4
	},
/obj/effect/decal/sandedge/corner2{
	dir = 4
	},
/turf/open/floor/tile/dark/red2{
	dir = 4
	},
/area/bigredv2/outside/nanotrasen_lab/inside)
"gE" = (
/obj/effect/landmark/lv624/fog_blocker,
/turf/closed/mineral/bigred,
/area/bigredv2/caves/rock)
"gQ" = (
/obj/structure/table,
/obj/effect/spawner/random/technology_scanner,
/turf/open/floor/tile/dark/red2/corner{
	dir = 4
	},
/area/bigredv2/outside/nanotrasen_lab/inside)
"hB" = (
/obj/effect/landmark/lv624/fog_blocker/xeno_spawn,
/turf/closed/mineral/bigred,
/area/bigredv2/caves/rock)
"hR" = (
/obj/structure/table,
/obj/item/paper,
/turf/open/floor/tile/dark/red2/corner,
/area/bigredv2/outside/nanotrasen_lab/inside)
"hV" = (
/obj/effect/landmark/weed_node,
/obj/effect/decal/sandedge{
	dir = 1
	},
/turf/open/floor/tile/dark/red2/corner,
/area/bigredv2/outside/nanotrasen_lab/inside)
"iP" = (
/obj/machinery/atmospherics/pipe/manifold/green/hidden{
	dir = 1
	},
/obj/effect/ai_node,
/turf/open/floor/tile/dark,
/area/bigredv2/outside/nanotrasen_lab/inside)
"iQ" = (
/obj/effect/decal/cleanable/dirt,
/turf/open/floor/tile/dark/red2/corner,
/area/bigredv2/outside/nanotrasen_lab/inside)
"ja" = (
/turf/open/floor/tile/dark/red2/corner{
	dir = 8
	},
/area/bigredv2/outside/nanotrasen_lab/inside)
"jK" = (
/obj/effect/landmark/weed_node,
/turf/open/floor/plating,
/area/bigredv2/outside/nanotrasen_lab/inside)
"kg" = (
/turf/closed/wall,
/area/bigredv2/outside/nanotrasen_lab/inside)
"ko" = (
/obj/effect/landmark/weed_node,
/obj/effect/landmark/excavation_site_spawner,
/turf/open/floor/plating/ground/mars/random/cave,
/area/bigredv2/caves/south)
"kJ" = (
/obj/machinery/door/airlock/mainship/research/glass/free_access{
	dir = 1;
	name = "\improper Eta Lab Cell"
	},
/turf/open/floor/tile/dark,
/area/bigredv2/outside/nanotrasen_lab/inside)
"lX" = (
/turf/open/floor/tile/dark/red2{
	dir = 1
	},
/area/bigredv2/outside/nanotrasen_lab/inside)
"mN" = (
/obj/effect/landmark/xeno_resin_door,
/turf/open/floor/plating/ground/mars/random/cave,
/area/bigredv2/caves/south)
"nj" = (
/obj/machinery/miner/damaged/platinum,
/turf/open/floor/plating/ground/mars/random/cave/rock,
/area/bigredv2/caves/south)
"ok" = (
/obj/machinery/light{
	dir = 4
	},
/turf/open/ground/jungle/clear,
/area/bigredv2/outside/nanotrasen_lab/inside)
"or" = (
/obj/structure/cable,
/obj/machinery/power/apc{
	dir = 1
	},
/turf/open/floor/plating,
/area/bigredv2/outside/nanotrasen_lab/inside)
"oB" = (
/obj/structure/bed/chair{
	dir = 8
	},
/obj/effect/landmark/weed_node,
/turf/open/floor/tile/dark/red2{
	dir = 8
	},
/area/bigredv2/outside/nanotrasen_lab/inside)
"oL" = (
/obj/structure/closet/crate/secure,
/turf/open/floor/tile/dark/red2/corner,
/area/bigredv2/outside/nanotrasen_lab/inside)
"pI" = (
/turf/closed/wall/indestructible/mineral,
/area/space)
"qc" = (
/turf/open/floor/tile/dark/red2/corner,
/area/bigredv2/outside/nanotrasen_lab/inside)
"qv" = (
/obj/effect/decal/cleanable/blood/gibs,
/turf/open/floor/plating/ground/mars/random/cave,
/area/bigredv2/caves/south)
"rR" = (
/obj/effect/landmark/weed_node,
/obj/effect/landmark/lv624/fog_blocker/xeno_spawn,
/turf/open/floor/plating/ground/mars/random/cave,
/area/bigredv2/caves/south)
"tn" = (
/obj/effect/landmark/weed_node,
/turf/open/floor/tile/dark/red2,
/area/bigredv2/outside/nanotrasen_lab/inside)
"tA" = (
/turf/open/floor/plating/ground/mars/random/sand,
/area/bigredv2/outside/nanotrasen_lab/inside)
"tM" = (
/obj/machinery/door/airlock/mainship/research/glass/free_access{
	name = "\improper Eta Lab Cell"
	},
/turf/open/floor/tile/dark,
/area/bigredv2/outside/nanotrasen_lab/inside)
"tY" = (
/obj/machinery/light{
	dir = 4
	},
/obj/effect/decal/cleanable/dirt,
/obj/effect/ai_node,
/turf/open/floor/tile/dark/red2/corner,
/area/bigredv2/outside/nanotrasen_lab/inside)
"uf" = (
/obj/effect/decal/cleanable/dirt,
/obj/effect/landmark/weed_node,
/turf/open/floor/tile/dark,
/area/bigredv2/outside/nanotrasen_lab/inside)
"un" = (
/turf/open/floor/tile/dark/red2{
	dir = 4
	},
/area/bigredv2/outside/nanotrasen_lab/inside)
"ux" = (
/obj/machinery/light,
/turf/open/floor/tile/darkgreen/darkgreen2,
/area/bigredv2/outside/nanotrasen_lab/inside)
"vM" = (
/obj/structure/bed/chair{
	dir = 4
	},
/obj/effect/landmark/excavation_site_spawner,
/turf/open/floor/tile/dark/red2{
	dir = 4
	},
/area/bigredv2/outside/nanotrasen_lab/inside)
"vR" = (
/obj/effect/landmark/weed_node,
/obj/effect/ai_node,
/turf/open/floor/tile/dark,
/area/bigredv2/outside/nanotrasen_lab/inside)
"vX" = (
/obj/structure/cable,
/turf/open/floor/plating,
/area/bigredv2/outside/nanotrasen_lab/inside)
"wF" = (
/obj/effect/landmark/corpsespawner/scientist,
/turf/open/floor/tile/dark,
/area/bigredv2/outside/nanotrasen_lab/inside)
"xw" = (
/obj/machinery/light{
	dir = 8
	},
/turf/open/floor/tile/dark/red2/corner{
	dir = 8
	},
/area/bigredv2/outside/nanotrasen_lab/inside)
"xB" = (
/turf/closed/wall/r_wall,
/area/bigredv2/outside/nanotrasen_lab/inside)
"xE" = (
/obj/effect/ai_node,
/turf/open/floor/plating/ground/mars/random/cave,
/area/bigredv2/caves/south)
"xJ" = (
/turf/open/floor/tile/darkgreen/darkgreen2{
	dir = 6
	},
/area/bigredv2/outside/nanotrasen_lab/inside)
"yR" = (
/obj/machinery/atmospherics/components/unary/vent_pump{
	dir = 4;
	on = 1
	},
/turf/open/floor/tile/dark,
/area/bigredv2/outside/nanotrasen_lab/inside)
"zn" = (
/obj/effect/landmark/weed_node,
/turf/open/floor/tile/dark/red2{
	dir = 1
	},
/area/bigredv2/outside/nanotrasen_lab/inside)
"zD" = (
/turf/open/floor/tile/dark/red2{
	dir = 6
	},
/area/bigredv2/outside/nanotrasen_lab/inside)
"zQ" = (
/obj/structure/closet/l3closet/scientist,
/turf/open/floor/tile/darkgreen/darkgreen2{
	dir = 1
	},
/area/bigredv2/outside/nanotrasen_lab/inside)
"zR" = (
/obj/effect/landmark/xeno_silo_spawn,
/turf/open/floor/plating/ground/mars/random/cave,
/area/bigredv2/caves/south)
"Ai" = (
/obj/effect/decal/cleanable/blood/oil,
/turf/open/floor/tile/dark,
/area/bigredv2/outside/nanotrasen_lab/inside)
"Am" = (
/turf/open/floor/tile/dark/red2{
	dir = 8
	},
/area/bigredv2/outside/nanotrasen_lab/inside)
"Av" = (
/obj/machinery/miner/damaged/platinum,
/turf/open/floor/plating/ground/mars/random/cave,
/area/bigredv2/caves/south)
"Ay" = (
/obj/structure/closet/toolcloset,
/turf/open/floor/plating,
/area/bigredv2/outside/nanotrasen_lab/inside)
"AB" = (
/obj/effect/decal/sandedge/corner2{
	dir = 8
	},
/turf/open/floor/tile/dark,
/area/bigredv2/outside/nanotrasen_lab/inside)
"Bj" = (
/obj/effect/decal/cleanable/blood,
/turf/open/floor/tile/dark,
/area/bigredv2/outside/nanotrasen_lab/inside)
"By" = (
/obj/structure/closet/firecloset,
/turf/open/floor/plating,
/area/bigredv2/outside/nanotrasen_lab/inside)
"BK" = (
/obj/machinery/computer/security,
/turf/open/floor/tile/dark/red2/corner{
	dir = 4
	},
/area/bigredv2/outside/nanotrasen_lab/inside)
"DG" = (
/obj/machinery/light{
	dir = 1
	},
/turf/open/floor/tile/dark/red2{
	dir = 9
	},
/area/bigredv2/outside/nanotrasen_lab/inside)
"EH" = (
/obj/machinery/light{
	dir = 8
	},
/turf/open/floor/plating/ground/mars/random/sand,
/area/bigredv2/outside/nanotrasen_lab/inside)
"FS" = (
/obj/effect/landmark/start/job/xenomorph,
/turf/open/floor/plating/ground/mars/random/sand,
/area/bigredv2/outside/nanotrasen_lab/inside)
"Gc" = (
/turf/open/floor/tile/darkgreen/darkgreen2{
	dir = 4
	},
/area/bigredv2/outside/nanotrasen_lab/inside)
"GB" = (
/obj/effect/landmark/weed_node,
/obj/effect/ai_node,
/turf/open/floor/plating/ground/mars/random/cave,
/area/bigredv2/caves/south)
"He" = (
/obj/structure/closet/l3closet/scientist,
/turf/open/floor/tile/darkgreen/darkgreen2{
	dir = 5
	},
/area/bigredv2/outside/nanotrasen_lab/inside)
"Hu" = (
/obj/effect/ai_node,
/turf/open/floor/plating/ground/mars/random/cave/rock,
/area/bigredv2/caves/south)
"Jn" = (
/obj/effect/landmark/xeno_resin_door,
/obj/effect/landmark/lv624/fog_blocker,
/turf/open/floor/plating/ground/mars/random/cave,
/area/bigredv2/outside/nanotrasen_lab/inside)
"JF" = (
/obj/structure/window/framed/colony,
/turf/open/floor/plating,
/area/bigredv2/outside/nanotrasen_lab/inside)
"JJ" = (
/obj/structure/bed/chair{
	dir = 4
	},
/turf/open/floor/tile/dark/red2{
	dir = 4
	},
/area/bigredv2/outside/nanotrasen_lab/inside)
"Kq" = (
/obj/effect/decal/cleanable/blood/xeno,
/turf/open/floor/tile/dark/red2/corner{
	dir = 4
	},
/area/bigredv2/outside/nanotrasen_lab/inside)
"KR" = (
/obj/structure/reagent_dispensers/fueltank,
/turf/open/floor/plating,
/area/bigredv2/outside/nanotrasen_lab/inside)
"Lk" = (
/turf/open/space/basic,
/area/space)
"LO" = (
/obj/structure/table,
/obj/item/alienjar,
/obj/effect/landmark/weed_node,
/turf/open/floor/tile/dark/red2/corner{
	dir = 4
	},
/area/bigredv2/outside/nanotrasen_lab/inside)
"LX" = (
/turf/open/floor/tile/dark/red2,
/area/bigredv2/outside/nanotrasen_lab/inside)
"Mq" = (
/turf/open/ground/jungle/clear,
/area/bigredv2/outside/nanotrasen_lab/inside)
"ME" = (
/turf/open/floor/tile/dark,
/area/bigredv2/outside/nanotrasen_lab/inside)
"MG" = (
/obj/structure/cable,
/obj/machinery/door/airlock/mainship/maint/free_access{
	name = "\improper Eta Lab Maintenance Storage"
	},
/turf/open/floor/tile/dark,
/area/bigredv2/outside/nanotrasen_lab/inside)
"Nt" = (
/obj/effect/landmark/start/job/xenomorph,
/turf/open/floor/tile/dark,
/area/bigredv2/outside/nanotrasen_lab/inside)
"NO" = (
/obj/machinery/atmospherics/pipe/simple/green/hidden{
	dir = 4
	},
/obj/effect/ai_node,
/turf/open/floor/tile/dark,
/area/bigredv2/outside/nanotrasen_lab/inside)
"NX" = (
/turf/open/floor/tile/darkgreen/darkgreen2{
	dir = 8
	},
/area/bigredv2/outside/nanotrasen_lab/inside)
"Or" = (
/obj/structure/table,
/obj/structure/xenoautopsy,
/turf/open/floor/tile/dark/red2/corner{
	dir = 4
	},
/area/bigredv2/outside/nanotrasen_lab/inside)
"Ox" = (
/obj/effect/landmark/weed_node,
/turf/open/floor/plating/ground/mars/random/cave,
/area/bigredv2/caves/south)
"PC" = (
/obj/effect/landmark/xeno_resin_door,
/obj/effect/landmark/lv624/fog_blocker,
/turf/open/floor/plating/ground/mars/cavetodirt{
	dir = 1
	},
/area/bigredv2/outside/nanotrasen_lab/inside)
"PD" = (
/obj/effect/landmark/lv624/fog_blocker,
/turf/closed/wall/r_wall,
/area/bigredv2/outside/nanotrasen_lab/inside)
"PG" = (
/obj/structure/xenoautopsy/tank,
/turf/open/floor/tile/dark/red2/corner{
	dir = 8
	},
/area/bigredv2/outside/nanotrasen_lab/inside)
"PY" = (
/obj/structure/xenoautopsy/tank/hugger,
/turf/open/floor/tile/dark/red2/corner{
	dir = 8
	},
/area/bigredv2/outside/nanotrasen_lab/inside)
"QX" = (
/turf/open/floor/tile/darkgreen/darkgreen2{
	dir = 10
	},
/area/bigredv2/outside/nanotrasen_lab/inside)
"SI" = (
/obj/structure/table,
/obj/effect/spawner/random/technology_scanner,
/turf/open/floor/tile/dark/red2/corner{
	dir = 8
	},
/area/bigredv2/outside/nanotrasen_lab/inside)
"SV" = (
/obj/machinery/atmospherics/pipe/simple/green/hidden{
	dir = 4
	},
/obj/machinery/door/airlock/mainship/research/glass/free_access{
	name = "\improper Eta Lab Xenobiology Lab"
	},
/turf/open/floor/tile/dark,
/area/bigredv2/outside/nanotrasen_lab/inside)
"Tc" = (
/turf/open/floor/plating/ground/mars/random/cave/rock,
/area/bigredv2/caves/south)
"Th" = (
/obj/effect/landmark/lv624/fog_blocker/xeno_spawn,
/turf/open/floor/plating/ground/mars/random/cave,
/area/bigredv2/caves/south)
"Tp" = (
/obj/machinery/atmospherics/pipe/simple/green/hidden{
	dir = 4
	},
/turf/open/floor/tile/dark,
/area/bigredv2/outside/nanotrasen_lab/inside)
"TH" = (
/obj/item/target,
/turf/open/floor/tile/dark/red2{
	dir = 1
	},
/area/bigredv2/outside/nanotrasen_lab/inside)
"TX" = (
/obj/effect/landmark/weed_node,
/turf/open/floor/tile/dark,
/area/bigredv2/outside/nanotrasen_lab/inside)
"Uk" = (
/turf/open/floor/tile/dark/red2{
	dir = 10
	},
/area/bigredv2/outside/nanotrasen_lab/inside)
"VS" = (
/obj/structure/bed/chair{
	dir = 8
	},
/turf/open/floor/tile/dark/red2{
	dir = 8
	},
/area/bigredv2/outside/nanotrasen_lab/inside)
"Ww" = (
/obj/structure/table,
/obj/item/tool/pen,
/turf/open/floor/tile/dark/red2/corner{
	dir = 4
	},
/area/bigredv2/outside/nanotrasen_lab/inside)
"WD" = (
/obj/machinery/atmospherics/components/unary/vent_pump{
	dir = 1;
	on = 1
	},
/turf/open/floor/tile/dark,
/area/bigredv2/outside/nanotrasen_lab/inside)
"WO" = (
/obj/effect/landmark/excavation_site_spawner,
/turf/open/floor/plating/ground/mars/random/cave,
/area/bigredv2/caves/south)
"WV" = (
/turf/open/floor/plating/ground/mars/random/cave,
/area/bigredv2/caves/south)
"XS" = (
/turf/closed/mineral/bigred,
/area/bigredv2/caves/rock)
"YW" = (
/obj/machinery/light{
	dir = 1
	},
/turf/open/floor/tile/dark/red2{
	dir = 5
	},
/area/bigredv2/outside/nanotrasen_lab/inside)
"Zp" = (
/obj/effect/landmark/weed_node,
/turf/open/floor/plating/ground/mars/random/sand,
/area/bigredv2/outside/nanotrasen_lab/inside)
"ZH" = (
/obj/effect/landmark/xeno_resin_wall,
/turf/open/floor/plating/ground/mars/random/cave,
/area/bigredv2/caves/south)
"ZO" = (
/obj/structure/window/framed/colony/reinforced,
/turf/open/floor/plating,
/area/bigredv2/outside/nanotrasen_lab/inside)

(1,1,1) = {"
pI
Lk
Lk
Lk
Lk
Lk
Lk
Lk
Lk
Lk
Lk
Lk
Lk
Lk
Lk
Lk
Lk
Lk
Lk
Lk
Lk
Lk
Lk
Lk
Lk
Lk
Lk
Lk
Lk
Lk
Lk
Lk
Lk
Lk
Lk
Lk
Lk
Lk
"}
(2,1,1) = {"
pI
Lk
Lk
Lk
Lk
Lk
Lk
Lk
Lk
Lk
Lk
Lk
Lk
Lk
Lk
Lk
Lk
Lk
Lk
Lk
Lk
Lk
Lk
Lk
Lk
Lk
Lk
Lk
Lk
Lk
Lk
Lk
Lk
Lk
Lk
Lk
Lk
Lk
"}
(3,1,1) = {"
pI
Lk
Lk
Lk
Lk
Lk
Lk
Lk
Lk
Lk
Lk
Lk
Lk
Lk
Lk
Lk
Lk
Lk
Lk
Lk
Lk
Lk
Lk
Lk
Lk
Lk
Lk
Lk
Lk
Lk
Lk
Lk
Lk
Lk
Lk
Lk
Lk
Lk
"}
(4,1,1) = {"
pI
Lk
Lk
Lk
Lk
Lk
Lk
Lk
Lk
Lk
Lk
Lk
Lk
Lk
Lk
Lk
Lk
Lk
Lk
Lk
Lk
Lk
Lk
Lk
Lk
Lk
Lk
Lk
Lk
Lk
Lk
Lk
Lk
Lk
Lk
Lk
Lk
Lk
"}
(5,1,1) = {"
pI
Lk
Lk
Lk
Lk
Lk
Lk
Lk
Lk
Lk
Lk
Lk
Lk
Lk
Lk
Lk
Lk
Lk
Lk
Lk
Lk
Lk
Lk
Lk
Lk
Lk
Lk
Lk
Lk
Lk
Lk
Lk
Lk
Lk
Lk
Lk
Lk
Lk
"}
(6,1,1) = {"
pI
Lk
Lk
Lk
Lk
Lk
Lk
Lk
Lk
Lk
Lk
Lk
Lk
Lk
Lk
Lk
Lk
Lk
Lk
Lk
Lk
Lk
Lk
Lk
Lk
Lk
Lk
Lk
Lk
Lk
Lk
Lk
Lk
Lk
Lk
Lk
Lk
Lk
"}
(7,1,1) = {"
pI
Lk
Lk
Lk
Lk
Lk
Lk
Lk
Lk
Lk
Lk
Lk
Lk
Lk
Lk
Lk
Lk
Lk
Lk
Lk
Lk
Lk
Lk
Lk
Lk
Lk
Lk
Lk
Lk
Lk
Lk
Lk
Lk
Lk
Lk
Lk
Lk
Lk
"}
(8,1,1) = {"
pI
Lk
Lk
Lk
Lk
Lk
Lk
Lk
Lk
Lk
Lk
Lk
Lk
Lk
Lk
Lk
Lk
Lk
Lk
Lk
Lk
Lk
Lk
Lk
Lk
Lk
Lk
Lk
Lk
Lk
Lk
Lk
Lk
Lk
Lk
Lk
Lk
Lk
"}
(9,1,1) = {"
pI
Lk
Lk
Lk
Lk
Lk
Lk
Lk
Lk
Lk
Lk
Lk
Lk
Lk
Lk
Lk
Lk
Lk
Lk
Lk
Lk
Lk
Lk
Lk
Lk
Lk
Lk
Lk
Lk
Lk
Lk
Lk
Lk
Lk
Lk
Lk
Lk
Lk
"}
(10,1,1) = {"
pI
Lk
Lk
Lk
Lk
Lk
Lk
Lk
Lk
Lk
Lk
Lk
Lk
Lk
Lk
Lk
Lk
Lk
Lk
Lk
Lk
Lk
Lk
Lk
Lk
Lk
Lk
Lk
Lk
Lk
Lk
Lk
Lk
Lk
Lk
Lk
Lk
Lk
"}
(11,1,1) = {"
pI
Lk
Lk
Lk
Lk
Lk
Lk
Lk
Lk
Lk
Lk
Lk
Lk
Lk
Lk
Lk
Lk
Lk
Lk
Lk
Lk
Lk
Lk
Lk
Lk
Lk
Lk
Lk
Lk
Lk
Lk
Lk
Lk
Lk
Lk
Lk
Lk
Lk
"}
(12,1,1) = {"
pI
Lk
Lk
Lk
Lk
Lk
Lk
Lk
Lk
Lk
Lk
Lk
Lk
Lk
Lk
Lk
Lk
Lk
Lk
Lk
Lk
Lk
Lk
Lk
Lk
Lk
Lk
Lk
Lk
Lk
Lk
Lk
Lk
Lk
Lk
Lk
Lk
Lk
"}
(13,1,1) = {"
pI
Lk
Lk
Lk
Lk
Lk
Lk
Lk
Lk
Lk
Lk
Lk
Lk
Lk
Lk
Lk
Lk
Lk
Lk
Lk
Lk
Lk
Lk
Lk
Lk
Lk
Lk
Lk
Lk
Lk
Lk
Lk
Lk
Lk
Lk
Lk
Lk
Lk
"}
(14,1,1) = {"
pI
Lk
Lk
Lk
Lk
Lk
Lk
Lk
Lk
Lk
Lk
Lk
Lk
Lk
Lk
Lk
Lk
Lk
Lk
Lk
Lk
Lk
Lk
Lk
Lk
Lk
Lk
Lk
Lk
Lk
Lk
Lk
Lk
Lk
Lk
Lk
Lk
Lk
"}
(15,1,1) = {"
pI
Lk
Lk
Lk
Lk
Lk
Lk
Lk
Lk
Lk
Lk
Lk
Lk
Lk
Lk
Lk
Lk
Lk
Lk
Lk
Lk
Lk
Lk
Lk
Lk
Lk
Lk
Lk
Lk
Lk
Lk
Lk
Lk
Lk
Lk
Lk
Lk
Lk
"}
(16,1,1) = {"
pI
Lk
Lk
Lk
Lk
Lk
Lk
Lk
Lk
Lk
Lk
Lk
Lk
Lk
Lk
Lk
Lk
Lk
Lk
Lk
Lk
Lk
Lk
Lk
Lk
Lk
Lk
Lk
Lk
Lk
Lk
Lk
Lk
Lk
Lk
Lk
Lk
Lk
"}
(17,1,1) = {"
pI
Lk
Lk
Lk
Lk
Lk
Lk
Lk
Lk
Lk
Lk
Lk
Lk
Lk
Lk
Lk
Lk
Lk
Lk
Lk
Lk
Lk
Lk
Lk
Lk
Lk
Lk
Lk
Lk
Lk
Lk
Lk
Lk
Lk
Lk
Lk
Lk
Lk
"}
(18,1,1) = {"
pI
Lk
Lk
Lk
Lk
Lk
Lk
Lk
Lk
Lk
Lk
Lk
Lk
Lk
Lk
Lk
Lk
Lk
Lk
Lk
Lk
Lk
Lk
Lk
Lk
Lk
Lk
Lk
Lk
Lk
Lk
Lk
Lk
Lk
Lk
Lk
Lk
Lk
"}
(19,1,1) = {"
pI
Lk
Lk
Lk
Lk
Lk
Lk
Lk
Lk
Lk
Lk
Lk
Lk
Lk
Lk
Lk
Lk
Lk
Lk
Lk
Lk
Lk
Lk
Lk
Lk
Lk
Lk
Lk
Lk
Lk
Lk
Lk
Lk
Lk
Lk
Lk
Lk
Lk
"}
(20,1,1) = {"
pI
Lk
Lk
Lk
Lk
Lk
Lk
Lk
Lk
Lk
Lk
Lk
Lk
Lk
Lk
Lk
Lk
Lk
Lk
Lk
Lk
Lk
Lk
Lk
Lk
Lk
Lk
Lk
Lk
Lk
Lk
Lk
Lk
Lk
Lk
Lk
Lk
Lk
"}
(21,1,1) = {"
pI
Lk
Lk
Lk
Lk
Lk
Lk
Lk
Lk
Lk
Lk
Lk
Lk
Lk
Lk
Lk
Lk
Lk
Lk
Lk
Lk
Lk
Lk
Lk
Lk
Lk
Lk
Lk
Lk
Lk
Lk
Lk
Lk
Lk
Lk
Lk
Lk
Lk
"}
(22,1,1) = {"
pI
Lk
Lk
Lk
Lk
Lk
Lk
Lk
Lk
Lk
Lk
Lk
Lk
Lk
Lk
Lk
Lk
Lk
Lk
Lk
Lk
Lk
Lk
Lk
Lk
Lk
Lk
Lk
Lk
Lk
Lk
Lk
Lk
Lk
Lk
Lk
Lk
Lk
"}
(23,1,1) = {"
pI
Lk
Lk
Lk
Lk
Lk
Lk
Lk
Lk
Lk
Lk
Lk
Lk
Lk
Lk
Lk
Lk
Lk
Lk
Lk
Lk
Lk
Lk
Lk
Lk
Lk
Lk
Lk
Lk
Lk
Lk
Lk
Lk
Lk
Lk
Lk
Lk
Lk
"}
(24,1,1) = {"
pI
Lk
Lk
Lk
Lk
Lk
Lk
Lk
Lk
Lk
Lk
Lk
Lk
Lk
Lk
Lk
Lk
Lk
Lk
Lk
Lk
Lk
Lk
Lk
Lk
Lk
Lk
Lk
Lk
Lk
Lk
Lk
Lk
Lk
Lk
Lk
Lk
Lk
"}
(25,1,1) = {"
pI
pI
pI
pI
pI
pI
pI
pI
pI
pI
pI
pI
pI
pI
pI
pI
pI
pI
pI
pI
pI
pI
pI
pI
pI
pI
pI
pI
pI
pI
pI
pI
pI
pI
pI
pI
pI
pI
"}
(26,1,1) = {"
XS
XS
XS
XS
XS
XS
XS
XS
XS
XS
XS
XS
XS
XS
XS
XS
XS
XS
XS
XS
XS
XS
XS
XS
XS
XS
XS
XS
XS
XS
XS
XS
XS
XS
XS
XS
XS
pI
"}
(27,1,1) = {"
XS
XS
XS
XS
XS
XS
XS
XS
XS
XS
XS
XS
XS
XS
XS
XS
XS
XS
XS
XS
XS
XS
XS
XS
XS
XS
XS
XS
XS
XS
XS
XS
XS
XS
XS
XS
XS
pI
"}
(28,1,1) = {"
XS
XS
XS
XS
XS
XS
XS
XS
XS
XS
XS
XS
XS
XS
XS
XS
XS
XS
XS
XS
XS
XS
XS
XS
XS
XS
XS
XS
XS
XS
XS
XS
XS
XS
XS
XS
XS
pI
"}
(29,1,1) = {"
XS
XS
XS
XS
XS
XS
XS
XS
XS
XS
XS
XS
XS
XS
XS
XS
XS
XS
XS
XS
XS
XS
hB
hB
hB
hB
hB
hB
hB
hB
hB
hB
hB
hB
hB
hB
XS
pI
"}
(30,1,1) = {"
XS
XS
XS
XS
XS
XS
XS
XS
XS
XS
XS
XS
XS
XS
XS
XS
XS
XS
XS
XS
XS
XS
hB
XS
XS
XS
XS
XS
XS
XS
XS
XS
XS
XS
XS
hB
XS
pI
"}
(31,1,1) = {"
XS
XS
XS
XS
XS
XS
XS
XS
XS
XS
XS
XS
XS
XS
XS
XS
XS
XS
XS
XS
XS
XS
hB
XS
XS
XS
WV
WV
xE
Ox
WV
XS
XS
XS
XS
hB
XS
pI
"}
(32,1,1) = {"
XS
XS
XS
XS
XS
XS
XS
XS
XS
XS
XS
XS
XS
XS
XS
XS
XS
XS
XS
XS
XS
XS
hB
XS
xE
WV
Ox
WV
WV
WV
WV
WV
XS
XS
XS
hB
XS
pI
"}
(33,1,1) = {"
XS
XS
XS
XS
XS
XS
XS
XS
XS
XS
XS
Tc
WV
XS
XS
XS
XS
XS
XS
XS
XS
XS
hB
XS
Ox
WV
WV
WV
WV
zR
WV
XS
XS
XS
XS
hB
XS
pI
"}
(34,1,1) = {"
XS
XS
XS
XS
XS
XS
XS
Tc
WV
Ox
WV
WV
WV
WV
xE
WV
XS
XS
XS
XS
XS
XS
Th
ZH
WV
WV
WV
WV
WV
WV
WV
WV
XS
XS
XS
hB
XS
pI
"}
(35,1,1) = {"
XS
XS
XS
XS
XS
XS
WV
WV
WV
WV
WV
Ox
WV
Ox
WV
WV
WV
XS
XS
XS
XS
XS
Th
ZH
WV
WV
WV
WV
WV
WV
WV
WV
WV
XS
XS
hB
XS
pI
"}
(36,1,1) = {"
XS
XS
XS
XS
WV
WV
WV
WV
Ox
xE
WV
WV
WV
WV
xE
WV
WV
WV
WV
WV
xE
WV
Th
mN
xE
Ox
WV
WV
xE
WV
WV
WV
Ox
XS
XS
hB
XS
pI
"}
(37,1,1) = {"
XS
XS
WV
xE
WV
WV
WV
WV
xE
WV
WV
WV
WV
WV
WV
WV
Ox
WV
WV
WV
Ox
WV
Th
mN
WV
WV
WV
Ox
WV
WV
Ox
WV
WV
XS
XS
hB
XS
pI
"}
(38,1,1) = {"
XS
WV
WV
WV
Ox
WV
WV
ko
WV
WV
WV
WV
Ox
WV
WV
WV
WV
WV
WV
WV
WV
WV
Th
mN
WV
WV
WV
WV
WV
WV
WV
WV
WV
XS
XS
hB
XS
pI
"}
(39,1,1) = {"
WV
WV
Ox
WV
WV
WV
WV
WV
WV
WV
WV
WV
WV
WV
Av
WV
Ox
WV
WV
WV
WV
Ox
Th
ZH
Ox
WV
WV
WV
GB
WV
WV
WV
GB
WV
XS
hB
XS
pI
"}
(40,1,1) = {"
WV
Tc
WV
WV
bm
Tc
WV
WV
WV
WV
Ox
Tc
WV
WV
WV
WV
WV
WV
WV
WV
WV
WV
Th
ZH
ZH
ZH
mN
mN
mN
mN
ZH
ZH
ZH
ZH
XS
hB
XS
pI
"}
(41,1,1) = {"
WV
WV
WV
xE
WV
WV
WV
Ox
WV
xE
WV
WV
Tc
Tc
Tc
Tc
Tc
Tc
Ox
Tc
Hu
Tc
Th
rR
Th
eA
Th
Th
Th
Th
Th
Th
Th
Th
hB
hB
XS
pI
"}
(42,1,1) = {"
WV
Ox
WV
WV
WV
WV
WV
Ox
WV
Ox
WV
WV
WV
WV
WV
WV
WV
WV
WV
WV
WV
WV
Tc
WV
WV
WV
WV
WV
WV
WV
WO
WV
WV
WV
XS
XS
XS
pI
"}
(43,1,1) = {"
WV
XS
XS
XS
XS
XS
XS
Tc
WV
WV
WV
WV
Ox
WV
Ox
WV
Ox
WV
WV
WV
WV
Ox
WV
WV
Ox
WV
WV
Ox
WV
WV
WV
Ox
WV
WV
XS
XS
XS
pI
"}
(44,1,1) = {"
XS
XS
XS
XS
XS
XS
XS
XS
XS
XS
XS
XS
XS
XS
XS
XS
XS
WV
XS
XS
Tc
Tc
XS
Tc
WV
Ox
WV
WV
WV
WV
WV
WV
WV
WV
XS
XS
XS
pI
"}
(45,1,1) = {"
XS
XS
XS
XS
XS
XS
XS
XS
XS
XS
XS
XS
XS
XS
XS
XS
XS
XS
XS
XS
XS
XS
XS
XS
WV
WV
WV
WV
WV
WV
WV
WV
WV
WV
XS
XS
XS
pI
"}
(46,1,1) = {"
gE
gE
gE
gE
gE
gE
gE
gE
gE
gE
gE
gE
gE
gE
gE
gE
gE
gE
gE
gE
gE
gE
XS
XS
Tc
WV
WV
WV
WV
Ox
Ox
WV
WV
XS
XS
XS
XS
pI
"}
(47,1,1) = {"
xB
xB
xB
xB
xB
xB
xB
xB
xB
xB
xB
xB
xB
xB
xB
xB
xB
xB
xB
xB
xB
xB
PD
XS
WV
WV
WV
WV
WV
WV
WV
WV
WV
XS
XS
XS
XS
pI
"}
(48,1,1) = {"
DG
Am
Am
Uk
xB
PG
cQ
PY
PY
PY
xB
tA
EH
tA
xB
tA
EH
tA
xB
tA
EH
tA
PD
XS
WV
xE
Ox
WO
xE
WV
WV
WV
xE
XS
XS
XS
XS
pI
"}
(49,1,1) = {"
lX
vR
Nt
ME
kJ
ME
ME
eQ
ME
ja
xB
tA
Zp
tA
xB
Zp
tA
tA
xB
tA
Zp
tA
PC
Tc
Tc
WV
WV
WV
WV
WV
WV
WV
WV
WV
XS
XS
XS
pI
"}
(50,1,1) = {"
lX
ME
ME
LX
xB
Kq
eZ
uf
ME
SI
xB
tA
tA
tA
xB
tA
tA
tA
xB
tA
FS
tA
PD
WV
WV
WV
Ox
WV
WV
WV
Ox
WV
WV
WV
XS
XS
XS
pI
"}
(51,1,1) = {"
TH
ME
ME
tn
ZO
BK
eZ
eZ
ME
bT
xB
ZO
tM
ZO
xB
ZO
tM
ZO
xB
ZO
tM
ZO
PD
WV
Ox
WV
WV
Tc
WV
WV
WV
Ox
Ox
WV
XS
XS
XS
pI
"}
(52,1,1) = {"
zn
ME
ME
LX
ZO
gQ
eZ
eZ
ME
ja
kg
VS
ME
VS
kg
VS
ME
VS
kg
oB
ME
VS
PD
WV
WV
WV
WV
nj
WV
WV
WV
WV
WV
WV
WV
XS
XS
pI
"}
(53,1,1) = {"
TH
ME
ME
LX
ZO
LO
ME
eZ
eZ
ME
ja
ja
TX
ja
xw
ja
TX
ja
ja
ja
eZ
ja
PD
WV
WV
WV
WV
Tc
WV
WV
WV
WV
WV
WV
WV
XS
XS
pI
"}
(54,1,1) = {"
lX
eQ
TX
LX
ZO
Or
ME
yR
eZ
uf
Bj
eZ
eZ
eZ
ME
eZ
eZ
eZ
ME
eZ
wF
AB
PD
WV
WV
WV
WV
Tc
WV
Ox
WV
WV
WV
WV
WV
XS
XS
pI
"}
(55,1,1) = {"
lX
Nt
ME
LX
ZO
Ww
Ai
NO
eZ
eZ
tY
iQ
eZ
iQ
iQ
iQ
eZ
iQ
cg
qc
ME
hV
Jn
WV
Ox
xE
WV
WV
WV
xE
WV
WV
xE
WV
WV
XS
XS
pI
"}
(56,1,1) = {"
YW
un
un
zD
ZO
hR
qc
Tp
qc
oL
kg
JJ
ME
vM
kg
JJ
ME
JJ
kg
JJ
ME
fk
PD
XS
Tc
WV
WV
WV
WV
Ox
WV
WV
WV
WV
Ox
XS
XS
pI
"}
(57,1,1) = {"
xB
xB
xB
xB
xB
kg
JF
SV
JF
kg
xB
ZO
tM
ZO
xB
ZO
tM
ZO
xB
ZO
tM
ZO
PD
XS
XS
XS
XS
WV
WV
WV
WV
WV
Ox
WV
WV
XS
XS
pI
"}
(58,1,1) = {"
KR
vX
vX
or
kg
cG
NX
Tp
NX
QX
xB
Mq
Mq
Mq
xB
ey
Mq
Mq
xB
Mq
Mq
Mq
PD
XS
XS
XS
XS
WV
XS
XS
WV
WV
WV
WV
WV
XS
XS
pI
"}
(59,1,1) = {"
KR
ci
jK
By
kg
zQ
TX
iP
WD
ux
xB
Mq
Mq
Mq
xB
Mq
Mq
Mq
xB
Mq
Mq
Mq
PD
XS
XS
XS
XS
XS
XS
XS
XS
WV
WV
Ox
WV
XS
XS
pI
"}
(60,1,1) = {"
KR
vX
cU
Ay
kg
He
Gc
Tp
Gc
xJ
xB
Mq
ok
Mq
xB
Mq
ok
Mq
xB
ey
ok
Mq
PD
gE
gE
gE
gE
gE
gE
gE
XS
WV
xE
qv
WV
XS
XS
pI
"}
(61,1,1) = {"
kg
MG
kg
kg
kg
kg
JF
SV
JF
kg
xB
xB
xB
xB
xB
xB
xB
xB
xB
xB
xB
xB
xB
xB
xB
xB
xB
xB
xB
gE
XS
WV
Ox
WV
WV
XS
XS
pI
"}
