//MAP CONVERTED BY dmm2tgm.py THIS HEADER COMMENT PREVENTS RECONVERSION, DO NOT REMOVE
"a" = (
/obj/effect/landmark/weed_node,
/turf/open/floor/plating/ground/mars/random/cave,
/area/bigredv2/caves/east)
"b" = (
/obj/effect/ai_node,
/turf/open/floor/plating/ground/mars/random/cave,
/area/bigredv2/caves/east)
"d" = (
/obj/effect/landmark/xeno_resin_wall,
/turf/open/floor/plating/ground/mars/random/cave,
/area/bigredv2/caves/east)
"e" = (
/obj/machinery/miner/damaged/platinum,
/turf/open/floor/plating/ground/mars/random/cave,
/area/bigredv2/caves/east)
"f" = (
/obj/effect/landmark/lv624/fog_blocker/xeno_spawn,
/obj/effect/landmark/lv624/fog_blocker/xeno_spawn,
/turf/closed/mineral/bigred,
/area/bigredv2/caves/rock)
"j" = (
/turf/open/floor/plating/ground/mars/random/cave,
/area/bigredv2/caves/east)
"n" = (
/obj/docking_port/stationary/crashmode,
/turf/open/floor/plating/ground/mars/random/cave,
/area/bigredv2/caves/east)
"o" = (
/obj/effect/landmark/xeno_silo_spawn,
/turf/open/floor/plating/ground/mars/random/cave,
/area/bigredv2/caves/east)
"p" = (
/obj/effect/landmark/weed_node,
/turf/open/floor/plating/ground/mars/random/sand,
/area/bigredv2/outside/se)
"q" = (
/obj/docking_port/stationary/crashmode,
/turf/closed/mineral/bigred,
/area/bigredv2/caves/rock)
"s" = (
/obj/effect/landmark/weed_node,
/obj/effect/ai_node,
/turf/open/floor/plating/ground/mars/random/cave,
/area/bigredv2/caves/east)
"u" = (
/turf/open/floor/plating/ground/mars/random/cave/rock,
/area/bigredv2/caves/east)
"v" = (
/obj/effect/landmark/xeno_resin_door,
/turf/open/floor/plating/ground/mars/random/cave,
/area/bigredv2/caves/east)
"w" = (
/obj/effect/landmark/lv624/fog_blocker/xeno_spawn,
/turf/closed/mineral/bigred,
/area/bigredv2/caves/rock)
"y" = (
/turf/closed/wall/indestructible/mineral,
/area/space)
"z" = (
/obj/effect/landmark/lv624/fog_blocker/xeno_spawn,
/obj/effect/landmark/lv624/fog_blocker/xeno_spawn,
/turf/open/floor/plating/ground/mars/random/cave,
/area/bigredv2/caves/east)
"A" = (
/obj/effect/landmark/xeno_resin_door,
/obj/effect/ai_node,
/turf/open/floor/plating/ground/mars/random/cave,
/area/bigredv2/caves/east)
"B" = (
/obj/effect/landmark/weed_node,
/obj/effect/landmark/lv624/fog_blocker/xeno_spawn,
/turf/open/floor/plating/ground/mars/random/cave,
/area/bigredv2/caves/east)
"D" = (
/obj/effect/landmark/weed_node,
/obj/effect/landmark/xeno_resin_door,
/turf/open/floor/plating/ground/mars/random/cave,
/area/bigredv2/caves/east)
"E" = (
/obj/effect/landmark/lv624/fog_blocker,
/turf/closed/mineral/bigred,
/area/bigredv2/caves/rock)
"H" = (
/turf/closed/mineral/bigred,
/area/bigredv2/caves/rock)
"J" = (
/obj/effect/ai_node,
/turf/open/floor/plating/ground/mars/random/cave/rock,
/area/bigredv2/caves/east)
"L" = (
/obj/effect/ai_node,
/turf/open/floor/plating/ground/mars/random/sand,
/area/bigredv2/outside/se)
"N" = (
/obj/effect/landmark/lv624/fog_blocker/xeno_spawn,
/turf/open/floor/plating/ground/mars/random/cave,
/area/bigredv2/caves/east)
"P" = (
/obj/effect/landmark/lv624/fog_blocker/xeno_spawn,
/obj/effect/landmark/xeno_resin_wall,
/turf/open/floor/plating/ground/mars/random/cave,
/area/bigredv2/caves/east)
"S" = (
/obj/effect/landmark/lv624/fog_blocker/xeno_spawn,
/turf/open/floor/plating/ground/mars/random/cave/rock,
/area/bigredv2/caves/east)
"T" = (
/turf/open/floor/plating/ground/mars/random/sand,
/area/bigredv2/outside/se)
"U" = (
/obj/effect/landmark/xeno_resin_door,
/turf/open/floor/plating/ground/mars/random/cave/rock,
/area/bigredv2/caves/east)
"V" = (
/obj/effect/landmark/weed_node,
/turf/open/floor/plating/ground/mars/random/cave/rock,
/area/bigredv2/caves/east)
"W" = (
/obj/structure/fence,
/obj/effect/landmark/lv624/fog_blocker,
/turf/open/floor/plating/ground/mars/random/cave,
/area/bigredv2/caves/east)
"X" = (
/obj/effect/landmark/excavation_site_spawner,
/turf/open/floor/plating/ground/mars/random/cave,
/area/bigredv2/caves/east)

(1,1,1) = {"
T
T
T
T
T
T
T
T
T
T
T
H
H
H
W
j
a
j
j
a
j
j
j
j
j
a
j
j
H
H
H
H
H
H
H
H
H
j
a
j
j
a
"}
(2,1,1) = {"
T
T
p
T
T
T
p
T
T
T
T
H
H
H
E
j
j
j
j
j
j
j
j
j
j
j
j
j
H
H
H
H
H
H
H
H
H
H
j
j
b
j
"}
(3,1,1) = {"
T
T
T
T
T
T
T
T
T
T
T
H
H
H
E
j
j
j
j
j
j
H
H
H
H
H
j
j
j
H
H
H
H
H
H
H
H
H
j
j
j
j
"}
(4,1,1) = {"
T
H
H
H
H
T
T
T
p
T
T
p
H
H
E
j
j
j
a
j
j
H
H
H
H
H
u
j
j
j
j
a
j
j
j
H
u
u
j
j
j
j
"}
(5,1,1) = {"
T
H
H
H
H
H
H
T
T
T
T
T
T
H
E
H
j
z
N
N
w
w
w
w
w
w
N
S
z
j
j
j
j
j
a
u
j
j
a
j
j
a
"}
(6,1,1) = {"
T
T
H
H
H
H
H
H
T
T
T
T
T
H
E
H
H
N
j
H
H
H
H
H
H
j
j
j
S
V
b
j
j
j
j
j
j
j
j
j
b
u
"}
(7,1,1) = {"
T
T
T
T
T
T
T
T
T
T
T
T
T
H
E
H
H
P
d
d
j
H
j
H
H
j
b
j
N
b
j
j
a
j
j
j
j
a
j
e
j
u
"}
(8,1,1) = {"
T
p
T
T
p
T
T
T
p
T
T
p
T
H
E
H
H
w
j
j
j
s
j
j
A
b
j
j
N
j
j
j
j
j
j
j
u
j
j
j
u
H
"}
(9,1,1) = {"
T
T
T
T
T
L
T
T
T
L
T
T
T
H
E
H
H
w
j
j
j
j
j
j
v
j
j
H
w
H
H
H
j
j
j
j
a
u
j
j
j
u
"}
(10,1,1) = {"
T
T
T
T
T
T
T
T
T
T
T
T
H
H
E
H
H
w
H
H
j
j
j
j
d
H
H
H
w
H
H
H
H
H
H
H
j
j
j
a
a
u
"}
(11,1,1) = {"
T
T
H
T
T
T
T
T
T
T
T
H
H
H
E
H
H
w
H
j
j
j
j
j
d
d
H
H
w
H
H
H
H
H
H
H
j
j
j
j
j
u
"}
(12,1,1) = {"
T
H
H
T
p
T
T
T
p
H
H
H
H
H
E
H
H
w
j
u
j
j
V
a
j
j
H
H
w
H
H
H
H
H
H
H
j
j
j
a
j
u
"}
(13,1,1) = {"
H
H
H
T
T
T
T
T
T
H
H
H
H
H
E
H
H
w
j
a
j
j
j
j
j
j
H
H
w
H
H
H
H
H
H
H
u
j
a
j
u
H
"}
(14,1,1) = {"
H
H
T
T
T
T
T
T
T
H
H
H
H
H
E
H
H
w
j
j
j
b
o
j
j
a
j
H
w
H
H
H
H
H
H
H
j
j
a
j
b
u
"}
(15,1,1) = {"
H
T
T
T
T
T
H
H
H
H
H
H
H
H
E
H
H
w
j
j
j
j
j
j
a
j
H
H
w
H
H
H
H
H
H
H
H
u
j
j
j
u
"}
(16,1,1) = {"
p
T
T
T
p
L
H
H
H
H
H
H
H
H
E
H
H
w
H
j
j
j
j
j
j
H
H
H
w
H
H
H
H
H
H
H
H
H
v
v
v
v
"}
(17,1,1) = {"
T
T
T
T
T
T
H
H
H
H
H
H
H
H
E
H
H
w
H
j
j
j
j
j
H
H
H
H
w
H
H
H
H
H
H
H
H
H
j
j
j
j
"}
(18,1,1) = {"
H
H
H
H
H
H
H
H
H
H
H
H
H
H
E
H
H
f
w
N
N
N
N
N
w
w
w
w
f
H
H
H
H
H
H
H
j
j
j
j
j
a
"}
(19,1,1) = {"
E
E
E
E
E
E
E
E
E
E
E
E
E
E
E
H
H
H
H
j
j
j
j
j
H
H
H
H
H
H
H
H
H
H
H
j
j
a
j
j
j
j
"}
(20,1,1) = {"
H
H
H
H
H
H
H
H
H
H
H
H
H
H
H
H
H
H
H
H
j
j
j
j
H
q
H
H
H
H
H
H
H
H
j
j
j
j
j
j
j
j
"}
(21,1,1) = {"
H
H
H
H
H
H
H
H
H
H
H
H
H
H
H
H
H
H
H
H
j
b
j
j
j
H
H
H
H
H
H
H
H
H
j
j
j
j
a
u
j
j
"}
(22,1,1) = {"
H
u
u
J
u
V
H
H
H
H
H
H
H
H
H
H
H
H
H
H
j
j
j
j
j
H
H
H
H
H
H
H
H
H
b
j
j
j
j
j
b
j
"}
(23,1,1) = {"
H
a
j
j
j
j
u
H
H
H
H
H
H
H
H
H
H
H
H
H
j
j
j
j
j
H
H
H
H
H
H
H
H
H
j
a
u
H
H
j
j
j
"}
(24,1,1) = {"
H
u
j
j
j
a
u
H
H
H
H
H
H
H
H
H
H
H
H
H
j
j
j
j
j
H
H
H
H
H
H
H
H
u
j
j
u
H
H
j
j
a
"}
(25,1,1) = {"
H
H
H
J
j
j
u
j
b
j
j
H
H
H
H
H
H
H
H
H
j
j
j
j
j
H
H
H
H
H
H
H
H
j
j
u
H
H
H
j
j
j
"}
(26,1,1) = {"
H
H
H
H
H
j
u
j
j
j
j
H
H
H
H
u
u
j
a
j
j
j
X
j
j
H
H
H
H
H
H
H
H
j
u
H
H
H
H
j
b
j
"}
(27,1,1) = {"
u
u
u
u
V
j
u
a
j
j
j
a
v
j
j
j
j
j
j
j
j
j
j
j
j
j
H
H
H
H
H
H
H
j
b
u
H
u
u
j
a
j
"}
(28,1,1) = {"
b
j
j
j
a
b
j
u
J
u
u
u
U
u
j
a
J
j
j
j
a
b
j
b
j
a
H
H
H
H
H
H
H
b
j
j
u
j
j
j
j
j
"}
(29,1,1) = {"
j
j
j
j
j
j
X
j
j
j
j
j
v
j
j
j
u
j
j
u
j
a
j
j
j
j
H
H
H
H
H
H
H
j
j
j
a
j
j
j
j
j
"}
(30,1,1) = {"
j
j
a
j
j
j
j
j
j
j
a
j
v
j
a
j
u
j
a
j
j
j
j
a
j
H
H
H
H
H
H
H
H
H
j
j
j
j
j
j
J
H
"}
(31,1,1) = {"
a
j
j
j
j
j
a
j
j
a
j
u
H
H
j
j
V
j
j
j
j
j
j
j
H
H
H
H
H
H
H
H
H
H
H
H
j
j
j
j
u
H
"}
(32,1,1) = {"
u
j
j
j
j
j
j
H
H
H
H
H
H
H
H
j
u
j
j
j
a
j
a
H
H
H
H
H
H
H
H
H
H
H
H
H
j
j
a
u
j
H
"}
(33,1,1) = {"
j
j
j
j
e
j
j
H
H
H
H
H
H
H
H
j
u
j
j
j
j
j
H
H
H
H
H
H
H
H
H
H
H
H
H
H
j
j
u
j
j
j
"}
(34,1,1) = {"
u
j
a
u
j
j
a
H
H
H
H
H
H
H
u
a
j
j
a
j
H
H
H
H
H
H
H
H
H
H
H
H
H
H
H
H
H
H
u
j
b
j
"}
(35,1,1) = {"
H
u
j
j
j
j
j
j
H
H
H
H
H
u
j
j
j
j
j
H
H
H
H
H
H
H
w
w
w
w
w
w
w
w
w
w
w
H
H
v
v
v
"}
(36,1,1) = {"
H
H
H
j
j
u
a
j
j
H
H
H
U
j
j
j
j
a
j
H
H
H
H
H
H
H
w
H
H
H
H
H
H
H
H
H
w
H
H
H
b
j
"}
(37,1,1) = {"
H
H
H
a
j
u
j
j
n
u
j
j
D
j
j
j
j
j
H
H
H
H
H
H
H
H
w
H
a
j
a
j
H
H
H
H
w
H
H
H
j
j
"}
(38,1,1) = {"
H
H
H
j
j
b
j
a
j
j
j
j
v
j
a
j
b
H
H
H
H
H
H
H
H
H
w
H
j
j
o
j
j
j
H
H
w
H
H
H
H
j
"}
(39,1,1) = {"
H
H
H
H
j
j
j
j
j
a
j
j
v
j
j
H
H
H
H
H
H
H
H
H
H
H
w
H
j
j
j
j
a
j
j
H
w
H
H
H
H
H
"}
(40,1,1) = {"
H
H
H
H
j
j
j
j
j
X
j
j
v
j
H
H
H
H
H
H
H
H
H
H
H
H
w
H
a
j
j
j
j
a
j
H
w
H
H
H
H
H
"}
(41,1,1) = {"
H
H
H
j
j
j
a
j
j
j
j
j
H
H
H
H
H
H
H
H
H
H
H
H
H
H
w
H
v
v
v
d
d
d
d
H
w
H
H
H
H
H
"}
(42,1,1) = {"
H
H
H
j
j
j
j
j
j
j
a
j
H
H
H
H
H
H
H
H
j
H
H
H
j
j
N
j
j
j
j
b
j
a
j
H
w
H
H
H
H
H
"}
(43,1,1) = {"
H
H
j
j
j
j
j
j
j
a
j
j
v
H
H
H
H
H
H
j
j
j
H
H
j
j
N
N
N
N
B
N
N
N
N
w
w
H
H
H
H
H
"}
(44,1,1) = {"
H
H
j
j
a
j
X
j
j
j
j
j
v
j
j
H
H
H
j
j
j
j
j
j
j
j
a
j
j
j
j
j
j
j
j
j
H
H
H
H
H
H
"}
(45,1,1) = {"
H
H
a
j
j
a
j
j
j
j
j
j
D
j
j
j
j
j
j
j
j
j
j
j
j
j
j
j
j
j
j
j
j
j
j
j
j
H
H
H
H
H
"}
(46,1,1) = {"
j
j
j
j
j
j
j
j
j
a
j
j
v
j
j
j
j
j
j
j
j
a
j
j
j
j
j
j
j
j
a
j
j
j
a
j
j
j
j
j
j
j
"}
(47,1,1) = {"
j
j
j
j
j
j
j
j
j
j
j
j
v
j
a
j
a
j
j
j
j
j
j
j
j
a
j
X
j
j
j
j
j
j
j
j
j
j
j
a
j
j
"}
(48,1,1) = {"
b
j
j
j
j
b
j
j
j
j
a
j
v
j
b
j
j
j
j
e
j
j
j
b
j
j
j
j
j
j
j
b
j
j
j
j
j
j
j
b
j
j
"}
(49,1,1) = {"
j
j
a
j
j
j
j
j
j
j
j
j
v
j
j
j
j
j
j
j
j
j
j
j
j
j
j
a
j
j
j
j
j
j
j
j
j
j
j
j
j
j
"}
(50,1,1) = {"
a
j
j
j
j
j
j
a
j
H
H
H
H
j
j
a
j
j
j
j
j
j
a
j
j
j
j
j
j
j
j
a
j
j
j
j
a
j
j
j
a
j
"}
(51,1,1) = {"
j
j
j
j
j
a
j
j
j
H
H
H
H
H
j
j
j
a
j
j
j
j
j
j
j
a
j
j
j
j
H
H
H
j
j
j
j
j
j
j
j
j
"}
(52,1,1) = {"
j
u
j
j
j
j
j
H
H
H
H
H
H
H
H
H
H
H
H
H
H
H
j
j
j
j
j
j
j
H
H
H
H
H
j
j
X
j
j
b
j
j
"}
(53,1,1) = {"
b
j
j
a
H
H
H
H
H
H
H
H
H
H
H
H
H
H
H
H
H
H
H
u
j
j
j
j
H
H
H
H
H
H
u
j
j
a
j
j
j
j
"}
(54,1,1) = {"
j
j
j
j
H
H
H
H
H
H
H
H
H
H
H
H
H
H
H
H
H
H
H
H
v
v
v
v
d
H
H
H
H
H
H
H
j
j
j
j
a
j
"}
(55,1,1) = {"
j
a
j
H
H
H
H
H
H
H
H
H
H
H
H
H
H
H
H
H
H
H
H
H
j
j
j
j
j
j
H
H
H
H
H
H
H
H
H
j
j
j
"}
(56,1,1) = {"
j
j
j
H
H
H
H
H
H
H
H
H
H
H
H
H
H
H
H
H
H
H
H
H
j
j
j
j
j
j
H
H
H
H
H
H
H
H
H
H
H
H
"}
(57,1,1) = {"
j
j
j
H
H
H
H
H
H
H
H
H
H
H
H
H
H
H
H
H
H
H
H
H
j
j
j
j
j
j
H
H
H
H
H
H
H
H
H
H
H
H
"}
(58,1,1) = {"
j
j
j
H
H
H
H
H
H
H
H
H
H
H
H
H
H
H
H
H
H
H
H
H
j
j
j
j
j
H
H
H
H
H
H
H
H
H
H
H
H
H
"}
(59,1,1) = {"
b
a
H
H
H
H
H
H
H
H
H
H
H
H
H
H
H
H
H
H
H
H
H
H
H
j
j
j
H
H
H
H
H
H
H
H
H
H
H
H
H
H
"}
(60,1,1) = {"
H
H
H
H
H
H
H
H
H
H
H
H
H
H
H
H
H
H
H
H
H
H
H
H
H
H
H
H
H
H
H
H
H
H
H
H
H
H
H
H
H
H
"}
(61,1,1) = {"
H
H
H
H
H
H
H
H
H
H
H
H
H
H
H
H
H
H
H
H
H
H
H
H
H
H
H
H
H
H
H
H
H
H
H
H
H
H
H
H
H
H
"}
(62,1,1) = {"
w
w
H
H
H
H
H
H
H
H
H
H
H
H
H
H
H
H
H
H
H
H
H
H
H
H
H
H
H
H
H
H
H
H
H
H
H
H
H
H
H
H
"}
(63,1,1) = {"
H
w
w
H
H
H
H
H
H
H
H
H
H
H
H
H
H
H
H
H
H
H
H
H
H
H
H
H
H
H
H
H
H
H
H
H
H
H
H
H
H
H
"}
(64,1,1) = {"
H
H
w
H
H
H
H
H
H
H
H
H
H
H
H
H
H
H
H
H
H
H
H
H
H
H
H
H
H
H
H
H
H
H
H
H
H
H
H
H
H
H
"}
(65,1,1) = {"
H
H
w
H
H
H
H
H
H
H
H
H
H
H
H
H
H
H
H
H
H
H
H
H
H
H
H
H
H
H
H
H
H
H
H
H
H
H
H
H
H
H
"}
(66,1,1) = {"
j
H
y
y
y
y
y
y
y
y
y
y
y
y
y
y
y
y
y
y
y
y
y
y
y
y
y
y
y
y
y
y
y
y
y
y
y
y
y
y
y
y
"}
