//MAP CONVERTED BY dmm2tgm.py THIS HEADER COMMENT PREVENTS RECONVERSION, DO NOT REMOVE
"a" = (
/obj/effect/landmark/weed_node,
/turf/open/floor/plating/ground/mars/random/cave,
/area/bigredv2/caves/east)
"c" = (
/obj/effect/landmark/xeno_resin_door,
/turf/open/floor/plating/ground/mars/random/cave,
/area/bigredv2/caves/east)
"d" = (
/obj/effect/landmark/weed_node,
/turf/open/floor/plating/ground/mars/random/sand,
/area/bigredv2/outside/se)
"f" = (
/turf/closed/wall/indestructible/mineral,
/area/space)
"g" = (
/obj/machinery/miner/damaged/platinum,
/turf/open/floor/plating/ground/mars/random/cave,
/area/bigredv2/caves/east)
"h" = (
/turf/closed/mineral/bigred,
/area/bigredv2/caves/rock)
"i" = (
/obj/structure/fence,
/obj/effect/landmark/lv624/fog_blocker,
/turf/open/floor/plating/ground/mars/random/cave,
/area/bigredv2/caves/east)
"m" = (
/obj/docking_port/stationary/crashmode,
/turf/open/floor/plating/ground/mars/random/cave,
/area/bigredv2/caves/east)
"n" = (
/obj/effect/landmark/lv624/fog_blocker/xeno_spawn,
/obj/effect/landmark/lv624/fog_blocker/xeno_spawn,
/turf/open/floor/plating/ground/mars/random/cave,
/area/bigredv2/caves/east)
"o" = (
/turf/open/floor/plating/ground/mars/random/sand,
/area/bigredv2/outside/se)
"p" = (
/obj/effect/landmark/xeno_resin_door,
/turf/open/floor/plating/ground/mars/random/cave/rock,
/area/bigredv2/caves/east)
"u" = (
/obj/effect/ai_node,
/turf/open/floor/plating/ground/mars/random/cave/rock,
/area/bigredv2/caves/east)
"v" = (
/obj/effect/landmark/lv624/fog_blocker/xeno_spawn,
/turf/open/floor/plating/ground/mars/random/cave/rock,
/area/bigredv2/caves/east)
"x" = (
/obj/effect/landmark/lv624/fog_blocker/xeno_spawn,
/obj/effect/landmark/lv624/fog_blocker/xeno_spawn,
/turf/closed/mineral/bigred,
/area/bigredv2/caves/rock)
"y" = (
/turf/open/floor/plating/ground/mars/random/cave/rock,
/area/bigredv2/caves/east)
"B" = (
/obj/effect/landmark/lv624/fog_blocker/xeno_spawn,
/turf/closed/mineral/bigred,
/area/bigredv2/caves/rock)
"D" = (
/obj/effect/landmark/xeno_resin_wall,
/turf/open/floor/plating/ground/mars/random/cave,
/area/bigredv2/caves/east)
"E" = (
/obj/effect/landmark/lv624/fog_blocker/xeno_spawn,
/turf/open/floor/plating/ground/mars/random/cave,
/area/bigredv2/caves/east)
"G" = (
/obj/effect/ai_node,
/turf/open/floor/plating/ground/mars/random/cave,
/area/bigredv2/caves/east)
"J" = (
/obj/effect/landmark/lv624/fog_blocker/xeno_spawn,
/obj/effect/ai_node,
/turf/open/floor/plating/ground/mars/random/cave,
/area/bigredv2/caves/east)
"M" = (
/obj/effect/landmark/xeno_silo_spawn,
/turf/open/floor/plating/ground/mars/random/cave,
/area/bigredv2/caves/east)
"O" = (
/obj/effect/landmark/weed_node,
/turf/open/floor/plating/ground/mars/random/cave/rock,
/area/bigredv2/caves/east)
"Q" = (
/obj/effect/ai_node,
/turf/open/floor/plating/ground/mars/random/sand,
/area/bigredv2/outside/se)
"R" = (
/obj/effect/landmark/excavation_site_spawner,
/turf/open/floor/plating/ground/mars/random/cave,
/area/bigredv2/caves/east)
"S" = (
/obj/docking_port/stationary/crashmode,
/turf/closed/mineral/bigred,
/area/bigredv2/caves/rock)
"T" = (
/turf/open/floor/plating/ground/mars/random/cave,
/area/bigredv2/caves/east)
"U" = (
/obj/effect/landmark/xeno_resin_door,
/obj/effect/ai_node,
/turf/open/floor/plating/ground/mars/random/cave,
/area/bigredv2/caves/east)
"V" = (
/obj/effect/landmark/weed_node,
/obj/effect/ai_node,
/turf/open/floor/plating/ground/mars/random/cave,
/area/bigredv2/caves/east)
"W" = (
/obj/effect/landmark/lv624/fog_blocker,
/turf/closed/mineral/bigred,
/area/bigredv2/caves/rock)
"X" = (
/obj/effect/landmark/lv624/fog_blocker/xeno_spawn,
/obj/effect/landmark/xeno_resin_wall,
/turf/open/floor/plating/ground/mars/random/cave,
/area/bigredv2/caves/east)

(1,1,1) = {"
o
o
o
o
o
o
o
o
o
o
o
h
h
h
i
T
a
T
T
a
T
T
T
T
T
a
T
T
h
h
h
h
h
h
h
h
h
T
a
T
T
a
"}
(2,1,1) = {"
o
o
d
o
o
o
d
o
o
o
o
h
h
h
W
T
T
T
T
T
T
T
T
T
T
T
T
T
h
h
h
h
h
h
h
h
h
h
T
T
G
T
"}
(3,1,1) = {"
o
o
o
o
o
o
o
o
o
o
o
h
h
h
W
T
T
T
T
T
T
h
h
h
h
h
T
T
T
h
h
h
h
h
h
h
h
h
T
T
T
T
"}
(4,1,1) = {"
o
h
h
h
h
o
o
o
d
o
o
d
h
h
W
T
T
T
a
T
T
h
h
h
h
h
y
T
T
T
T
a
T
T
T
h
y
y
T
T
T
T
"}
(5,1,1) = {"
o
h
h
h
h
h
h
o
o
o
o
o
o
h
W
h
T
n
E
E
B
B
B
B
B
B
E
v
n
T
T
T
T
T
a
y
T
T
a
T
T
a
"}
(6,1,1) = {"
o
o
h
h
h
h
h
h
o
o
o
o
o
h
W
h
h
E
T
h
h
h
h
h
h
T
T
T
v
O
G
T
T
T
T
T
T
T
T
T
G
y
"}
(7,1,1) = {"
o
o
o
o
o
o
o
o
o
o
o
o
o
h
W
h
h
X
D
D
T
h
T
h
h
T
G
T
E
G
T
T
a
T
T
T
T
a
T
g
T
y
"}
(8,1,1) = {"
o
d
o
o
d
o
o
o
d
o
o
d
o
h
W
h
h
B
T
T
T
V
T
T
U
G
T
T
E
T
T
T
T
T
T
T
y
T
T
T
y
h
"}
(9,1,1) = {"
o
o
o
o
o
Q
o
o
o
Q
o
o
o
h
W
h
h
B
T
T
T
T
T
T
c
T
T
h
B
h
h
h
T
T
T
T
a
y
T
T
T
y
"}
(10,1,1) = {"
o
o
o
o
o
o
o
o
o
o
o
o
h
h
W
h
h
B
h
h
T
T
T
T
D
h
h
h
B
h
h
h
h
h
h
h
T
T
T
a
a
y
"}
(11,1,1) = {"
o
o
h
o
o
o
o
o
o
o
o
h
h
h
W
h
h
B
h
T
T
T
T
T
D
D
h
h
B
h
h
h
h
h
h
h
T
T
T
T
T
y
"}
(12,1,1) = {"
o
h
h
o
d
o
o
o
d
h
h
h
h
h
W
h
h
B
T
y
T
T
O
a
T
T
h
h
B
h
h
h
h
h
h
h
T
T
T
a
T
y
"}
(13,1,1) = {"
h
h
h
o
o
o
o
o
o
h
h
h
h
h
W
h
h
B
T
a
T
T
T
T
T
T
h
h
B
h
h
h
h
h
h
h
y
T
a
T
y
h
"}
(14,1,1) = {"
h
h
o
o
o
o
o
o
o
h
h
h
h
h
W
h
h
B
T
T
T
G
M
T
T
a
T
h
B
h
h
h
h
h
h
h
T
T
a
T
G
y
"}
(15,1,1) = {"
h
o
o
o
o
o
h
h
h
h
h
h
h
h
W
h
h
B
T
T
T
T
T
T
a
T
h
h
B
h
h
h
h
h
h
h
h
y
T
T
T
y
"}
(16,1,1) = {"
d
o
o
o
d
Q
h
h
h
h
h
h
h
h
W
h
h
B
h
h
h
T
T
T
T
h
h
h
B
h
h
h
h
h
h
h
h
h
c
c
c
c
"}
(17,1,1) = {"
o
o
o
o
o
o
h
h
h
h
h
h
h
h
W
h
h
B
h
h
h
h
h
h
h
h
h
h
B
h
h
h
h
h
h
h
h
h
T
T
T
T
"}
(18,1,1) = {"
h
h
h
h
h
h
h
h
h
h
h
h
h
h
W
h
h
x
B
B
B
B
B
B
B
B
B
B
x
h
h
h
h
h
h
h
T
T
T
T
T
T
"}
(19,1,1) = {"
W
W
W
W
W
W
W
W
W
W
W
W
W
W
W
h
h
h
h
h
h
h
h
h
h
h
h
h
h
h
h
h
h
h
h
T
T
T
T
a
T
T
"}
(20,1,1) = {"
h
h
h
h
h
h
h
h
h
h
h
h
h
h
h
h
h
h
h
h
h
h
h
h
h
S
h
h
h
h
h
h
h
h
T
T
T
T
T
T
T
T
"}
(21,1,1) = {"
h
h
h
h
h
h
h
h
h
h
h
h
h
h
h
h
h
h
h
h
h
h
h
h
h
h
h
h
h
h
h
h
T
T
T
a
T
T
T
y
T
T
"}
(22,1,1) = {"
h
y
y
y
y
y
h
h
h
h
h
h
h
h
h
h
h
h
h
h
h
h
y
y
y
y
y
h
h
h
T
T
T
G
T
T
T
T
T
T
G
T
"}
(23,1,1) = {"
h
G
T
a
T
T
u
h
h
h
h
h
h
h
h
h
h
h
u
y
y
y
T
T
G
T
T
y
O
T
T
T
G
a
T
T
y
h
h
T
a
T
"}
(24,1,1) = {"
h
y
T
T
T
T
y
h
h
h
h
h
h
h
h
h
h
h
T
T
T
T
T
T
T
a
T
T
T
T
y
T
T
y
T
T
y
h
h
T
T
T
"}
(25,1,1) = {"
h
h
h
y
T
T
y
T
T
T
T
h
h
h
h
h
h
y
T
T
T
T
T
T
T
T
T
T
T
T
T
T
y
T
T
y
h
h
h
T
T
T
"}
(26,1,1) = {"
h
h
h
h
h
T
y
T
T
T
T
h
h
h
h
y
y
T
T
T
a
T
T
a
T
T
T
T
T
T
a
T
T
T
y
h
h
h
h
T
G
T
"}
(27,1,1) = {"
y
y
y
y
y
T
y
a
T
T
T
T
c
T
T
T
T
T
T
T
T
T
T
T
T
T
a
T
T
T
T
T
T
T
T
y
h
y
y
T
T
T
"}
(28,1,1) = {"
T
T
T
T
T
T
G
y
y
y
y
y
p
y
T
T
u
T
G
T
T
T
T
T
T
g
T
T
T
T
a
T
T
T
T
T
y
T
T
T
T
T
"}
(29,1,1) = {"
T
T
T
a
T
T
T
T
T
T
a
T
c
T
T
T
y
T
T
y
T
T
T
T
T
T
T
T
T
T
T
T
T
T
a
T
T
T
T
a
T
T
"}
(30,1,1) = {"
T
T
T
T
T
T
T
T
T
T
T
T
c
T
T
T
u
T
T
T
T
T
T
T
G
y
T
T
T
T
a
T
T
G
T
T
T
T
T
T
u
h
"}
(31,1,1) = {"
a
T
T
T
T
T
T
T
T
T
T
y
h
h
T
T
y
E
E
E
E
E
E
E
E
J
E
E
E
T
T
T
T
T
T
T
T
T
T
T
y
h
"}
(32,1,1) = {"
y
T
T
T
T
T
T
h
h
h
h
h
h
h
h
T
y
E
D
D
D
D
D
D
D
c
c
D
X
T
T
T
T
T
T
T
a
T
T
y
T
h
"}
(33,1,1) = {"
T
T
T
a
g
T
T
h
h
h
h
h
h
h
h
T
y
E
D
T
G
T
T
T
T
T
T
T
B
h
h
h
h
h
T
T
T
T
y
T
T
T
"}
(34,1,1) = {"
y
T
T
y
T
T
T
h
h
h
h
h
h
h
y
T
T
E
D
T
T
T
T
T
T
T
T
h
B
h
h
h
h
h
a
T
T
T
y
T
T
T
"}
(35,1,1) = {"
h
y
T
T
T
T
T
T
h
h
h
h
h
y
T
T
T
E
D
T
T
T
M
T
a
T
T
y
B
h
h
h
h
h
h
h
h
h
h
c
c
c
"}
(36,1,1) = {"
h
h
h
T
T
y
T
T
T
h
h
h
y
T
T
T
T
E
D
T
T
T
T
T
T
T
T
y
B
h
h
h
h
h
h
h
h
h
h
h
G
T
"}
(37,1,1) = {"
h
h
h
T
T
O
G
T
m
y
T
T
T
T
T
T
u
B
h
T
T
a
T
T
T
a
T
y
B
h
h
h
h
h
h
h
h
h
h
h
T
T
"}
(38,1,1) = {"
h
h
h
T
T
T
T
T
T
T
T
T
T
T
T
y
y
B
h
T
G
T
T
T
a
G
y
h
B
h
h
h
h
h
h
h
h
h
h
h
h
T
"}
(39,1,1) = {"
h
h
h
h
T
T
T
T
T
T
T
T
T
a
T
h
h
B
h
h
y
T
T
T
T
y
h
h
B
h
h
h
h
h
h
h
h
h
h
h
h
h
"}
(40,1,1) = {"
h
h
h
h
T
T
T
T
T
T
T
T
T
T
T
h
h
B
B
B
h
h
h
h
h
h
h
B
B
h
h
h
h
h
h
h
h
h
h
h
h
h
"}
(41,1,1) = {"
h
h
h
T
T
T
T
T
T
T
T
T
T
T
h
h
h
h
h
h
B
B
B
B
B
B
B
h
h
h
h
h
h
h
h
h
h
h
h
h
h
h
"}
(42,1,1) = {"
h
h
h
T
T
T
a
T
T
h
h
h
h
h
h
h
h
h
h
h
h
h
h
h
h
h
h
h
h
h
h
h
h
h
h
h
h
h
h
h
h
h
"}
(43,1,1) = {"
h
h
T
T
T
T
T
T
T
h
h
h
h
h
h
h
h
h
h
h
h
h
h
h
h
h
h
h
h
h
h
h
h
h
h
h
h
h
h
h
h
h
"}
(44,1,1) = {"
h
h
c
c
c
c
c
c
h
h
h
h
h
h
h
h
h
h
h
h
h
h
h
h
h
h
h
h
h
h
h
h
h
h
h
h
h
h
h
h
h
h
"}
(45,1,1) = {"
h
h
T
T
T
T
T
T
h
h
h
h
h
h
h
h
h
h
h
h
h
h
h
h
h
h
h
h
h
h
h
h
h
h
h
h
h
h
h
h
h
h
"}
(46,1,1) = {"
T
T
T
T
T
a
T
T
h
h
h
h
h
h
h
h
h
h
h
h
h
h
h
h
h
h
h
h
h
h
h
h
h
h
T
T
T
T
T
T
T
T
"}
(47,1,1) = {"
T
T
G
T
T
T
G
h
h
h
h
h
h
h
h
h
h
h
h
h
h
h
h
h
h
h
h
h
h
h
h
h
h
h
T
T
T
T
T
T
T
T
"}
(48,1,1) = {"
T
T
a
T
T
T
T
h
h
h
h
h
h
h
h
h
h
h
h
h
h
h
h
h
h
h
h
h
h
h
h
h
h
T
T
T
T
T
T
G
T
T
"}
(49,1,1) = {"
T
T
G
T
a
T
h
h
h
h
h
h
h
h
h
h
h
h
h
h
h
h
h
h
h
h
h
h
h
h
h
h
h
T
T
T
a
T
T
T
a
T
"}
(50,1,1) = {"
T
T
T
T
T
T
h
h
h
h
h
h
h
h
h
h
h
h
h
h
T
T
T
T
T
T
T
T
T
T
T
T
T
T
T
T
T
T
T
T
T
T
"}
(51,1,1) = {"
T
T
T
T
T
T
h
h
h
h
h
h
h
h
h
h
h
h
h
h
T
T
T
T
T
T
T
T
T
T
T
T
T
T
T
T
T
T
T
T
T
T
"}
(52,1,1) = {"
T
O
T
T
T
a
h
h
h
T
T
T
T
T
T
T
T
T
T
T
T
T
T
T
T
T
T
T
T
T
G
a
T
T
T
T
R
T
a
G
T
T
"}
(53,1,1) = {"
T
T
T
T
T
T
h
h
h
T
T
T
T
T
T
a
T
a
T
T
T
T
T
y
a
T
T
T
T
T
T
T
T
T
y
T
T
T
T
T
T
T
"}
(54,1,1) = {"
T
T
T
T
T
T
T
T
T
T
T
T
T
T
T
T
T
T
T
R
a
T
T
T
T
T
T
g
T
T
T
T
T
T
T
T
T
T
T
T
T
T
"}
(55,1,1) = {"
a
T
G
T
T
a
T
T
T
T
T
a
G
T
T
a
T
T
T
T
G
T
T
T
T
a
T
T
T
T
G
T
T
T
T
T
T
T
T
T
T
T
"}
(56,1,1) = {"
T
T
T
T
T
T
T
T
T
T
T
y
T
T
T
T
T
T
T
T
T
T
T
T
T
T
T
T
T
T
T
a
T
T
h
h
h
h
h
h
h
h
"}
(57,1,1) = {"
T
T
T
h
T
T
T
T
T
T
T
T
T
T
T
T
T
O
T
T
T
T
T
T
T
T
T
T
T
T
T
T
T
T
h
h
h
h
h
h
h
h
"}
(58,1,1) = {"
T
T
T
h
h
h
h
h
h
T
T
T
T
T
T
T
T
T
T
T
T
T
T
T
T
T
h
h
h
h
h
h
h
h
h
h
h
h
h
h
h
h
"}
(59,1,1) = {"
T
T
h
h
h
h
h
h
h
T
T
T
T
T
T
T
T
T
T
T
T
T
T
T
T
T
h
h
h
h
h
h
h
h
h
h
h
h
h
h
h
h
"}
(60,1,1) = {"
h
h
h
h
h
h
h
h
h
h
h
h
h
T
T
T
T
T
h
h
h
h
h
h
h
h
h
h
h
h
h
h
h
h
h
h
h
h
h
h
h
h
"}
(61,1,1) = {"
h
h
h
h
h
h
h
h
h
h
h
h
h
h
h
h
h
h
h
h
h
h
h
h
h
h
h
h
h
h
h
h
h
h
h
h
h
h
h
h
h
h
"}
(62,1,1) = {"
B
B
h
h
h
h
h
h
h
h
h
h
h
h
h
h
h
h
h
h
h
h
h
h
h
h
h
h
h
h
h
h
h
h
h
h
h
h
h
h
h
h
"}
(63,1,1) = {"
h
B
B
h
h
h
h
h
h
h
h
h
h
h
h
h
h
h
h
h
h
h
h
h
h
h
h
h
h
h
h
h
h
h
h
h
h
h
h
h
h
h
"}
(64,1,1) = {"
h
h
B
h
h
h
h
h
h
h
h
h
h
h
h
h
h
h
h
h
h
h
h
h
h
h
h
h
h
h
h
h
h
h
h
h
h
h
h
h
h
h
"}
(65,1,1) = {"
h
h
B
h
h
h
h
h
h
h
h
h
h
h
h
h
h
h
h
h
h
h
h
h
h
h
h
h
h
h
h
h
h
h
h
h
h
h
h
h
h
h
"}
(66,1,1) = {"
T
h
f
f
f
f
f
f
f
f
f
f
f
f
f
f
f
f
f
f
f
f
f
f
f
f
f
f
f
f
f
f
f
f
f
f
f
f
f
f
f
f
"}
