//MAP CONVERTED BY dmm2tgm.py THIS HEADER COMMENT PREVENTS RECONVERSION, DO NOT REMOVE
"a" = (
/turf/open/space/basic,
/area/space)
"c" = (
/atom/movable/effect/landmark/excavation_site_spawner,
/turf/open/floor/plating/ground/mars/random/cave,
/area/bigredv2/caves/southwest)
"e" = (
/atom/movable/effect/landmark/xeno_resin_door,
/turf/open/floor/plating/ground/mars/random/cave,
/area/bigredv2/caves/southwest)
"g" = (
/atom/movable/effect/landmark/lv624/fog_blocker,
/turf/closed/mineral/bigred,
/area/bigredv2/caves/rock)
"h" = (
/turf/open/floor/plating/ground/mars/random/cave,
/area/bigredv2/caves/southwest)
"i" = (
/atom/movable/effect/ai_node,
/turf/open/floor/plating/ground/mars/random/cave,
/area/bigredv2/caves/southwest)
"p" = (
/turf/open/floor/plating/ground/mars/random/cave/rock,
/area/bigredv2/caves/southwest)
"u" = (
/atom/movable/effect/landmark/weed_node,
/turf/open/floor/plating/ground/mars/random/cave,
/area/bigredv2/caves/southwest)
"v" = (
/atom/movable/effect/landmark/weed_node,
/turf/open/floor/plating/ground/mars/random/cave/rock,
/area/bigredv2/caves/southwest)
"w" = (
/atom/movable/effect/landmark/lv624/fog_blocker,
/turf/open/floor/plating/ground/mars/random/cave,
/area/bigredv2/caves/southwest)
"x" = (
/turf/closed/mineral/bigred,
/area/bigredv2/caves/rock)
"A" = (
/atom/movable/effect/landmark/xeno_silo_spawn,
/turf/open/floor/plating/ground/mars/random/cave,
/area/bigredv2/caves/southwest)
"C" = (
/atom/movable/effect/landmark/excavation_site_spawner,
/atom/movable/effect/ai_node,
/turf/open/floor/plating/ground/mars/random/cave,
/area/bigredv2/caves/southwest)
"H" = (
/atom/movable/effect/landmark/weed_node,
/atom/movable/effect/landmark/weed_node,
/turf/open/floor/plating/ground/mars/random/cave,
/area/bigredv2/caves/southwest)
"I" = (
/atom/movable/effect/landmark/lv624/fog_blocker/xeno_spawn,
/turf/closed/mineral/bigred,
/area/bigredv2/caves/rock)
"N" = (
/atom/movable/effect/landmark/xeno_resin_wall,
/turf/open/floor/plating/ground/mars/random/cave,
/area/bigredv2/caves/southwest)
"O" = (
/turf/closed/wall/indestructible/mineral,
/area/space)
"R" = (
/atom/movable/effect/landmark/lv624/fog_blocker/xeno_spawn,
/turf/open/floor/plating/ground/mars/random/cave,
/area/bigredv2/caves/southwest)
"S" = (
/atom/movable/effect/landmark/weed_node,
/atom/movable/effect/ai_node,
/turf/open/floor/plating/ground/mars/random/cave,
/area/bigredv2/caves/southwest)
"T" = (
/atom/movable/effect/landmark/weed_node,
/atom/movable/effect/landmark/xeno_resin_wall,
/turf/open/floor/plating/ground/mars/random/cave,
/area/bigredv2/caves/southwest)
"Z" = (
/atom/movable/effect/ai_node,
/turf/open/floor/plating/ground/mars/random/cave/rock,
/area/bigredv2/caves/southwest)

(1,1,1) = {"
O
O
O
O
O
O
O
O
O
O
O
O
O
O
O
O
O
O
O
O
O
O
O
O
O
O
O
O
O
O
O
O
O
O
O
O
a
a
a
a
a
a
a
"}
(2,1,1) = {"
x
x
x
x
x
x
x
x
x
x
x
x
I
x
x
x
x
x
x
x
x
x
x
x
x
x
x
x
x
x
x
x
x
x
x
O
a
a
a
a
a
a
a
"}
(3,1,1) = {"
x
x
x
x
x
x
x
x
x
x
x
x
I
x
x
x
x
x
x
x
x
x
x
x
x
x
x
x
x
x
x
x
x
x
x
O
a
a
a
a
a
a
a
"}
(4,1,1) = {"
x
x
x
x
x
x
x
x
x
x
x
x
I
x
x
x
x
x
x
x
x
x
x
x
x
x
x
x
x
x
x
x
x
x
x
O
a
a
a
a
a
a
a
"}
(5,1,1) = {"
x
x
x
x
x
x
x
x
x
x
x
x
I
x
x
x
x
x
x
x
x
x
x
x
x
x
x
x
x
x
x
x
x
x
x
O
a
a
a
a
a
a
a
"}
(6,1,1) = {"
x
x
x
x
x
x
x
x
x
x
x
x
I
x
x
x
x
h
p
p
p
p
p
x
x
x
x
x
x
x
x
x
x
x
x
O
a
a
a
a
a
a
a
"}
(7,1,1) = {"
x
x
x
x
h
h
h
h
h
x
x
x
I
x
x
v
N
h
h
h
h
h
h
p
x
x
x
x
x
x
x
x
x
x
x
O
a
a
a
a
a
a
a
"}
(8,1,1) = {"
x
x
h
h
h
u
h
h
h
h
h
x
I
x
p
h
N
h
h
u
h
u
h
p
x
x
x
x
x
x
x
x
x
x
x
O
a
a
a
a
a
a
a
"}
(9,1,1) = {"
x
h
h
h
h
h
h
h
h
h
h
h
R
h
h
h
N
h
h
h
A
h
h
v
x
x
x
x
x
x
x
x
x
x
x
O
a
a
a
a
a
a
a
"}
(10,1,1) = {"
h
h
i
h
u
u
h
h
u
h
u
i
R
h
h
i
N
h
h
u
i
h
h
h
p
x
x
x
x
x
x
x
x
x
x
O
a
a
a
a
a
a
a
"}
(11,1,1) = {"
u
h
h
h
h
h
u
h
h
h
h
h
R
h
h
h
T
h
h
h
h
h
h
h
p
x
x
x
x
x
x
x
x
x
x
O
a
a
a
a
a
a
a
"}
(12,1,1) = {"
h
h
h
h
h
h
h
h
h
h
x
x
I
h
h
h
N
h
h
h
h
h
h
h
h
h
h
x
x
x
x
x
x
x
x
O
a
a
a
a
a
a
a
"}
(13,1,1) = {"
h
p
Z
x
x
x
x
x
x
x
x
x
I
h
h
u
N
N
N
N
e
e
N
N
T
N
N
x
x
x
x
x
x
x
x
O
a
a
a
a
a
a
a
"}
(14,1,1) = {"
h
h
p
x
x
x
x
x
x
x
x
x
I
h
h
h
h
h
h
h
h
h
h
h
h
h
h
p
x
x
x
x
x
x
x
O
a
a
a
a
a
a
a
"}
(15,1,1) = {"
h
h
h
p
p
x
x
x
x
x
x
x
I
p
h
h
h
h
h
u
h
h
h
h
h
h
h
h
x
x
x
x
x
x
x
O
a
a
a
a
a
a
a
"}
(16,1,1) = {"
h
h
H
h
p
x
x
x
x
x
x
x
I
x
h
i
u
h
h
h
i
h
h
h
h
i
h
h
x
x
x
x
x
x
x
O
a
a
a
a
a
a
a
"}
(17,1,1) = {"
h
u
h
h
p
x
x
x
x
x
x
x
I
x
h
h
h
h
h
c
h
h
h
h
h
h
h
p
x
x
x
x
x
x
x
O
a
a
a
a
a
a
a
"}
(18,1,1) = {"
h
h
h
h
p
x
x
x
x
x
x
x
I
x
h
h
h
h
h
h
u
h
h
H
h
h
x
x
x
x
x
x
x
x
x
O
a
a
a
a
a
a
a
"}
(19,1,1) = {"
h
u
i
h
Z
x
x
x
x
x
x
x
I
I
R
R
R
R
h
h
h
u
h
p
h
h
x
x
x
x
x
x
x
x
x
O
a
a
a
a
a
a
a
"}
(20,1,1) = {"
x
h
h
h
u
p
x
x
x
x
x
p
p
p
h
h
h
R
h
h
h
h
h
p
h
h
h
x
x
x
x
x
x
x
x
O
a
a
a
a
a
a
a
"}
(21,1,1) = {"
x
x
x
h
h
p
x
x
x
x
x
p
h
h
h
u
h
R
h
h
h
h
p
h
h
u
h
x
x
x
x
x
x
x
x
O
a
a
a
a
a
a
a
"}
(22,1,1) = {"
x
x
x
u
h
h
p
h
x
x
x
h
i
h
h
i
p
I
p
h
h
h
p
x
x
h
h
x
x
x
x
x
x
x
x
O
a
a
a
a
a
a
a
"}
(23,1,1) = {"
x
x
x
h
h
h
h
h
h
x
h
h
h
h
h
p
x
I
I
I
I
I
I
I
I
R
R
R
I
I
I
I
I
I
I
O
a
a
a
a
a
a
a
"}
(24,1,1) = {"
x
x
x
h
h
u
h
h
p
h
h
p
h
u
h
p
x
x
x
x
x
x
x
x
h
h
h
h
x
x
x
x
x
x
x
O
a
a
a
a
a
a
a
"}
(25,1,1) = {"
x
x
x
p
h
h
h
u
h
h
v
h
h
h
h
x
x
x
x
x
x
x
x
x
h
S
h
h
x
x
x
x
x
x
x
O
a
a
a
a
a
a
a
"}
(26,1,1) = {"
x
x
x
x
i
h
h
h
h
h
h
u
p
h
h
x
x
x
x
x
x
x
x
x
x
h
i
h
x
x
x
x
x
x
x
O
a
a
a
a
a
a
a
"}
(27,1,1) = {"
x
x
x
h
u
i
h
h
h
h
h
h
i
h
h
x
x
x
x
x
x
x
x
x
x
h
h
u
h
x
x
x
x
x
x
O
a
a
a
a
a
a
a
"}
(28,1,1) = {"
x
x
h
h
h
h
h
h
h
h
h
h
u
h
p
x
x
x
x
x
x
x
x
x
x
x
h
h
h
x
x
x
x
x
x
O
a
a
a
a
a
a
a
"}
(29,1,1) = {"
x
x
h
h
h
h
h
u
h
h
h
h
h
u
h
x
x
x
x
x
x
x
x
x
x
x
h
u
h
x
x
x
x
x
x
O
a
a
a
a
a
a
a
"}
(30,1,1) = {"
x
x
h
u
h
h
h
h
u
p
x
p
i
h
h
h
x
x
x
x
x
x
x
x
x
x
h
u
h
h
x
x
x
x
x
O
a
a
a
a
a
a
a
"}
(31,1,1) = {"
x
h
h
h
h
h
h
h
h
p
x
x
p
i
u
h
h
x
x
x
x
x
x
x
x
x
Z
h
h
h
x
x
x
x
x
O
a
a
a
a
a
a
a
"}
(32,1,1) = {"
x
h
i
h
h
i
x
h
h
p
x
x
x
h
i
h
h
i
h
x
x
x
x
x
x
x
p
Z
u
h
x
x
x
x
x
O
a
a
a
a
a
a
a
"}
(33,1,1) = {"
x
h
h
h
x
x
x
p
p
x
x
x
x
h
h
h
u
h
u
h
p
x
x
x
x
x
x
p
i
h
h
x
x
x
x
O
a
a
a
a
a
a
a
"}
(34,1,1) = {"
x
h
h
h
x
x
x
x
x
x
x
x
x
x
h
h
h
h
h
h
h
p
x
x
x
x
x
x
h
h
h
h
x
x
x
O
a
a
a
a
a
a
a
"}
(35,1,1) = {"
x
h
h
x
x
x
x
x
x
x
x
x
x
h
h
h
h
h
h
h
p
x
x
x
x
x
x
x
h
h
h
x
x
x
x
O
a
a
a
a
a
a
a
"}
(36,1,1) = {"
x
h
h
x
x
x
x
x
x
x
x
x
x
p
h
h
h
h
u
h
p
x
x
x
x
x
x
x
h
u
h
x
x
x
x
O
a
a
a
a
a
a
a
"}
(37,1,1) = {"
h
h
h
x
x
x
x
x
x
x
x
x
x
x
x
x
h
C
h
h
h
Z
x
x
x
x
x
x
h
c
h
x
x
x
x
O
a
a
a
a
a
a
a
"}
(38,1,1) = {"
h
h
h
x
x
x
x
x
x
x
x
x
x
x
x
x
h
h
h
h
h
p
x
x
x
x
p
v
h
u
h
x
x
x
x
O
a
a
a
a
a
a
a
"}
(39,1,1) = {"
h
h
h
x
x
x
x
x
x
x
x
x
x
x
x
x
p
h
h
h
h
p
x
x
x
x
p
p
h
h
x
x
x
x
x
O
a
a
a
a
a
a
a
"}
(40,1,1) = {"
h
u
h
x
x
x
x
x
x
x
x
x
x
x
x
x
x
x
x
u
u
h
p
p
x
x
x
x
h
h
x
x
x
x
x
O
a
a
a
a
a
a
a
"}
(41,1,1) = {"
w
w
w
g
g
g
g
g
g
g
g
g
g
g
x
x
x
x
x
h
h
h
h
p
x
x
x
x
h
u
x
x
x
x
x
O
a
a
a
a
a
a
a
"}
