//MAP CONVERTED BY dmm2tgm.py THIS HEADER COMMENT PREVENTS RECONVERSION, DO NOT REMOVE
"a" = (
/turf/closed/mineral/bigred,
/area/bigredv2/caves/rock)
"f" = (
/atom/movable/effect/landmark/weed_node,
/turf/open/floor/plating/ground/mars/random/cave,
/area/bigredv2/caves/east)
"h" = (
/turf/open/floor/plating/ground/mars/random/cave,
/area/bigredv2/caves/northeast)
"k" = (
/turf/open/floor/plating/ground/mars/random/cave,
/area/bigredv2/caves/east)
"m" = (
/atom/movable/effect/landmark/lv624/fog_blocker,
/atom/movable/effect/ai_node,
/turf/open/floor/plating/ground/mars/random/cave,
/area/bigredv2/caves/east)
"w" = (
/atom/movable/effect/landmark/weed_node,
/turf/open/floor/plating/ground/mars/random/cave,
/area/bigredv2/caves/northeast)
"y" = (
/atom/movable/effect/landmark/start/job/xenomorph,
/atom/movable/effect/landmark/weed_node,
/turf/open/floor/plating/ground/mars/random/cave,
/area/bigredv2/caves/east)
"z" = (
/turf/open/floor/plating/ground/mars/random/cave/rock,
/area/bigredv2/caves/east)
"H" = (
/atom/movable/effect/landmark/lv624/fog_blocker,
/turf/closed/mineral/bigred,
/area/bigredv2/caves/rock)
"J" = (
/atom/movable/effect/landmark/weed_node,
/atom/movable/effect/ai_node,
/turf/open/floor/plating/ground/mars/random/cave,
/area/bigredv2/caves/east)
"M" = (
/atom/movable/effect/landmark/lv624/fog_blocker,
/turf/open/floor/plating/ground/mars/random/cave,
/area/bigredv2/caves/east)
"P" = (
/atom/movable/effect/ai_node,
/turf/open/floor/plating/ground/mars/random/cave,
/area/bigredv2/caves/northeast)
"Z" = (
/atom/movable/effect/ai_node,
/turf/open/floor/plating/ground/mars/random/cave,
/area/bigredv2/caves/east)

(1,1,1) = {"
a
a
a
a
a
a
a
a
a
a
a
"}
(2,1,1) = {"
a
a
a
a
a
a
a
a
a
a
a
"}
(3,1,1) = {"
a
a
a
a
a
a
a
a
a
a
a
"}
(4,1,1) = {"
a
a
a
a
a
a
a
a
a
a
a
"}
(5,1,1) = {"
a
a
a
a
a
a
a
a
a
a
a
"}
(6,1,1) = {"
w
a
a
k
f
k
Z
k
a
a
a
"}
(7,1,1) = {"
h
k
k
k
f
k
k
f
k
z
z
"}
(8,1,1) = {"
P
f
k
Z
k
k
Z
k
k
J
M
"}
(9,1,1) = {"
h
k
k
k
a
a
a
a
k
M
Z
"}
(10,1,1) = {"
P
k
f
k
a
a
a
a
a
m
k
"}
(11,1,1) = {"
w
k
f
k
k
a
k
H
H
k
y
"}
(12,1,1) = {"
h
k
f
k
f
k
M
z
f
k
Z
"}
(13,1,1) = {"
P
f
k
Z
k
M
k
k
k
Z
a
"}
(14,1,1) = {"
a
k
k
a
f
M
a
a
k
a
a
"}
(15,1,1) = {"
a
a
a
a
a
H
a
a
a
a
a
"}
(16,1,1) = {"
a
a
a
a
a
H
a
a
a
a
a
"}
(17,1,1) = {"
a
a
a
a
a
H
a
a
a
a
a
"}
(18,1,1) = {"
a
a
a
a
a
H
a
a
a
a
a
"}
(19,1,1) = {"
a
a
a
a
a
H
a
a
a
a
a
"}
(20,1,1) = {"
a
a
a
a
a
H
a
a
a
a
a
"}
(21,1,1) = {"
a
a
a
a
a
H
a
a
a
a
a
"}
(22,1,1) = {"
H
H
H
H
H
a
a
a
a
a
a
"}
