//MAP CONVERTED BY dmm2tgm.py THIS HEADER COMMENT PREVENTS RECONVERSION, DO NOT REMOVE
"aa" = (
/obj/effect/landmark/weed_node,
/turf/open/floor/plating/ground/mars/random/cave,
/area/bigredv2/caves/east)
"ab" = (
/obj/effect/landmark/lv624/fog_blocker/xeno_spawn,
/obj/effect/landmark/lv624/fog_blocker/xeno_spawn,
/turf/closed/mineral/bigred,
/area/bigredv2/caves/rock)
"ac" = (
/obj/effect/ai_node,
/turf/open/floor/plating/ground/mars/random/cave,
/area/bigredv2/caves/east)
"ad" = (
/turf/closed/mineral/smooth/bigred,
/area/bigredv2/caves/rock)
"ae" = (
/atom/movable/effect/landmark/weed_node,
/atom/movable/effect/ai_node,
/turf/open/floor/plating/ground/mars/random/cave,
/area/bigredv2/caves/east)
"af" = (
/atom/movable/effect/landmark/weed_node,
/turf/open/floor/plating/ground/mars/random/cave,
/area/bigredv2/caves/east)
"ag" = (
/turf/closed/mineral/bigred,
/area/bigredv2/caves/rock)
"ah" = (
/obj/effect/landmark/lv624/fog_blocker/xeno_spawn,
/obj/effect/landmark/xeno_resin_wall,
/turf/open/floor/plating/ground/mars/random/cave,
/area/bigredv2/caves/east)
"ai" = (
/turf/open/floor/plating/ground/mars/random/cave,
/area/bigredv2/caves/east)
"aj" = (
/obj/effect/ai_node,
/turf/open/floor/plating/ground/mars/random/cave/rock,
/area/bigredv2/caves/east)
"ak" = (
/obj/machinery/miner/damaged/platinum,
/turf/open/floor/plating/ground/mars/random/cave,
/area/bigredv2/caves/east)
"al" = (
/atom/movable/effect/landmark/xeno_resin_door,
/turf/open/floor/plating/ground/mars/random/cave,
/area/bigredv2/caves/east)
"am" = (
/atom/movable/effect/ai_node,
/turf/open/floor/plating/ground/mars/random/cave,
/area/bigredv2/caves/east)
"an" = (
/atom/movable/effect/landmark/xeno_resin_wall,
/turf/open/floor/plating/ground/mars/random/cave,
/area/bigredv2/caves/east)
"ao" = (
/obj/effect/landmark/xeno_resin_wall,
/turf/open/floor/plating/ground/mars/random/cave,
/area/bigredv2/caves/east)
"ap" = (
/turf/open/floor/plating/ground/mars/random/cave/rock,
/area/bigredv2/caves/east)
"aq" = (
/obj/docking_port/stationary/crashmode,
/turf/closed/mineral/smooth/bigred,
/area/bigredv2/caves/rock)
"ar" = (
/obj/effect/landmark/lv624/fog_blocker/xeno_spawn,
/turf/open/floor/plating/ground/mars/random/cave/rock,
/area/bigredv2/caves/east)
"as" = (
/atom/movable/effect/landmark/lv624/fog_blocker,
/turf/closed/mineral/smooth/bigred,
/area/bigredv2/caves/rock)
"at" = (
/obj/structure/fence,
/atom/movable/effect/landmark/lv624/fog_blocker,
/turf/open/floor/plating/ground/mars/random/cave,
/area/bigredv2/caves/east)
"au" = (
/atom/movable/effect/landmark/lv624/fog_blocker/xeno_spawn,
/turf/closed/mineral/smooth/bigred,
/area/bigredv2/caves/rock)
"av" = (
/obj/effect/landmark/weed_node,
/obj/effect/ai_node,
/turf/open/floor/plating/ground/mars/random/cave,
/area/bigredv2/caves/east)
"aw" = (
/atom/movable/effect/landmark/weed_node,
/atom/movable/effect/landmark/xeno_resin_door,
/turf/open/floor/plating/ground/mars/random/cave,
/area/bigredv2/caves/east)
"ax" = (
/atom/movable/effect/landmark/excavation_site_spawner,
/turf/open/floor/plating/ground/mars/random/cave,
/area/bigredv2/caves/east)
"ay" = (
/atom/movable/effect/landmark/lv624/fog_blocker/xeno_spawn,
/atom/movable/effect/landmark/lv624/fog_blocker/xeno_spawn,
/turf/open/floor/plating/ground/mars/random/cave,
/area/bigredv2/caves/east)
"az" = (
/atom/movable/effect/landmark/xeno_resin_door,
/atom/movable/effect/ai_node,
/turf/open/floor/plating/ground/mars/random/cave,
/area/bigredv2/caves/east)
"aA" = (
/atom/movable/effect/landmark/weed_node,
/turf/open/floor/plating/ground/mars/random/cave/rock,
/area/bigredv2/caves/east)
"aB" = (
/obj/effect/landmark/weed_node,
/turf/open/floor/plating/ground/mars/random/cave/rock,
/area/bigredv2/caves/east)
"aC" = (
/obj/effect/landmark/lv624/fog_blocker/xeno_spawn,
/turf/closed/mineral/bigred,
/area/bigredv2/caves/rock)
"aD" = (
/obj/effect/landmark/xeno_silo_spawn,
/turf/open/floor/plating/ground/mars/random/cave,
/area/bigredv2/caves/east)
"aE" = (
/atom/movable/effect/landmark/lv624/fog_blocker/xeno_spawn,
/turf/open/floor/plating/ground/mars/random/cave/rock,
/area/bigredv2/caves/east)
"aF" = (
/atom/movable/effect/landmark/weed_node,
/turf/open/floor/plating/ground/mars/random/sand,
/area/bigredv2/outside/se)
"aG" = (
/atom/movable/effect/landmark/lv624/fog_blocker/xeno_spawn,
/atom/movable/effect/landmark/lv624/fog_blocker/xeno_spawn,
/turf/closed/mineral/smooth/bigred,
/area/bigredv2/caves/rock)
"aH" = (
/obj/effect/landmark/lv624/fog_blocker/xeno_spawn,
/obj/effect/landmark/lv624/fog_blocker/xeno_spawn,
/turf/open/floor/plating/ground/mars/random/cave,
/area/bigredv2/caves/east)
"aI" = (
/obj/effect/landmark/xeno_resin_door,
/obj/effect/ai_node,
/turf/open/floor/plating/ground/mars/random/cave,
/area/bigredv2/caves/east)
"aJ" = (
/obj/effect/ai_node,
/turf/open/floor/plating/ground/mars/random/sand,
/area/bigredv2/outside/se)
"aK" = (
/atom/movable/effect/landmark/xeno_silo_spawn,
/turf/open/floor/plating/ground/mars/random/cave,
/area/bigredv2/caves/east)
"aL" = (
/turf/closed/wall/indestructible/mineral,
/area/space)
"aM" = (
/obj/effect/landmark/lv624/fog_blocker/xeno_spawn,
/turf/open/floor/plating/ground/mars/random/cave,
/area/bigredv2/caves/east)
"aN" = (
/obj/effect/landmark/excavation_site_spawner,
/turf/open/floor/plating/ground/mars/random/cave,
/area/bigredv2/caves/east)
"aO" = (
/obj/docking_port/stationary/crashmode,
/turf/closed/mineral/bigred,
/area/bigredv2/caves/rock)
"aP" = (
/obj/effect/landmark/weed_node,
/turf/open/floor/plating/ground/mars/random/sand,
/area/bigredv2/outside/se)
"aQ" = (
/obj/structure/fence,
/obj/effect/landmark/lv624/fog_blocker,
/turf/open/floor/plating/ground/mars/random/cave,
/area/bigredv2/caves/east)
"aR" = (
/atom/movable/effect/landmark/lv624/fog_blocker/xeno_spawn,
/turf/open/floor/plating/ground/mars/random/cave,
/area/bigredv2/caves/east)
"aS" = (
/atom/movable/effect/ai_node,
/turf/open/floor/plating/ground/mars/random/sand,
/area/bigredv2/outside/se)
"aT" = (
/obj/docking_port/stationary/crashmode,
/turf/open/floor/plating/ground/mars/random/cave,
/area/bigredv2/caves/east)
"aU" = (
/obj/effect/landmark/weed_node,
/obj/effect/landmark/xeno_resin_door,
/turf/open/floor/plating/ground/mars/random/cave,
/area/bigredv2/caves/east)
"aV" = (
/obj/effect/landmark/xeno_resin_door,
/turf/open/floor/plating/ground/mars/random/cave,
/area/bigredv2/caves/east)
"aW" = (
/atom/movable/effect/landmark/lv624/fog_blocker/xeno_spawn,
/atom/movable/effect/landmark/xeno_resin_wall,
/turf/open/floor/plating/ground/mars/random/cave,
/area/bigredv2/caves/east)
"aX" = (
/obj/effect/landmark/lv624/fog_blocker,
/turf/closed/mineral/bigred,
/area/bigredv2/caves/rock)
"aY" = (
/turf/open/floor/plating/ground/mars/random/sand,
/area/bigredv2/outside/se)
"aZ" = (
/turf/closed/mineral/smooth/bigred/indestructible,
/area/space)
"wM" = (
/atom/movable/effect/ai_node,
/turf/open/floor/plating/ground/mars/random/cave/rock,
/area/bigredv2/caves/east)

(1,1,1) = {"
aY
aY
aY
aY
aY
aY
aY
aY
aY
aY
aY
ad
ad
ad
at
ai
af
ai
ai
af
ai
ai
ai
ai
ai
af
ai
ai
ad
ad
ad
ad
ad
ad
ad
ad
ad
ai
af
ai
ai
af
"}
(2,1,1) = {"
aY
aY
aF
aY
aY
aY
aF
aY
aY
aY
aY
ad
ad
ad
as
ai
ai
ai
ai
ai
ai
ai
ai
ai
ai
ai
ai
ai
ad
ad
ad
ad
ad
ad
ad
ad
ad
ad
ai
ai
am
ai
"}
(3,1,1) = {"
aY
aY
aY
aY
aY
aY
aY
aY
aY
aY
aY
ad
ad
ad
as
ai
ai
ai
ai
ai
ai
ad
ad
ad
ad
ad
ai
ai
ai
ad
ad
ad
ad
ad
ad
ad
ad
ad
ai
ai
ai
ai
"}
(4,1,1) = {"
aY
ad
ad
ad
ad
aY
aY
aY
aF
aY
aY
aF
ad
ad
as
ai
ai
ai
af
ai
ai
ad
ad
ad
ad
ad
ap
ai
ai
ai
ai
af
ai
ai
ai
ad
ap
ap
ai
ai
ai
ai
"}
(5,1,1) = {"
aY
ad
ad
ad
ad
ad
ad
aY
aY
aY
aY
aY
aY
ad
as
ad
ai
ay
aR
aR
au
au
au
au
au
au
aR
aE
ay
ai
ai
ai
ai
ai
af
ap
ai
ai
af
ai
ai
af
"}
(6,1,1) = {"
aY
aY
ad
ad
ad
ad
ad
ad
aY
aY
aY
aY
aY
ad
as
ad
ad
aR
ai
ad
ad
ad
ad
ad
ad
ai
ai
ai
aE
aA
am
ai
ai
ai
ai
ai
ai
ai
ai
ai
am
ap
"}
(7,1,1) = {"
aY
aY
aY
aY
aY
aY
aY
aY
aY
aY
aY
aY
aY
ad
as
ad
ad
aW
an
an
ai
ad
ai
ad
ad
ai
am
ai
aR
am
ai
ai
af
ai
ai
ai
ai
af
ai
ak
ai
ap
"}
(8,1,1) = {"
aY
aF
aY
aY
aF
aY
aY
aY
aF
aY
aY
aF
aY
ad
as
ad
ad
au
ai
ai
ai
ae
ai
ai
az
ai
ai
ai
aR
ai
ai
ai
ai
ai
ai
ai
ap
ai
ai
ai
ap
ad
"}
(9,1,1) = {"
aY
aY
aY
aY
aY
aS
aY
aY
aY
aS
aY
aY
aY
ad
as
ad
ad
au
ai
ai
ai
ai
ai
ai
al
ai
ai
ad
au
ad
ad
ad
ai
ai
ai
ai
af
ap
ai
ai
ai
ap
"}
(10,1,1) = {"
aY
aY
aY
aY
aY
aY
aY
aY
aY
aY
aY
aY
ad
ad
as
ad
ad
au
ad
ad
ai
ai
ai
ai
an
ad
ad
ad
au
ad
ad
ad
ad
ad
ad
ad
ai
ai
ai
af
af
ap
"}
(11,1,1) = {"
aY
aY
ad
aY
aY
aY
aY
aY
aY
aY
aY
ad
ad
ad
as
ad
ad
au
ad
ai
ai
ai
ai
ai
an
an
ad
ad
au
ad
ad
ad
ad
ad
ad
ad
ai
ai
ai
ai
ai
ap
"}
(12,1,1) = {"
aY
ad
ad
aY
aF
aY
aY
aY
aF
ad
ad
ad
ad
ad
as
ad
ad
au
ai
ap
ai
ai
aA
af
ai
ai
ad
ad
au
ad
ad
ad
ad
ad
ad
ad
ai
ai
ai
af
ai
ap
"}
(13,1,1) = {"
ad
ad
ad
aY
aY
aY
aY
aY
aY
ad
ad
ad
ad
ad
as
ad
ad
au
ai
af
ai
ai
ai
ai
ai
ai
ad
ad
au
ad
ad
ad
ad
ad
ad
ad
ap
ai
af
ai
ap
ad
"}
(14,1,1) = {"
ad
ad
aY
aY
aY
aY
aY
aY
aY
ad
ad
ad
ad
ad
as
ad
ad
au
ai
ai
ai
am
aK
ai
ai
af
ai
ad
au
ad
ad
ad
ad
ad
ad
ad
ai
ai
af
ai
am
ap
"}
(15,1,1) = {"
ad
aY
aY
aY
aY
aY
ad
ad
ad
ad
ad
ad
ad
ad
as
ad
ad
au
ai
ai
ai
ai
ai
ai
af
ai
ad
ad
au
ad
ad
ad
ad
ad
ad
ad
ad
ap
ai
ai
ai
ap
"}
(16,1,1) = {"
aF
aY
aY
aY
aF
aS
ad
ad
ad
ad
ad
ad
ad
ad
as
ad
ad
au
ad
ai
ai
ai
ai
ai
ai
ad
ad
ad
au
ad
ad
ad
ad
ad
ad
ad
ad
ad
al
al
al
al
"}
(17,1,1) = {"
aY
aY
aY
aY
aY
aY
ad
ad
ad
ad
ad
ad
ad
ad
as
ad
ad
au
ad
ai
ai
ai
ai
ai
ad
ad
ad
ad
au
ad
ad
ad
ad
ad
ad
ad
ad
ad
ai
ai
ai
ai
"}
(18,1,1) = {"
ad
ad
ad
ad
ad
ad
ad
ad
ad
ad
ad
ad
ad
ad
as
ad
ad
aG
au
aR
aR
aR
aR
aR
au
au
au
au
aG
ad
ad
ad
ad
ad
ad
ad
ai
ai
ai
ai
ai
af
"}
(19,1,1) = {"
as
as
as
as
as
as
as
as
as
as
as
as
as
as
as
ad
ad
ad
ad
ad
ad
ai
ai
ai
ad
ad
ad
ad
ad
ad
ad
ad
ad
ad
ad
ai
ai
af
ai
ai
ai
ai
"}
(20,1,1) = {"
ad
ad
ad
ad
ad
ad
ad
ad
ad
ad
ad
ad
ad
ad
ad
ad
ad
ad
ad
ad
ad
ad
ad
ad
ad
aq
ad
ad
ad
ad
ad
ad
ad
ad
ai
ai
ai
ai
ai
ai
ai
ai
"}
(21,1,1) = {"
ad
ad
ad
ad
ad
ad
ad
ad
ad
ad
ad
ad
ad
ad
ad
ad
ad
ad
ad
ad
ad
ad
ad
ad
ad
ad
ad
ad
ad
ad
ad
ad
ad
ad
ai
ai
ai
ai
af
ap
ai
ai
"}
(22,1,1) = {"
ad
ap
ap
wM
ap
aA
ad
ad
ad
ad
ad
ad
ad
ad
ad
ad
ad
ad
ad
ad
ad
ad
ad
ad
ad
ad
ad
ad
ad
ad
ad
ad
ad
ad
ai
ai
ai
ai
ai
ai
ai
ai
"}
(23,1,1) = {"
ad
af
ai
ai
ai
ai
ap
ad
ad
ad
ad
ad
ad
ad
ad
ad
ad
ad
ad
ad
ad
ad
ad
ad
ad
ad
ad
ad
ad
ad
ad
ad
ad
ad
ai
af
ap
ad
ad
ai
ai
ai
"}
(24,1,1) = {"
ad
ap
ai
ai
ai
af
ap
ad
ad
ad
ad
ad
ad
ad
ad
ad
ad
ad
ad
ad
ad
ad
ad
ad
ad
ad
ad
ad
ad
ad
ad
ad
ad
ad
ad
ai
ap
ad
ad
ai
ai
ai
"}
(25,1,1) = {"
ad
ad
ad
wM
ai
ai
ap
ai
am
ai
ai
ad
ad
ad
ad
ad
ad
ad
ad
ad
ad
ad
ad
ad
ad
ad
ad
ad
ad
ad
ad
ad
ad
ad
ad
ad
ad
ad
ad
ai
ai
ai
"}
(26,1,1) = {"
ad
ad
ad
ad
ad
ai
ap
ai
ai
ai
ai
ad
ad
ad
ad
ad
ad
ad
ad
ad
ad
ad
ad
ad
ad
au
au
au
au
au
au
au
au
au
au
au
ad
ad
ad
ad
ai
ai
"}
(27,1,1) = {"
ap
ap
ap
ap
aA
ai
ap
af
ai
ai
ai
ap
ad
ad
ad
ad
ad
ad
ad
ad
ad
ad
ad
ad
ad
au
ad
ad
ad
ad
ad
ad
ad
ad
ad
au
ad
ad
ad
ad
am
ai
"}
(28,1,1) = {"
am
ai
ai
ai
af
am
ai
ap
wM
ap
ap
ai
ad
ad
ad
ad
ad
ad
ad
ad
ad
ad
ad
ad
ad
au
ad
ad
ad
ai
ai
ad
ad
ad
ad
au
ad
ad
ad
ad
ai
ai
"}
(29,1,1) = {"
ai
ai
ai
ai
ai
ai
ai
ai
ai
ai
ai
ad
ad
ad
ad
ad
ad
ad
ad
ad
ad
ad
ad
ad
ad
au
ad
ad
ai
ai
ai
ai
ad
ad
ad
au
ad
ad
ad
ad
ad
ai
"}
(30,1,1) = {"
ai
ai
af
ai
ai
ai
ai
ai
ai
ai
ai
ad
ad
ad
ad
ad
ad
ad
ad
ad
ad
ad
ad
ad
ad
au
ad
ad
ai
ai
aK
ai
ai
ad
ad
au
ad
ad
ad
ad
ad
ad
"}
(31,1,1) = {"
af
ai
ai
ai
ax
ai
af
ai
ai
ad
ad
ad
ad
ad
ad
ad
ad
ad
ad
ad
ad
ad
ad
ad
ad
au
ad
ad
ai
ai
ai
ai
ai
ad
ad
au
ad
ad
ad
ad
ad
ad
"}
(32,1,1) = {"
ap
ai
ai
ai
ai
ai
ai
ad
ad
ad
ad
ad
ad
ad
ad
ad
ad
ad
ad
ad
ad
ad
ad
ad
ad
au
ad
ai
ai
ai
ai
ai
ai
ai
ad
au
ad
ad
ad
ad
ad
ad
"}
(33,1,1) = {"
ai
ai
ai
ai
ak
ai
ai
ad
ad
ad
ad
ad
ad
ad
ad
ad
ad
ad
ad
ai
ad
ad
ad
ad
ad
au
ad
al
al
al
an
an
an
an
ad
au
ad
ad
ad
ad
ad
ad
"}
(34,1,1) = {"
ap
ai
af
ap
ai
ai
af
ad
ad
ad
ad
ai
ad
ad
ad
ad
ad
ad
ai
ai
ai
ad
ad
ad
ai
aR
ai
ai
ai
ai
ai
ai
ai
ai
ad
au
ad
ad
ad
ad
ad
ad
"}
(35,1,1) = {"
ad
ap
ai
ai
ai
ai
ai
ai
ad
ad
ad
ai
al
ai
ad
ad
ad
ai
ai
ai
ai
ai
ai
ai
ai
aR
aR
aR
aR
aR
aR
aR
aR
aR
aR
au
ad
ad
ad
ad
ad
ad
"}
(36,1,1) = {"
ad
ad
ad
ai
ai
ap
af
ai
ai
ad
ad
ai
al
ai
ai
ai
ai
ai
ai
ai
ai
ai
ai
ai
af
ai
ai
ai
ai
ai
ai
af
ai
ai
ai
ai
ad
ad
ad
ad
ad
ai
"}
(37,1,1) = {"
ad
ad
ad
af
ai
ap
ai
ai
aT
ap
ai
ai
al
ai
ai
ai
ai
ai
af
ai
ai
ai
ai
ai
ai
ai
af
ai
ai
ai
ai
ai
ai
ai
ai
ai
ai
ai
ai
ai
ai
ai
"}
(38,1,1) = {"
ad
ad
ad
ai
ai
am
ai
af
ai
ai
ai
ai
al
ai
af
ai
am
ai
ai
af
ai
ai
af
am
ai
ai
ai
ai
ai
ai
ai
am
ai
ax
ai
ai
af
ai
ai
am
ai
ai
"}
(39,1,1) = {"
ad
ad
ad
ad
ai
ai
ax
ai
ai
af
ai
ai
al
ai
ai
ai
ai
ai
ai
ai
ai
ai
ai
ai
ai
ai
ai
ai
ai
ai
ai
ai
af
ai
ai
ai
ai
ai
af
ai
af
ai
"}
(40,1,1) = {"
ad
ad
ad
ad
ai
ai
ai
ai
ai
ai
ai
ai
al
ai
ai
ai
ai
ai
ai
ai
ai
ai
ai
ai
ai
ai
ai
ai
af
ai
ai
ai
ai
af
ai
ai
ai
ai
ai
ai
ai
ai
"}
(41,1,1) = {"
ad
ad
ad
ai
ai
ai
af
ai
ai
ai
ai
ai
al
ai
ai
ax
ai
af
ai
ai
ai
ai
ai
ai
af
ai
ai
ai
ai
ai
ai
ai
ai
ai
ai
ai
ai
ai
ai
ai
ai
ai
"}
(42,1,1) = {"
ad
ad
ad
ai
ai
ai
ai
ai
ai
ai
af
ai
al
ai
ai
ai
ai
ai
ai
ai
af
ai
ai
ai
ai
ai
ai
ai
ai
ai
ai
am
ai
af
ai
ai
ai
ai
af
am
ai
ai
"}
(43,1,1) = {"
ad
ad
ai
ai
ai
am
ai
ai
ai
af
ai
ai
al
ai
ai
af
am
ai
ai
ai
ai
ai
ai
am
ai
ai
ai
ai
ai
ai
af
ai
ai
ai
ai
ai
ai
ai
ai
ai
af
ai
"}
(44,1,1) = {"
ad
ad
ai
ai
af
ai
ai
ai
ai
ai
ai
ai
al
ai
ai
ai
ai
ai
af
ai
ai
ai
ai
ai
ai
ai
ai
ai
ai
ai
ai
ai
ai
ai
ai
ai
ai
ai
ai
ai
ai
ai
"}
(45,1,1) = {"
ad
ad
af
ai
ai
af
ai
ai
ai
ai
ai
ai
aw
ai
ai
ai
ai
ai
ai
ai
ai
ai
ai
af
ai
ai
ai
af
ai
ai
ai
ai
ai
ai
ai
ai
af
ai
ai
af
ai
ai
"}
(46,1,1) = {"
ai
ai
ai
ai
ai
ai
ai
ai
ai
af
ai
ai
al
ai
ai
ai
ai
ai
ai
ai
af
ai
ai
ai
ai
ai
ax
ai
ai
ai
af
ai
ai
ai
af
ai
ai
ai
ai
ai
ai
ai
"}
(47,1,1) = {"
ai
ai
ai
ai
ai
ai
am
ai
ai
ai
ai
ai
al
ai
af
ai
ae
ai
ai
ai
ai
ai
am
ai
ai
af
ai
ai
ai
ai
ai
ai
ai
ai
ai
ai
ai
ai
ai
af
ai
ai
"}
(48,1,1) = {"
am
ai
ai
ai
ai
am
ax
ai
ai
ai
af
ai
al
ai
ai
ai
ai
ai
ai
ak
ai
ai
ai
am
ai
ai
ai
ai
ai
ai
ai
am
ai
ai
ai
ai
ai
ai
ai
am
ai
ai
"}
(49,1,1) = {"
ai
ai
af
ai
ai
ai
ai
ai
ai
ai
ai
ai
al
ai
ai
ai
ai
ai
ai
ai
ai
ai
ai
ai
ai
ai
ai
af
ai
ai
ai
ai
ai
ai
af
ai
ai
ai
ai
ai
ai
ai
"}
(50,1,1) = {"
af
ai
ai
ai
ai
ai
ai
af
ai
ad
ad
ad
ad
ai
ai
af
ai
ai
ai
ai
ai
ai
af
ai
ai
ai
ai
ai
ai
ai
ai
af
ai
ai
ai
ai
af
ai
af
ai
af
ai
"}
(51,1,1) = {"
ai
ai
ai
ai
ai
af
ai
ai
ai
ad
ad
ad
ad
ad
ai
ai
ai
af
ai
ai
ai
ai
ai
ai
ai
af
ai
ai
ai
ai
ad
ad
ad
ai
ai
ai
ai
ai
ai
ai
ai
ai
"}
(52,1,1) = {"
ai
ap
ai
ai
ai
ai
ai
ad
ad
ad
ad
ad
ad
ad
ad
ad
ad
ad
ad
ad
ad
ad
ai
ai
ai
ai
ai
ai
ai
ad
ad
ad
ad
ad
ai
ai
ax
ai
ai
am
ai
ai
"}
(53,1,1) = {"
am
ai
ai
af
ad
ad
ad
ad
ad
ad
ad
ad
ad
ad
ad
ad
ad
ad
ad
ad
ad
ad
ad
ap
ai
ai
ai
ai
ad
ad
ad
ad
ad
ad
ap
ai
ai
af
ai
ai
ai
ai
"}
(54,1,1) = {"
ai
ai
ai
ai
ad
ad
ad
ad
ad
ad
ad
ad
ad
ad
ad
ad
ad
ad
ad
ad
ad
ad
ad
ad
al
al
al
al
an
ad
ad
ad
ad
ad
ad
ad
ai
ai
ai
ai
af
ai
"}
(55,1,1) = {"
ai
af
ai
ad
ad
ad
ad
ad
ad
ad
ad
ad
ad
ad
ad
ad
ad
ad
ad
ad
ad
ad
ad
ad
ai
ai
ai
ai
ai
ai
ad
ad
ad
ad
ad
ad
ad
ad
ad
ai
ai
ai
"}
(56,1,1) = {"
ai
ai
ai
ad
ad
ad
ad
ad
ad
ad
ad
ad
ad
ad
ad
ad
ad
ad
ad
ad
ad
ad
ad
ad
ai
ai
ai
ai
ai
ai
ad
ad
ad
ad
ad
ad
ad
ad
ad
ad
ad
ad
"}
(57,1,1) = {"
ai
ai
ai
ad
ad
ad
ad
ad
ad
ad
ad
ad
ad
ad
ad
ad
ad
ad
ad
ad
ad
ad
ad
ad
ai
ai
ai
ai
ai
ai
ad
ad
ad
ad
ad
ad
ad
ad
ad
ad
ad
ad
"}
(58,1,1) = {"
ai
ai
ai
ad
ad
ad
ad
ad
ad
ad
ad
ad
ad
ad
ad
ad
ad
ad
ad
ad
ad
ad
ad
ad
ai
ai
ai
ai
ai
ad
ad
ad
ad
ad
ad
ad
ad
ad
ad
ad
ad
ad
"}
(59,1,1) = {"
am
af
ad
ad
ad
ad
ad
ad
ad
ad
ad
ad
ad
ad
ad
ad
ad
ad
ad
ad
ad
ad
ad
ad
ad
ai
ai
ai
ad
ad
ad
ad
ad
ad
ad
ad
ad
ad
ad
ad
ad
ad
"}
(60,1,1) = {"
ad
ad
ad
ad
ad
ad
ad
ad
ad
ad
ad
ad
ad
ad
ad
ad
ad
ad
ad
ad
ad
ad
ad
ad
ad
ad
ad
ad
ad
ad
ad
ad
ad
ad
ad
ad
ad
ad
ad
ad
ad
ad
"}
(61,1,1) = {"
ad
ad
ad
ad
ad
ad
ad
ad
ad
ad
ad
ad
ad
ad
ad
ad
ad
ad
ad
ad
ad
ad
ad
ad
ad
ad
ad
ad
ad
ad
ad
ad
ad
ad
ad
ad
ad
ad
ad
ad
ad
ad
"}
(62,1,1) = {"
au
au
ad
ad
ad
ad
ad
ad
ad
ad
ad
ad
ad
ad
ad
ad
ad
ad
ad
ad
ad
ad
ad
ad
ad
ad
ad
ad
ad
ad
ad
ad
ad
ad
ad
ad
ad
ad
ad
ad
ad
ad
"}
(63,1,1) = {"
ad
au
au
ad
ad
ad
ad
ad
ad
ad
ad
ad
ad
ad
ad
ad
ad
ad
ad
ad
ad
ad
ad
ad
ad
ad
ad
ad
ad
ad
ad
ad
ad
ad
ad
ad
ad
ad
ad
ad
ad
ad
"}
(64,1,1) = {"
ad
ad
au
ad
ad
ad
ad
ad
ad
ad
ad
ad
ad
ad
ad
ad
ad
ad
ad
ad
ad
ad
ad
ad
ad
ad
ad
ad
ad
ad
ad
ad
ad
ad
ad
ad
ad
ad
ad
ad
ad
ad
"}
(65,1,1) = {"
ad
ad
au
ad
ad
ad
ad
ad
ad
ad
ad
ad
ad
ad
ad
ad
ad
ad
ad
ad
ad
ad
ad
ad
ad
ad
ad
ad
ad
ad
ad
ad
ad
ad
ad
ad
ad
ad
ad
ad
ad
ad
"}
(66,1,1) = {"
ai
ad
aZ
aZ
aZ
aZ
aZ
aZ
aZ
aZ
aZ
aZ
aZ
aZ
aZ
aZ
aZ
aZ
aZ
aZ
aZ
aZ
aZ
aZ
aZ
aZ
aZ
aZ
aZ
aZ
aZ
aZ
aZ
aZ
aZ
aZ
aZ
aZ
aZ
aZ
aZ
aZ
"}
