//MAP CONVERTED BY dmm2tgm.py THIS HEADER COMMENT PREVENTS RECONVERSION, DO NOT REMOVE
"a" = (
/turf/open/space/basic,
/area/space)
"c" = (
/obj/effect/landmark/xeno_resin_door,
/turf/open/floor/plating/ground/mars/random/cave,
/area/bigredv2/caves/southeast)
"d" = (
/obj/effect/landmark/weed_node,
/turf/open/floor/plating/ground/mars/random/cave/rock,
/area/bigredv2/caves/southeast/garbledradio)
"e" = (
/turf/open/floor/plating/ground/mars/random/cave/rock,
/area/bigredv2/caves/southeast)
"k" = (
/turf/open/floor/plating/ground/mars/random/cave,
/area/bigredv2/caves/east)
"l" = (
/obj/effect/landmark/weed_node,
/turf/open/floor/plating/ground/mars/random/cave,
/area/bigredv2/caves/southeast/garbledradio)
"p" = (
/turf/open/floor/plating/ground/mars/random/cave,
/area/bigredv2/caves/southeast/garbledradio)
"r" = (
/obj/effect/landmark/weed_node,
/turf/open/floor/plating/ground/mars/random/cave,
/area/bigredv2/caves/southeast)
"s" = (
/turf/closed/mineral/smooth/bigred/indestructible,
/area/space)
"t" = (
/obj/effect/ai_node,
/turf/open/floor/plating/ground/mars/random/cave,
/area/bigredv2/caves/southeast/garbledradio)
"v" = (
/turf/closed/mineral/smooth/bigred,
/area/bigredv2/caves/rock)
"w" = (
/obj/effect/landmark/weed_node,
/turf/open/floor/plating/ground/mars/random/cave/rock,
/area/bigredv2/caves/southeast)
"y" = (
/obj/effect/landmark/start/job/xenomorph,
/turf/open/floor/plating/ground/mars/random/cave,
/area/bigredv2/caves/southeast)
"B" = (
/turf/open/floor/plating/ground/mars/random/cave,
/area/bigredv2/caves/southeast)
"C" = (
/obj/effect/landmark/patrol_point/tgmc_13,
/turf/open/floor/plating/ground/mars/random/cave,
/area/bigredv2/caves/southeast)
"E" = (
/turf/open/floor/plating/ground/mars/random/cave/rock,
/area/bigredv2/caves/southeast/garbledradio)
"G" = (
/obj/effect/ai_node,
/turf/open/floor/plating/ground/mars/random/cave/rock,
/area/bigredv2/caves/southeast/garbledradio)
"H" = (
/obj/docking_port/stationary/crashmode,
/turf/closed/mineral/smooth/bigred,
/area/bigredv2/caves/rock)
"I" = (
/obj/effect/landmark/patrol_point/tgmc_11,
/turf/open/floor/plating/ground/mars/random/cave,
/area/bigredv2/caves/southeast)
"J" = (
/obj/machinery/miner/damaged/platinum,
/turf/open/floor/plating/ground/mars/random/cave,
/area/bigredv2/caves/southeast/garbledradio)
"K" = (
/obj/effect/landmark/start/job/xenomorph,
/obj/effect/landmark/weed_node,
/turf/open/floor/plating/ground/mars/random/cave,
/area/bigredv2/caves/southeast/garbledradio)
"L" = (
/obj/effect/landmark/patrol_point/tgmc_14,
/turf/open/floor/plating/ground/mars/random/cave,
/area/bigredv2/caves/southeast)
"M" = (
/obj/effect/landmark/weed_node,
/obj/effect/ai_node,
/turf/open/floor/plating/ground/mars/random/cave,
/area/bigredv2/caves/southeast)
"R" = (
/obj/effect/landmark/patrol_point/tgmc_12,
/turf/open/floor/plating/ground/mars/random/cave,
/area/bigredv2/caves/southeast)
"V" = (
/obj/machinery/miner/damaged/platinum,
/turf/open/floor/plating/ground/mars/random/cave,
/area/bigredv2/caves/southeast)
"W" = (
/obj/effect/ai_node,
/turf/open/floor/plating/ground/mars/random/cave/rock,
/area/bigredv2/caves/southeast)
"Y" = (
/obj/effect/landmark/weed_node,
/obj/effect/ai_node,
/turf/open/floor/plating/ground/mars/random/cave,
/area/bigredv2/caves/southeast/garbledradio)
"Z" = (
/obj/effect/ai_node,
/turf/open/floor/plating/ground/mars/random/cave,
/area/bigredv2/caves/southeast)

(1,1,1) = {"
v
v
v
v
v
v
v
v
v
v
v
v
v
v
v
v
t
p
p
p
p
Y
E
v
v
v
v
v
v
v
v
B
B
B
B
B
B
v
v
v
v
v
v
v
v
v
v
v
v
v
c
c
c
c
v
v
v
v
v
v
v
v
v
s
s
s
a
"}
(2,1,1) = {"
k
v
v
v
v
v
v
v
v
v
v
v
v
v
E
E
p
p
p
v
p
p
E
v
v
v
v
v
v
v
v
c
c
c
c
c
v
v
v
v
v
v
v
v
v
v
v
v
v
v
B
r
B
B
v
v
v
v
v
v
v
v
v
s
s
s
a
"}
(3,1,1) = {"
v
v
v
v
v
v
v
v
v
v
v
v
v
v
p
p
p
p
p
v
E
p
E
v
v
v
v
v
v
v
v
B
B
B
B
B
v
v
v
v
v
v
v
v
v
v
v
v
v
v
e
B
e
B
v
v
v
v
v
v
v
v
v
s
s
s
a
"}
(4,1,1) = {"
v
v
v
v
v
v
v
v
v
v
v
v
v
G
p
p
Y
p
v
v
v
p
E
v
v
v
v
v
v
v
v
r
B
y
B
r
v
v
v
v
v
v
v
v
v
v
v
v
v
v
B
B
B
B
v
v
v
v
v
v
v
v
v
s
s
s
a
"}
(5,1,1) = {"
v
v
v
v
v
v
v
v
v
v
v
v
v
p
l
E
p
p
v
v
v
p
E
v
v
v
v
v
v
v
v
B
B
Z
B
B
v
v
v
v
v
v
v
v
v
v
v
v
v
v
B
B
Z
r
v
v
v
v
v
v
v
v
v
s
s
s
a
"}
(6,1,1) = {"
v
v
v
v
v
v
v
v
v
v
v
E
E
p
p
E
p
p
v
v
v
p
E
v
v
v
v
v
v
v
v
B
B
B
e
B
v
v
H
v
v
v
v
v
v
v
v
v
v
v
B
r
B
B
v
v
v
v
v
v
v
v
v
s
s
s
a
"}
(7,1,1) = {"
v
v
v
v
v
v
v
v
v
v
v
p
p
p
E
p
p
v
v
v
v
p
E
v
v
v
v
v
v
v
v
e
B
r
B
B
v
v
v
v
v
v
v
v
v
v
v
v
v
Z
B
B
Z
B
v
v
v
v
v
v
v
v
v
s
s
s
a
"}
(8,1,1) = {"
v
v
v
v
v
v
v
v
v
v
v
p
p
Y
p
v
v
v
v
v
v
p
E
v
v
v
v
v
v
v
v
B
B
B
B
B
v
v
v
v
v
v
v
v
v
v
v
v
B
B
r
e
B
B
v
v
v
v
v
v
v
v
v
s
s
s
a
"}
(9,1,1) = {"
v
v
v
v
v
v
v
v
v
v
v
p
G
p
p
v
v
v
v
v
v
p
E
v
v
v
v
v
v
v
v
B
B
r
B
B
v
v
v
v
v
v
v
v
v
v
v
v
B
B
e
e
B
r
v
v
v
v
v
v
v
v
v
s
s
s
a
"}
(10,1,1) = {"
v
v
v
v
v
v
v
v
v
v
E
p
E
p
p
v
v
v
v
p
p
t
d
v
v
v
v
v
v
v
B
B
B
B
B
v
v
v
v
v
v
v
v
v
v
B
B
B
B
B
B
r
B
v
v
v
v
v
v
v
v
v
v
s
s
s
a
"}
(11,1,1) = {"
v
v
v
v
v
v
v
v
v
v
p
p
E
p
E
E
E
E
E
p
p
p
E
v
v
v
v
v
v
B
B
B
B
Z
B
v
v
v
v
v
v
v
B
e
B
B
B
w
B
B
B
B
B
v
v
v
v
v
v
v
v
v
v
s
s
s
a
"}
(12,1,1) = {"
H
v
v
v
v
v
v
v
v
v
p
K
p
E
p
p
p
p
E
p
l
p
p
p
v
v
v
B
Z
B
B
B
Z
B
B
v
v
v
v
v
B
B
Z
e
B
w
B
B
B
Z
v
v
v
v
v
v
v
v
v
v
v
v
v
s
s
s
a
"}
(13,1,1) = {"
v
v
v
v
v
v
v
v
v
v
p
p
p
p
p
l
t
p
l
p
p
p
p
p
B
B
B
B
B
B
B
B
r
B
B
v
v
e
B
B
B
r
B
B
B
B
e
B
B
v
v
v
v
v
v
v
v
v
v
v
v
v
v
s
s
s
a
"}
(14,1,1) = {"
E
p
v
v
v
v
v
v
v
E
p
p
p
p
p
t
p
p
p
p
p
G
p
l
p
B
B
B
M
B
B
Z
e
B
B
B
B
B
B
B
B
e
B
B
B
r
B
v
v
v
v
v
v
v
v
v
v
v
v
v
v
v
v
s
s
s
a
"}
(15,1,1) = {"
G
v
v
v
v
v
v
v
v
p
t
p
t
l
p
p
t
p
p
E
v
p
p
p
p
B
B
B
B
B
B
B
Z
B
B
e
r
Z
B
e
e
B
Z
v
v
v
v
v
v
v
v
v
v
v
v
v
v
v
v
v
v
v
v
s
s
s
a
"}
(16,1,1) = {"
E
v
v
v
v
v
v
E
E
p
E
p
p
p
p
p
p
p
p
v
v
v
v
p
r
B
B
B
B
B
B
B
B
B
B
B
B
B
B
r
B
v
v
v
v
v
v
v
v
v
v
v
v
v
v
v
v
v
v
v
v
v
v
s
s
s
a
"}
(17,1,1) = {"
p
v
v
v
v
v
v
p
p
p
E
p
p
p
v
v
v
v
v
v
v
v
v
v
v
v
B
B
B
B
B
B
B
B
B
B
v
v
v
v
v
v
v
v
v
v
v
v
v
v
v
v
v
v
v
v
v
v
v
v
v
v
v
s
s
s
a
"}
(18,1,1) = {"
p
v
v
v
v
v
v
E
p
E
p
p
p
v
v
v
v
v
v
v
v
v
v
v
v
v
B
B
B
B
r
B
B
B
B
B
v
v
v
v
v
v
v
v
v
v
v
v
v
v
v
v
v
v
v
v
v
v
v
v
v
v
v
s
s
s
a
"}
(19,1,1) = {"
p
v
v
v
v
v
p
p
p
E
p
v
v
v
v
v
v
v
v
v
v
v
v
v
v
B
B
B
Z
B
B
B
B
Z
B
B
v
v
v
v
v
v
v
v
v
v
v
v
v
v
v
v
v
v
v
v
v
v
v
v
v
v
v
s
s
s
a
"}
(20,1,1) = {"
p
v
v
p
p
p
t
p
p
p
t
v
v
v
v
v
v
v
v
B
B
B
B
B
B
B
B
B
B
B
r
B
B
e
B
B
v
v
v
v
v
v
v
v
v
v
v
v
v
v
v
v
v
v
v
v
v
v
v
v
v
v
v
s
s
s
a
"}
(21,1,1) = {"
p
p
p
p
p
p
p
p
E
p
v
v
v
v
v
v
v
v
v
B
Z
B
B
B
Z
B
r
B
Z
B
B
B
e
B
B
B
B
v
v
v
v
v
v
v
v
v
v
v
v
v
v
v
v
v
v
v
v
v
v
v
v
v
v
s
s
s
a
"}
(22,1,1) = {"
t
p
p
p
E
E
p
p
p
p
v
v
v
v
v
v
v
B
B
B
B
B
B
B
B
B
e
B
B
B
V
B
B
r
B
B
B
v
v
v
v
v
v
v
v
v
v
v
v
v
v
v
v
v
v
v
v
v
v
v
v
v
v
s
s
s
a
"}
(23,1,1) = {"
J
t
p
E
p
p
t
p
p
v
v
v
v
v
B
B
B
B
e
B
B
B
e
B
B
B
e
B
B
B
B
B
B
B
B
B
v
v
v
v
v
v
v
v
v
v
v
v
v
v
v
v
v
v
v
v
v
v
v
v
v
v
v
s
s
s
a
"}
(24,1,1) = {"
p
E
d
p
p
p
p
E
v
v
v
v
v
v
B
B
B
B
B
B
B
B
B
B
B
B
B
B
B
B
B
B
B
B
B
B
v
v
v
v
v
v
v
v
v
v
v
v
v
v
v
v
v
v
v
v
v
v
v
v
v
v
v
s
s
s
a
"}
(25,1,1) = {"
E
p
p
E
v
v
v
v
v
v
v
v
B
B
W
B
B
B
r
B
Z
B
B
B
Z
B
B
B
r
Z
B
B
B
B
B
B
v
v
v
v
v
v
v
v
v
v
v
v
v
v
v
v
v
v
v
v
v
v
v
v
v
v
v
s
s
s
a
"}
(26,1,1) = {"
p
p
p
E
v
v
v
v
v
v
v
v
r
B
B
B
B
B
B
B
B
B
r
e
v
B
B
B
Z
B
B
r
B
Z
B
v
v
v
v
v
v
v
v
v
v
v
v
v
v
v
v
v
v
v
v
v
v
v
v
v
v
v
v
s
s
s
a
"}
(27,1,1) = {"
v
v
v
v
v
v
v
v
v
v
B
Z
B
B
Z
B
B
r
B
B
B
B
B
v
v
v
B
B
B
B
B
B
B
B
B
v
v
v
v
v
v
v
v
v
v
v
v
v
v
v
v
v
v
v
v
v
v
v
v
v
v
v
v
s
s
s
a
"}
(28,1,1) = {"
v
v
v
v
v
v
v
v
v
B
B
e
B
B
B
B
B
B
B
B
B
B
B
v
v
v
B
B
B
e
B
B
B
B
v
v
v
v
v
v
v
v
v
v
v
v
v
v
v
v
v
v
v
v
v
v
v
v
v
v
v
v
v
s
s
s
a
"}
(29,1,1) = {"
v
v
v
v
v
v
v
v
v
B
B
B
B
e
B
B
B
r
B
B
v
v
v
v
v
v
B
B
B
B
B
B
B
v
v
v
v
v
v
v
v
v
v
v
v
v
v
v
v
v
v
v
v
v
v
v
v
v
v
v
v
v
v
s
s
s
a
"}
(30,1,1) = {"
v
v
v
v
v
v
v
v
v
B
B
r
r
B
B
B
B
B
B
B
v
v
v
v
v
v
v
v
B
B
B
B
v
v
v
v
v
v
v
v
v
v
v
v
v
v
v
v
v
v
v
v
v
v
v
v
v
v
v
v
v
v
v
s
s
s
a
"}
(31,1,1) = {"
v
v
v
v
v
v
v
Z
B
B
B
B
B
B
Z
e
B
v
v
v
v
v
v
v
v
v
v
v
v
B
B
v
v
v
v
v
v
v
v
v
v
v
v
v
v
v
v
v
v
v
v
v
v
v
v
v
v
v
v
v
v
v
v
s
s
s
a
"}
(32,1,1) = {"
B
B
v
v
v
v
v
C
B
B
e
B
e
B
B
B
B
v
v
v
v
v
v
v
v
v
v
v
v
v
v
v
v
v
v
v
v
v
v
v
v
v
v
v
v
v
v
v
v
v
v
v
v
v
v
v
v
v
v
v
v
v
v
s
s
s
a
"}
(33,1,1) = {"
Z
B
r
B
Z
v
v
B
B
B
B
B
B
B
B
v
v
v
v
v
v
v
v
v
v
v
v
v
v
v
v
v
v
v
v
v
v
v
v
v
v
v
v
v
v
v
v
v
v
v
v
v
v
v
v
v
v
v
v
v
v
v
v
s
s
s
a
"}
(34,1,1) = {"
B
B
B
B
B
B
B
B
B
B
B
B
B
B
v
v
v
v
v
v
v
v
v
v
v
v
v
v
v
v
v
v
v
v
v
v
v
v
v
v
v
v
v
v
v
v
v
v
v
v
v
v
v
v
v
v
v
v
v
v
v
v
v
s
s
s
a
"}
(35,1,1) = {"
B
B
B
B
B
e
B
B
e
r
B
B
B
v
v
v
v
v
v
v
v
v
v
v
v
v
v
v
v
v
v
v
v
v
v
v
v
v
v
v
v
v
v
v
v
v
v
v
v
v
v
v
v
v
v
v
v
v
v
v
v
v
v
s
s
s
a
"}
(36,1,1) = {"
B
B
B
B
B
B
B
B
B
B
B
B
v
v
v
v
v
v
v
v
v
v
v
v
v
v
v
v
v
v
v
v
v
v
v
v
v
v
v
v
v
v
v
v
v
v
v
v
v
v
v
v
v
v
v
v
v
v
v
v
v
v
v
s
s
s
a
"}
(37,1,1) = {"
Z
e
B
B
Z
r
B
Z
B
B
B
Z
v
v
v
v
v
v
v
v
v
v
v
v
v
v
v
v
v
v
v
v
v
v
v
v
v
v
v
v
v
v
v
v
v
v
v
v
v
v
v
v
v
v
v
v
v
v
v
v
v
v
v
s
s
s
a
"}
(38,1,1) = {"
v
v
B
B
B
B
B
B
B
B
B
B
B
B
v
v
v
v
v
v
v
v
v
v
v
v
v
v
v
v
v
v
v
v
v
v
v
v
v
v
v
v
v
v
v
v
v
v
v
v
v
v
v
v
v
v
v
v
v
v
v
v
v
s
s
s
a
"}
(39,1,1) = {"
v
v
B
B
B
e
B
Z
e
B
e
B
B
B
Z
B
Z
B
v
v
v
v
v
v
v
v
v
v
v
v
v
v
v
v
v
v
v
v
v
v
v
v
v
v
v
v
v
v
v
v
v
v
v
v
v
v
v
v
v
v
v
v
v
s
s
s
a
"}
(40,1,1) = {"
v
v
B
B
B
B
B
e
B
B
B
B
B
B
B
B
B
B
B
v
v
v
v
v
v
v
v
v
v
v
v
v
v
v
v
v
v
v
v
v
v
v
v
v
v
v
v
v
v
v
v
v
v
v
v
v
v
v
v
v
v
v
v
s
s
s
a
"}
(41,1,1) = {"
B
B
B
B
B
B
B
B
B
B
r
r
e
B
B
B
r
B
B
B
v
v
v
v
v
v
v
v
v
v
v
v
v
v
v
v
v
v
v
v
v
v
v
v
v
v
v
v
v
v
v
v
v
v
v
v
v
v
v
v
v
v
v
s
s
s
a
"}
(42,1,1) = {"
B
B
B
B
B
r
B
B
B
B
B
B
B
B
B
B
Z
r
B
B
Z
v
v
v
v
v
v
v
v
v
v
v
v
v
v
v
v
v
v
v
v
v
v
v
v
v
v
v
v
v
v
v
v
v
v
v
v
v
v
v
v
v
v
s
s
s
a
"}
(43,1,1) = {"
B
e
B
r
B
B
B
B
e
B
B
B
B
B
B
V
B
B
e
B
B
v
v
v
v
v
v
v
v
v
v
v
v
v
v
v
v
v
v
v
v
v
v
v
v
v
v
v
v
v
v
v
v
v
v
v
v
v
v
v
v
v
v
s
s
s
a
"}
(44,1,1) = {"
B
B
B
B
B
B
B
r
B
B
B
e
r
B
B
B
B
e
B
B
B
I
v
v
v
v
v
v
v
v
v
v
v
v
v
v
v
v
v
v
v
v
v
v
v
v
v
v
v
v
v
v
v
v
v
v
v
v
v
v
v
v
v
s
s
s
a
"}
(45,1,1) = {"
B
Z
B
B
B
B
e
Z
B
B
B
B
B
B
M
B
B
B
B
B
Z
B
v
v
v
v
v
v
v
v
v
v
v
v
v
v
s
s
s
s
s
s
s
s
s
s
s
s
s
s
s
s
s
s
s
s
s
s
s
s
s
s
s
s
s
s
a
"}
(46,1,1) = {"
B
B
B
B
e
B
B
B
B
v
B
B
B
B
B
B
B
B
B
r
e
B
v
v
v
v
v
v
v
v
v
v
v
v
v
v
s
s
s
s
s
s
s
s
s
s
s
s
s
s
s
s
s
s
s
s
s
s
s
s
s
s
s
s
s
s
a
"}
(47,1,1) = {"
B
B
r
B
B
B
B
B
L
v
v
v
R
B
B
B
e
B
r
B
B
B
v
v
v
v
v
v
v
v
v
v
v
v
v
v
s
s
s
s
s
s
s
s
s
s
s
s
s
s
s
s
s
s
s
s
s
s
s
s
s
s
s
s
s
s
a
"}
(48,1,1) = {"
B
B
B
B
B
B
B
v
v
v
v
v
v
v
v
B
Z
B
B
B
Z
B
v
v
v
v
v
v
v
v
v
v
v
v
v
v
s
s
s
s
s
s
s
s
s
s
s
s
s
s
s
s
s
s
s
s
s
s
s
s
s
s
s
s
s
s
a
"}
(49,1,1) = {"
B
Z
B
B
B
B
v
v
v
v
v
v
v
v
v
v
v
B
B
B
B
B
v
v
v
v
v
v
v
v
v
v
v
v
v
v
s
s
s
s
s
s
s
s
s
s
s
s
s
s
s
s
s
s
s
s
s
s
s
s
s
s
s
s
s
s
a
"}
(50,1,1) = {"
B
B
B
v
v
v
v
v
v
v
v
v
v
v
v
v
v
v
v
B
B
v
v
v
v
v
v
v
v
v
v
v
v
v
v
v
s
s
s
s
s
s
s
s
s
s
s
s
s
s
s
s
s
s
s
s
s
s
s
s
s
s
s
s
s
s
a
"}
(51,1,1) = {"
B
B
B
v
v
v
v
v
v
v
v
v
v
v
v
v
v
v
v
v
v
v
v
v
v
v
v
v
v
v
v
v
v
v
v
v
s
s
s
s
s
s
s
s
s
s
s
s
s
s
s
s
s
s
s
s
s
s
s
s
s
s
s
s
s
s
a
"}
(52,1,1) = {"
v
v
v
v
v
v
v
v
v
v
v
v
v
v
v
v
v
v
v
v
v
v
v
v
v
v
v
v
v
v
v
v
v
v
v
v
s
s
s
s
s
s
s
s
s
s
s
s
s
s
s
s
s
s
s
s
s
s
s
s
s
s
s
s
s
s
a
"}
(53,1,1) = {"
v
v
v
v
v
v
v
v
v
v
v
v
v
v
v
v
v
v
v
v
v
v
v
v
v
v
v
v
v
v
v
v
v
v
v
v
s
s
s
s
s
s
s
s
s
s
s
s
s
s
s
s
s
s
s
s
s
s
s
s
s
s
s
s
s
s
a
"}
(54,1,1) = {"
v
v
v
v
v
v
v
v
v
v
v
v
v
v
v
v
v
v
v
v
v
v
v
v
v
v
v
v
v
v
v
v
v
v
v
v
s
s
s
s
s
s
s
s
s
s
s
s
s
s
s
s
s
s
s
s
s
s
s
s
s
s
s
s
s
s
a
"}
(55,1,1) = {"
v
v
v
v
v
v
v
v
v
v
v
v
v
v
v
v
v
v
v
v
v
v
v
v
v
v
v
v
v
v
v
v
v
v
v
v
s
s
s
s
s
s
s
s
s
s
s
s
s
s
s
s
s
s
s
s
s
s
s
s
s
s
s
s
s
s
a
"}
(56,1,1) = {"
v
v
v
v
v
v
v
v
v
v
v
v
v
v
v
v
v
v
v
v
v
v
v
v
v
v
v
v
v
v
v
v
v
v
v
v
s
s
s
s
s
s
s
s
s
s
s
s
s
s
s
s
s
s
s
s
s
s
s
s
s
s
s
s
s
s
a
"}
(57,1,1) = {"
v
v
v
v
v
v
v
v
v
v
v
v
v
v
v
v
v
v
v
v
v
v
v
v
v
v
v
v
v
v
v
v
v
v
v
v
s
s
s
s
s
s
s
s
s
s
s
s
s
s
s
s
s
s
s
s
s
s
s
s
s
s
s
s
s
s
a
"}
(58,1,1) = {"
v
v
v
v
v
v
v
v
v
v
v
v
v
v
v
v
v
v
v
v
v
v
v
v
v
v
v
v
v
v
v
v
v
v
v
v
s
s
s
s
s
s
s
s
s
s
s
s
s
s
s
s
s
s
s
s
s
s
s
s
s
s
s
s
s
s
a
"}
(59,1,1) = {"
v
v
v
v
v
v
v
v
v
v
v
v
v
v
v
v
v
v
v
v
v
v
v
v
v
v
v
v
v
v
v
v
v
v
v
v
s
s
s
s
s
s
s
s
s
s
s
s
s
s
s
s
s
s
s
s
s
s
s
s
s
s
s
s
s
s
a
"}
(60,1,1) = {"
v
v
v
v
v
v
v
v
v
v
v
v
v
v
v
v
v
v
v
v
v
v
v
v
v
v
v
v
v
v
v
v
v
v
v
v
s
s
s
s
s
s
s
s
s
s
s
s
s
s
s
s
s
s
s
s
s
s
s
s
s
s
s
s
s
s
a
"}
(61,1,1) = {"
v
v
v
v
v
v
v
v
v
v
v
v
v
v
v
v
v
v
v
v
v
v
v
v
v
v
v
v
v
v
v
v
v
v
v
v
s
s
s
s
s
s
s
s
s
s
s
s
s
s
s
s
s
s
s
s
s
s
s
s
s
s
s
s
s
s
a
"}
(62,1,1) = {"
v
v
v
v
v
v
v
v
v
v
v
v
v
v
v
v
v
v
v
v
v
v
v
v
v
v
v
v
v
v
v
v
v
v
v
v
s
s
s
s
s
s
s
s
s
s
s
s
s
s
s
s
s
s
s
s
s
s
s
s
s
s
s
s
s
s
a
"}
(63,1,1) = {"
s
s
s
s
s
s
s
s
s
s
s
s
s
s
s
s
s
s
s
s
s
s
s
s
s
s
s
s
s
s
s
s
s
s
s
s
s
s
s
s
s
s
s
s
s
s
s
s
s
s
s
s
s
s
s
s
s
s
s
s
s
s
s
s
s
s
a
"}
(64,1,1) = {"
s
s
s
s
s
s
s
s
s
s
s
s
s
s
s
s
s
s
s
s
s
s
s
s
s
s
s
s
s
s
s
s
s
s
s
s
s
s
s
s
s
s
s
s
s
s
s
s
s
s
s
s
s
s
s
s
s
s
s
s
s
s
s
s
s
s
a
"}
(65,1,1) = {"
s
s
s
s
s
s
s
s
s
s
s
s
s
s
s
s
s
s
s
s
s
s
s
s
s
s
s
s
s
s
s
s
s
s
s
s
s
s
s
s
s
s
s
s
s
s
s
s
s
s
s
s
s
s
s
s
s
s
s
s
s
s
s
s
s
s
a
"}
(66,1,1) = {"
s
s
s
s
s
s
s
s
s
s
s
s
s
s
s
s
s
s
s
s
s
s
s
s
s
s
s
s
s
s
s
s
s
s
s
s
s
s
s
s
s
s
s
s
s
s
s
s
s
s
s
s
s
s
s
s
s
s
s
s
s
s
s
s
s
s
a
"}
(67,1,1) = {"
s
s
s
s
s
s
s
s
s
s
s
s
s
s
s
s
s
s
s
s
s
s
s
s
s
s
s
s
s
s
s
s
s
s
s
s
s
s
s
s
s
s
s
s
s
s
s
s
s
s
s
s
s
s
s
s
s
s
s
s
s
s
s
s
s
s
a
"}
(68,1,1) = {"
s
s
s
s
s
s
s
s
s
s
s
s
s
s
s
s
s
s
s
s
s
s
s
s
s
s
s
s
s
s
s
s
s
s
s
s
s
s
s
s
s
s
s
s
s
s
s
s
s
s
s
s
s
s
s
s
s
s
s
s
s
s
s
s
s
s
a
"}
(69,1,1) = {"
s
s
s
s
s
s
s
s
s
s
s
s
s
s
s
s
s
s
s
s
s
s
s
s
s
s
s
s
s
s
s
s
s
s
s
s
s
s
s
s
s
s
s
s
s
s
s
s
s
s
s
s
s
s
s
s
s
s
s
s
s
s
s
s
s
s
a
"}
(70,1,1) = {"
s
s
s
s
s
s
s
s
s
s
s
s
s
s
s
s
s
s
s
s
s
s
s
s
s
s
s
s
s
s
s
s
s
s
s
s
s
s
s
s
s
s
s
s
s
s
s
s
s
s
s
s
s
s
s
s
s
s
s
s
s
s
s
s
s
s
a
"}
(71,1,1) = {"
s
s
s
s
s
s
s
s
s
s
s
s
s
s
s
s
s
s
s
s
s
s
s
s
s
s
s
s
s
s
s
s
s
s
s
s
s
s
s
s
s
s
s
s
s
s
s
s
s
s
s
s
s
s
s
s
s
s
s
s
s
s
s
s
s
s
a
"}
