//MAP CONVERTED BY dmm2tgm.py THIS HEADER COMMENT PREVENTS RECONVERSION, DO NOT REMOVE
"a" = (
/turf/open/space/basic,
/area/space)
"g" = (
/atom/movable/effect/landmark/patrol_point{
	id = "TGMC_13";
	name = "TGMC exit point 13"
	},
/turf/open/floor/plating/ground/mars/random/cave,
/area/bigredv2/caves/southeast)
"h" = (
/turf/open/floor/plating/ground/mars/random/cave,
/area/bigredv2/caves/southeast)
"l" = (
/turf/closed/wall/indestructible/mineral,
/area/space)
"m" = (
/atom/movable/effect/landmark/lv624/fog_blocker/xeno_spawn,
/turf/closed/mineral/bigred,
/area/bigredv2/caves/rock)
"n" = (
/obj/docking_port/stationary/crashmode,
/turf/closed/mineral/bigred,
/area/bigredv2/caves/rock)
"p" = (
/obj/machinery/miner/damaged/platinum,
/turf/open/floor/plating/ground/mars/random/cave,
/area/bigredv2/caves/southeast)
"s" = (
/atom/movable/effect/landmark/lv624/fog_blocker/xeno_spawn,
/turf/open/floor/plating/ground/mars/random/cave,
/area/bigredv2/caves/southeast)
"v" = (
/atom/movable/effect/landmark/patrol_point{
	id = "TGMC_14";
	name = "TGMC exit point 14"
	},
/turf/open/floor/plating/ground/mars/random/cave,
/area/bigredv2/caves/southeast)
"w" = (
/atom/movable/effect/landmark/xeno_silo_spawn,
/turf/open/floor/plating/ground/mars/random/cave,
/area/bigredv2/caves/southeast)
"x" = (
/turf/open/floor/plating/ground/mars/random/cave/rock,
/area/bigredv2/caves/southeast)
"z" = (
/turf/closed/mineral/bigred,
/area/bigredv2/caves/rock)
"D" = (
/atom/movable/effect/landmark/xeno_resin_door,
/turf/open/floor/plating/ground/mars/random/cave,
/area/bigredv2/caves/southeast)
"F" = (
/turf/open/floor/plating/ground/mars/random/cave,
/area/bigredv2/caves/east)
"G" = (
/atom/movable/effect/landmark/weed_node,
/atom/movable/effect/ai_node,
/turf/open/floor/plating/ground/mars/random/cave,
/area/bigredv2/caves/southeast)
"H" = (
/atom/movable/effect/landmark/patrol_point{
	id = "TGMC_12";
	name = "TGMC exit point 12"
	},
/turf/open/floor/plating/ground/mars/random/cave,
/area/bigredv2/caves/southeast)
"K" = (
/atom/movable/effect/landmark/weed_node,
/turf/open/floor/plating/ground/mars/random/cave,
/area/bigredv2/caves/southeast)
"M" = (
/atom/movable/effect/landmark/patrol_point{
	id = "TGMC_11";
	name = "TGMC exit point 11"
	},
/turf/open/floor/plating/ground/mars/random/cave,
/area/bigredv2/caves/southeast)
"N" = (
/atom/movable/effect/landmark/xeno_resin_wall,
/turf/open/floor/plating/ground/mars/random/cave,
/area/bigredv2/caves/southeast)
"Q" = (
/atom/movable/effect/landmark/start/job/xenomorph,
/atom/movable/effect/landmark/weed_node,
/turf/open/floor/plating/ground/mars/random/cave,
/area/bigredv2/caves/southeast)
"U" = (
/atom/movable/effect/landmark/start/job/xenomorph,
/turf/open/floor/plating/ground/mars/random/cave,
/area/bigredv2/caves/southeast)
"V" = (
/atom/movable/effect/ai_node,
/turf/open/floor/plating/ground/mars/random/cave/rock,
/area/bigredv2/caves/southeast)
"W" = (
/atom/movable/effect/ai_node,
/turf/open/floor/plating/ground/mars/random/cave,
/area/bigredv2/caves/southeast)
"Y" = (
/atom/movable/effect/landmark/weed_node,
/turf/open/floor/plating/ground/mars/random/cave/rock,
/area/bigredv2/caves/southeast)

(1,1,1) = {"
z
z
z
z
z
z
z
z
z
z
z
z
z
z
z
z
h
h
h
h
h
K
x
z
z
z
z
z
z
z
z
h
h
h
h
h
h
z
z
z
z
z
z
z
z
z
z
z
z
z
D
D
D
D
z
z
z
z
z
z
z
z
z
z
l
l
a
"}
(2,1,1) = {"
F
z
z
z
z
z
z
z
z
z
z
z
z
z
x
x
h
h
h
z
h
h
x
z
z
z
z
z
z
z
z
D
D
D
D
D
z
z
z
z
z
z
z
z
z
z
z
z
z
z
h
K
h
h
z
z
z
z
z
z
z
z
z
z
z
l
a
"}
(3,1,1) = {"
z
z
z
z
z
z
z
z
z
z
z
z
z
z
h
h
h
h
h
z
x
h
x
z
z
z
z
z
z
z
z
h
h
h
h
h
z
z
z
z
z
z
z
z
z
z
z
z
z
z
h
h
h
h
z
z
z
z
z
z
z
z
z
z
z
l
a
"}
(4,1,1) = {"
z
z
z
z
z
z
z
z
z
z
z
z
z
V
h
h
G
h
z
z
z
h
x
z
z
z
z
z
z
z
z
h
h
U
h
h
z
z
z
z
z
z
z
z
z
z
z
z
z
z
h
h
h
h
z
z
z
z
z
z
z
z
z
z
z
l
a
"}
(5,1,1) = {"
z
z
z
z
z
z
z
z
z
z
z
z
z
h
K
x
h
h
z
z
z
h
Y
z
z
z
z
z
z
z
z
h
h
h
h
h
z
z
z
z
z
z
z
z
z
z
z
z
z
z
h
h
W
K
z
z
z
z
z
z
z
z
z
z
z
l
a
"}
(6,1,1) = {"
z
z
z
z
z
z
z
z
z
z
z
x
x
h
h
x
h
h
z
z
z
h
x
h
z
z
z
z
z
z
z
h
h
h
h
h
z
z
n
z
z
z
z
z
z
z
z
z
z
z
h
K
h
h
z
z
z
z
z
z
z
z
z
z
z
l
a
"}
(7,1,1) = {"
z
z
z
z
z
z
z
z
z
z
z
h
h
h
x
h
h
z
z
z
z
h
x
h
D
h
h
h
z
z
z
h
h
K
h
h
z
z
z
z
z
z
z
z
z
z
z
z
z
z
h
h
h
h
z
z
z
z
z
z
z
z
z
z
z
l
a
"}
(8,1,1) = {"
z
z
z
z
z
z
z
z
z
z
z
h
h
G
h
z
z
z
z
z
z
h
x
h
D
h
h
h
h
h
z
h
h
h
h
h
z
z
z
z
z
z
z
z
z
z
z
z
z
z
h
h
h
h
z
z
z
z
z
z
z
z
z
z
z
l
a
"}
(9,1,1) = {"
z
z
z
z
z
z
z
z
z
z
z
h
V
h
h
z
z
z
z
z
z
h
x
h
D
h
h
K
h
h
h
h
h
K
h
h
z
z
z
z
z
z
z
z
z
z
z
z
z
z
h
h
h
h
z
z
z
z
z
z
z
z
z
z
z
l
a
"}
(10,1,1) = {"
z
z
z
z
z
z
z
z
z
z
x
h
x
h
h
z
z
z
z
h
h
W
Y
h
D
h
h
h
h
h
h
h
h
h
h
h
z
z
z
z
z
z
z
z
z
z
z
z
z
z
h
h
K
h
z
z
z
z
z
z
z
z
z
z
z
l
a
"}
(11,1,1) = {"
z
z
z
z
z
z
z
z
z
z
h
h
x
h
x
x
x
x
x
h
h
h
x
z
z
z
h
h
h
h
K
h
h
W
h
h
h
z
z
z
z
z
z
z
z
z
z
z
z
z
h
h
h
h
z
z
z
z
z
z
z
z
z
z
z
l
a
"}
(12,1,1) = {"
n
z
z
z
z
z
z
z
z
z
h
Q
h
x
h
h
h
h
x
h
K
h
z
z
z
z
z
z
z
h
h
h
W
h
h
h
h
z
z
z
z
z
z
z
z
z
z
z
z
z
h
K
h
z
z
z
z
z
z
z
z
z
z
z
z
l
a
"}
(13,1,1) = {"
z
z
z
z
z
z
z
z
z
z
K
h
h
h
h
K
W
h
K
h
h
h
z
z
z
z
z
z
z
h
h
h
K
h
h
h
h
z
z
z
z
z
z
z
z
z
z
z
z
h
h
h
h
z
z
z
z
z
z
z
z
z
z
z
z
l
a
"}
(14,1,1) = {"
x
h
z
z
z
z
z
z
z
x
h
h
h
h
h
h
h
h
h
h
h
z
z
z
z
z
z
z
z
h
h
h
h
h
h
h
h
h
h
z
z
z
z
z
z
z
z
z
z
h
h
h
W
z
z
z
z
z
z
z
z
z
z
z
z
l
a
"}
(15,1,1) = {"
x
z
z
z
z
z
z
z
z
h
W
h
W
K
h
h
W
h
h
x
z
z
z
z
z
z
z
z
z
h
h
K
h
h
h
h
K
h
h
h
h
z
z
z
z
z
z
z
h
h
h
W
h
z
z
z
z
z
z
z
z
z
z
z
z
l
a
"}
(16,1,1) = {"
x
z
z
z
z
z
z
x
x
h
x
h
h
h
h
h
h
h
h
h
z
z
z
z
z
z
z
z
z
h
h
h
h
h
h
h
h
h
h
h
h
h
h
h
h
z
z
z
h
h
h
h
h
z
z
z
z
z
z
z
z
z
z
z
z
l
a
"}
(17,1,1) = {"
h
z
z
z
z
z
z
h
h
h
x
K
h
h
z
z
z
z
z
z
z
z
z
z
z
z
z
h
h
h
h
h
h
h
h
K
h
h
h
h
h
h
h
h
h
h
h
h
h
K
h
h
z
z
z
z
z
z
z
z
z
z
z
z
z
l
a
"}
(18,1,1) = {"
h
z
z
z
z
z
z
x
h
x
h
h
h
z
z
z
z
z
z
z
z
z
z
z
z
z
z
h
h
h
K
h
h
h
h
K
h
h
h
h
h
K
h
K
h
h
h
h
h
h
h
h
z
z
z
z
z
z
z
z
z
z
z
z
z
l
l
"}
(19,1,1) = {"
h
z
z
z
z
z
h
h
K
x
h
z
z
z
z
z
z
z
z
z
z
z
z
z
z
h
h
h
W
h
h
h
h
W
h
h
h
h
h
h
h
h
W
h
h
h
h
p
h
W
h
W
z
z
z
z
z
z
z
z
z
z
z
z
z
z
l
"}
(20,1,1) = {"
h
z
z
h
h
h
W
h
h
h
W
z
z
z
z
z
z
z
z
z
z
z
z
z
z
h
h
h
h
h
K
h
h
h
h
h
h
h
h
K
h
h
h
h
h
h
K
h
h
h
h
h
z
z
z
z
z
z
z
z
z
z
z
z
z
z
l
"}
(21,1,1) = {"
h
h
h
h
h
h
h
h
x
h
z
z
z
z
z
z
z
m
m
m
m
m
m
m
m
s
K
h
W
h
h
h
h
h
h
h
h
h
h
h
h
h
h
h
K
h
h
h
h
h
h
z
z
z
z
z
z
z
z
z
z
z
z
z
z
z
l
"}
(22,1,1) = {"
h
h
h
h
x
x
h
h
h
h
z
z
z
z
z
z
z
m
z
z
z
h
h
K
N
s
h
h
h
h
p
h
h
K
h
h
h
z
z
z
z
h
h
h
h
h
h
h
h
h
z
z
z
z
z
z
z
z
z
z
z
z
z
z
z
z
l
"}
(23,1,1) = {"
p
W
h
x
h
h
W
h
h
z
z
z
z
z
z
z
z
m
z
z
h
h
K
h
N
s
h
h
h
h
h
h
h
h
h
h
z
z
z
z
z
z
z
z
z
z
z
z
z
z
z
z
z
z
z
z
z
z
z
z
z
z
z
z
z
z
l
"}
(24,1,1) = {"
h
x
Y
h
h
h
h
x
z
z
z
z
z
z
z
z
z
m
z
h
h
h
h
h
N
s
h
h
h
h
h
h
h
h
h
h
z
z
z
z
z
z
z
z
z
z
z
z
z
z
z
z
z
z
z
z
z
z
z
z
z
z
z
z
z
z
l
"}
(25,1,1) = {"
x
h
h
x
z
z
z
z
z
z
z
z
z
z
z
z
z
m
z
h
K
h
w
h
N
s
h
h
K
W
h
h
h
h
h
h
z
z
z
z
z
z
z
z
z
z
z
z
z
z
z
z
z
z
z
z
z
z
z
z
z
z
z
z
z
z
l
"}
(26,1,1) = {"
h
h
h
x
z
z
z
z
z
z
z
z
z
z
z
z
z
m
z
h
h
h
h
h
D
s
h
h
W
h
h
K
h
W
h
z
z
z
z
z
z
z
z
z
z
z
z
z
z
z
z
z
z
z
z
z
z
z
z
z
z
z
z
z
z
z
l
"}
(27,1,1) = {"
z
z
z
z
z
z
z
z
z
z
z
z
z
z
z
z
z
m
z
z
h
h
h
h
D
s
h
h
h
h
h
h
h
h
h
z
z
z
z
z
z
z
z
z
z
z
z
z
z
z
z
z
z
z
z
z
z
z
z
z
z
z
z
z
z
z
l
"}
(28,1,1) = {"
z
z
z
z
z
z
z
z
z
z
z
z
z
z
z
z
z
m
z
z
h
h
h
K
D
s
h
h
h
h
h
h
h
h
z
z
z
z
z
z
z
z
z
z
z
z
z
z
z
z
z
z
z
z
z
z
z
z
z
z
z
z
z
z
z
z
l
"}
(29,1,1) = {"
z
z
z
z
z
z
z
z
z
z
z
z
z
z
z
z
z
m
z
z
K
h
h
h
N
s
h
h
h
h
h
h
h
z
z
z
z
z
z
z
z
z
z
z
z
z
z
z
z
z
z
z
z
z
z
z
z
z
z
z
z
z
z
z
z
z
l
"}
(30,1,1) = {"
z
z
z
z
z
z
z
z
z
z
z
z
z
z
z
z
z
m
z
z
z
h
K
h
N
s
h
h
W
h
h
h
z
z
z
z
z
z
z
z
z
z
z
z
z
z
z
z
z
z
z
z
z
z
z
z
z
z
z
z
z
z
z
z
z
z
l
"}
(31,1,1) = {"
z
z
z
z
z
z
z
z
z
z
z
z
z
z
z
z
z
m
z
z
z
z
z
h
N
s
h
G
h
h
h
z
z
z
z
z
z
z
z
z
z
z
z
z
z
z
z
z
z
z
z
z
z
z
z
z
z
z
z
z
z
z
z
z
z
z
l
"}
(32,1,1) = {"
h
h
z
z
z
z
z
z
z
z
z
z
z
z
z
z
z
m
z
z
z
z
z
z
N
s
h
h
K
h
z
z
z
z
z
z
z
z
z
z
z
z
z
z
z
z
z
z
z
z
z
z
z
z
z
z
z
z
z
z
z
z
z
z
z
z
l
"}
(33,1,1) = {"
h
h
K
h
W
z
z
z
z
z
z
z
z
z
z
z
z
m
m
m
m
m
m
m
m
s
h
h
h
h
z
z
z
z
z
z
z
z
z
z
z
z
z
z
z
z
z
z
z
z
z
z
z
z
z
z
z
z
z
z
z
z
z
z
z
z
l
"}
(34,1,1) = {"
h
h
h
h
h
h
h
z
z
z
z
z
z
z
z
z
z
z
z
z
z
z
z
z
z
h
h
h
h
h
z
z
z
z
z
z
z
z
z
z
z
z
z
z
z
z
z
z
z
z
z
z
z
z
z
z
z
z
z
z
z
z
z
z
z
z
l
"}
(35,1,1) = {"
h
K
h
h
h
h
h
z
z
z
z
z
z
z
z
z
z
z
z
z
z
z
z
z
z
h
h
h
K
z
z
z
z
z
z
z
z
z
z
z
z
z
z
z
z
z
z
z
z
z
z
z
z
z
z
z
z
z
z
z
z
z
z
z
z
z
l
"}
(36,1,1) = {"
h
h
h
h
h
h
h
h
z
h
z
z
z
z
z
z
z
z
z
z
z
z
z
z
h
h
h
h
h
z
z
z
z
z
z
z
z
z
z
z
z
z
z
z
z
z
z
z
z
z
z
z
z
z
z
z
z
z
z
z
z
z
z
z
z
z
l
"}
(37,1,1) = {"
h
h
h
h
W
K
h
W
h
h
h
h
z
z
z
z
z
z
z
z
z
z
z
z
h
h
h
h
h
z
z
z
z
z
z
z
z
z
z
z
z
z
z
z
z
z
z
z
z
z
z
z
z
z
z
z
z
z
z
z
z
z
z
z
z
z
l
"}
(38,1,1) = {"
z
z
h
h
h
h
h
h
h
h
h
h
h
v
z
z
z
z
z
z
z
z
z
z
h
h
h
h
H
z
z
z
z
z
z
z
z
z
z
z
z
z
z
z
z
z
z
z
z
z
z
z
z
z
z
z
z
z
z
z
z
z
z
l
l
l
l
"}
(39,1,1) = {"
z
z
h
h
h
h
h
W
h
h
h
h
h
h
W
h
h
h
z
z
z
z
z
h
h
h
K
h
h
z
z
z
z
z
z
z
z
z
z
z
z
z
z
z
z
z
z
z
z
z
z
z
z
z
z
z
z
z
z
z
z
z
z
l
a
a
a
"}
(40,1,1) = {"
z
z
h
h
h
h
h
h
h
h
h
h
h
h
h
h
h
h
h
z
z
z
z
h
h
h
h
h
K
z
z
z
z
z
z
z
z
z
z
z
z
z
z
z
z
z
z
z
z
z
z
z
z
z
z
z
z
z
z
z
z
z
z
l
a
a
a
"}
(41,1,1) = {"
h
h
h
h
h
h
K
h
h
h
K
h
h
h
h
h
K
h
h
h
z
z
h
h
h
h
h
h
h
z
z
z
z
z
z
z
z
z
z
z
z
z
z
z
z
z
z
z
z
z
z
z
z
z
z
z
z
z
z
z
z
z
z
l
a
a
a
"}
(42,1,1) = {"
h
h
h
h
h
h
h
h
h
h
h
h
h
h
h
h
h
h
K
h
h
h
h
h
K
h
h
h
h
z
z
z
z
z
z
z
z
z
z
z
z
z
z
z
z
z
z
z
z
z
z
z
z
z
z
z
z
z
z
z
z
z
z
l
a
a
a
"}
(43,1,1) = {"
h
h
h
K
h
h
h
h
h
h
h
h
h
h
h
p
h
h
h
h
h
h
h
h
h
h
h
h
h
z
z
z
z
z
z
z
z
z
z
z
z
z
z
z
z
z
z
z
z
z
z
z
z
z
z
z
z
z
z
z
z
z
z
l
a
a
a
"}
(44,1,1) = {"
h
h
h
h
h
h
h
K
h
h
h
h
K
h
h
h
h
h
h
h
h
h
h
h
h
h
h
h
h
z
z
z
z
z
z
z
z
z
z
z
z
z
z
z
z
z
z
z
z
z
z
z
z
z
z
z
z
z
z
z
z
z
z
l
a
a
a
"}
(45,1,1) = {"
h
W
h
h
h
h
h
W
h
h
h
h
h
h
G
h
h
h
h
h
h
h
h
h
h
K
h
h
h
z
z
z
z
z
z
z
z
z
z
z
z
z
z
z
z
z
z
z
z
z
z
z
z
z
z
z
z
z
z
z
z
z
z
l
a
a
a
"}
(46,1,1) = {"
h
h
h
h
h
h
h
h
h
z
h
h
h
h
h
h
h
h
h
K
h
h
h
h
h
h
h
h
z
z
z
z
z
z
z
z
z
z
z
z
z
z
z
z
z
z
z
z
z
z
z
z
z
z
z
z
z
z
z
z
z
z
z
l
a
a
a
"}
(47,1,1) = {"
h
h
K
h
h
h
h
h
h
z
z
z
h
h
h
h
h
h
K
h
h
h
h
K
h
h
h
h
z
z
z
z
z
z
z
z
z
z
z
z
z
z
z
z
z
z
z
z
z
z
z
z
z
z
z
z
z
z
z
z
z
z
z
l
a
a
a
"}
(48,1,1) = {"
h
h
h
h
h
h
h
z
z
z
z
z
z
z
z
h
h
h
h
h
h
h
h
h
h
h
h
z
z
z
z
z
z
z
z
z
z
z
z
z
z
z
z
z
z
z
z
z
z
z
z
z
z
z
z
z
z
z
z
z
z
z
z
l
a
a
a
"}
(49,1,1) = {"
h
W
h
h
h
h
z
z
z
z
z
z
z
z
z
z
z
M
h
h
h
h
h
h
h
h
g
z
z
z
z
z
z
z
z
z
z
z
z
z
z
z
z
z
z
z
z
z
z
z
z
z
z
z
z
z
z
z
z
z
z
z
z
l
a
a
a
"}
(50,1,1) = {"
h
h
h
z
z
z
z
z
z
z
z
z
z
z
z
z
z
z
z
h
h
h
h
h
h
z
z
z
z
z
z
z
z
z
z
z
z
z
z
z
z
z
z
z
z
z
z
z
z
z
z
z
z
z
z
z
z
z
z
z
z
z
z
l
a
a
a
"}
(51,1,1) = {"
h
h
h
z
z
z
z
z
z
z
z
z
z
z
z
z
z
z
z
z
z
z
h
h
z
z
z
z
z
z
z
z
z
z
z
z
z
z
z
z
z
z
z
z
z
z
z
z
z
z
z
z
z
z
z
z
z
z
z
z
z
z
z
l
a
a
a
"}
(52,1,1) = {"
z
z
z
z
z
z
z
z
z
z
z
z
z
z
z
z
z
z
z
z
z
z
z
z
z
z
z
z
z
z
z
z
z
z
z
z
z
z
z
z
z
z
z
z
z
z
z
z
z
z
z
z
z
z
z
z
z
z
z
z
z
z
z
l
a
a
a
"}
(53,1,1) = {"
z
z
z
z
z
z
z
z
z
z
z
z
z
z
z
z
z
z
z
z
z
z
z
z
z
z
z
z
z
z
z
z
z
z
z
z
z
z
z
z
z
z
z
z
z
z
z
z
z
z
z
z
z
z
z
z
z
z
z
z
z
z
z
l
a
a
a
"}
(54,1,1) = {"
z
z
z
z
z
z
z
z
z
z
z
z
z
z
z
z
z
z
z
z
z
z
z
z
z
z
z
z
z
z
z
z
z
z
z
z
z
z
z
z
z
z
z
z
z
z
z
z
z
z
z
z
z
z
z
z
z
z
z
z
z
z
z
l
a
a
a
"}
(55,1,1) = {"
z
z
z
z
z
z
z
z
z
z
z
z
z
z
z
z
z
z
z
z
z
z
z
z
z
z
z
z
z
z
z
z
z
z
z
z
z
z
z
z
z
z
z
z
z
z
z
z
z
z
z
z
z
z
z
z
z
z
z
z
z
z
z
l
a
a
a
"}
(56,1,1) = {"
z
z
z
z
z
z
z
z
z
z
z
z
z
z
z
z
z
z
z
z
z
z
z
z
z
z
z
z
z
z
z
z
z
z
z
z
z
z
z
z
z
z
z
z
z
z
z
z
z
z
z
z
z
z
z
z
z
z
z
z
z
z
z
l
a
a
a
"}
(57,1,1) = {"
z
z
z
z
z
z
z
z
z
z
z
z
z
z
z
z
z
z
z
z
z
z
z
z
z
z
z
z
z
z
z
z
z
z
z
z
z
z
z
z
z
z
z
z
z
z
z
z
z
z
z
z
z
z
z
z
z
z
z
z
z
z
z
l
a
a
a
"}
(58,1,1) = {"
z
z
z
z
z
z
z
z
z
z
z
z
z
z
z
z
z
z
z
z
z
z
z
z
z
z
z
z
z
z
z
z
z
z
z
z
z
z
z
z
z
z
z
z
z
z
z
z
z
z
z
z
z
z
z
z
z
z
z
z
z
z
z
l
a
a
a
"}
(59,1,1) = {"
z
z
z
z
z
z
z
z
z
z
z
z
z
z
z
z
z
z
z
z
z
z
z
z
z
z
z
z
z
z
z
z
z
z
z
z
z
z
z
z
z
z
z
z
z
z
z
z
z
z
z
z
z
z
z
z
z
z
z
z
z
z
z
l
a
a
a
"}
(60,1,1) = {"
z
z
z
z
z
z
z
z
z
z
z
z
z
z
z
z
z
z
z
z
z
z
z
z
z
z
z
z
z
z
z
z
z
z
z
z
z
z
z
z
z
z
z
z
z
z
z
z
z
z
z
z
z
z
z
z
z
z
z
z
z
z
z
l
a
a
a
"}
(61,1,1) = {"
z
z
z
z
z
z
z
z
z
z
z
z
z
z
z
z
z
z
z
z
z
z
z
z
z
z
z
z
z
z
z
z
z
z
z
z
z
z
z
z
z
z
z
z
z
z
z
z
z
z
z
z
z
z
z
z
z
z
z
z
z
z
z
l
a
a
a
"}
(62,1,1) = {"
z
z
z
z
z
z
z
z
z
z
z
z
z
z
z
z
z
z
z
z
z
z
z
z
z
z
z
z
z
z
z
z
z
z
z
z
z
z
z
z
z
z
z
z
z
z
z
z
z
z
z
z
z
z
z
z
z
z
z
z
z
z
z
l
a
a
a
"}
(63,1,1) = {"
l
l
l
l
l
l
l
l
l
l
l
l
l
l
l
l
l
l
l
l
l
l
l
l
l
l
l
l
l
l
l
l
l
l
l
l
l
l
l
l
l
l
l
l
l
l
l
l
l
l
l
l
l
l
l
l
l
l
l
l
l
l
l
l
a
a
a
"}
(64,1,1) = {"
a
a
a
a
a
a
a
a
a
a
a
a
a
a
a
a
a
a
a
a
a
a
a
a
a
a
a
a
a
a
a
a
a
a
a
a
a
a
a
a
a
a
a
a
a
a
a
a
a
a
a
a
a
a
a
a
a
a
a
a
a
a
a
a
a
a
a
"}
(65,1,1) = {"
a
a
a
a
a
a
a
a
a
a
a
a
a
a
a
a
a
a
a
a
a
a
a
a
a
a
a
a
a
a
a
a
a
a
a
a
a
a
a
a
a
a
a
a
a
a
a
a
a
a
a
a
a
a
a
a
a
a
a
a
a
a
a
a
a
a
a
"}
(66,1,1) = {"
a
a
a
a
a
a
a
a
a
a
a
a
a
a
a
a
a
a
a
a
a
a
a
a
a
a
a
a
a
a
a
a
a
a
a
a
a
a
a
a
a
a
a
a
a
a
a
a
a
a
a
a
a
a
a
a
a
a
a
a
a
a
a
a
a
a
a
"}
(67,1,1) = {"
a
a
a
a
a
a
a
a
a
a
a
a
a
a
a
a
a
a
a
a
a
a
a
a
a
a
a
a
a
a
a
a
a
a
a
a
a
a
a
a
a
a
a
a
a
a
a
a
a
a
a
a
a
a
a
a
a
a
a
a
a
a
a
a
a
a
a
"}
(68,1,1) = {"
a
a
a
a
a
a
a
a
a
a
a
a
a
a
a
a
a
a
a
a
a
a
a
a
a
a
a
a
a
a
a
a
a
a
a
a
a
a
a
a
a
a
a
a
a
a
a
a
a
a
a
a
a
a
a
a
a
a
a
a
a
a
a
a
a
a
a
"}
(69,1,1) = {"
a
a
a
a
a
a
a
a
a
a
a
a
a
a
a
a
a
a
a
a
a
a
a
a
a
a
a
a
a
a
a
a
a
a
a
a
a
a
a
a
a
a
a
a
a
a
a
a
a
a
a
a
a
a
a
a
a
a
a
a
a
a
a
a
a
a
a
"}
(70,1,1) = {"
a
a
a
a
a
a
a
a
a
a
a
a
a
a
a
a
a
a
a
a
a
a
a
a
a
a
a
a
a
a
a
a
a
a
a
a
a
a
a
a
a
a
a
a
a
a
a
a
a
a
a
a
a
a
a
a
a
a
a
a
a
a
a
a
a
a
a
"}
(71,1,1) = {"
a
a
a
a
a
a
a
a
a
a
a
a
a
a
a
a
a
a
a
a
a
a
a
a
a
a
a
a
a
a
a
a
a
a
a
a
a
a
a
a
a
a
a
a
a
a
a
a
a
a
a
a
a
a
a
a
a
a
a
a
a
a
a
a
a
a
a
"}
