//MAP CONVERTED BY dmm2tgm.py THIS HEADER COMMENT PREVENTS RECONVERSION, DO NOT REMOVE
"v" = (
/atom/movable/effect/landmark/weed_node,
/turf/open/floor/plating/ground/mars/random/cave,
/area/bigredv2/caves/northeast)
"z" = (
/obj/structure/glowshroom,
/turf/open/floor/plating/ground/mars/random/cave,
/area/bigredv2/caves/northeast)
"B" = (
/turf/closed/mineral/smooth/bigred,
/area/bigredv2/caves/rock)
"G" = (
/atom/movable/effect/landmark/lv624/fog_blocker/xeno_spawn,
/turf/closed/mineral/smooth/bigred,
/area/bigredv2/caves/rock)
"O" = (
/turf/open/floor/plating/ground/mars/random/cave,
/area/bigredv2/caves/northeast)
"T" = (
/obj/structure/glowshroom,
/atom/movable/effect/landmark/weed_node,
/turf/open/floor/plating/ground/mars/random/cave,
/area/bigredv2/caves/northeast)

(1,1,1) = {"
O
v
O
v
O
O
B
B
B
B
B
B
B
B
B
"}
(2,1,1) = {"
B
O
O
O
B
B
B
B
B
B
B
B
B
B
B
"}
(3,1,1) = {"
B
O
v
O
O
B
B
B
B
B
B
B
B
B
O
"}
(4,1,1) = {"
B
O
O
O
T
O
O
O
B
B
B
B
B
O
O
"}
(5,1,1) = {"
B
B
O
O
O
O
O
O
O
B
B
B
B
O
v
"}
(6,1,1) = {"
B
B
B
O
O
v
O
v
z
O
B
B
O
O
O
"}
(7,1,1) = {"
B
B
B
B
O
O
O
O
O
O
O
B
O
v
O
"}
(8,1,1) = {"
B
B
B
B
B
O
v
O
v
O
v
O
O
O
O
"}
(9,1,1) = {"
B
B
z
z
B
O
z
O
O
z
O
O
v
O
O
"}
(10,1,1) = {"
B
z
O
O
z
O
O
B
B
B
B
B
O
v
v
"}
(11,1,1) = {"
B
z
v
O
v
O
O
B
B
B
B
B
B
O
O
"}
(12,1,1) = {"
B
z
O
T
O
z
O
z
B
B
B
B
B
B
O
"}
(13,1,1) = {"
B
B
z
z
z
O
T
O
B
B
B
B
B
B
B
"}
(14,1,1) = {"
B
B
B
B
z
z
B
B
B
B
B
B
B
B
B
"}
(15,1,1) = {"
G
G
G
G
G
G
G
G
G
G
G
G
G
G
G
"}
