//MAP CONVERTED BY dmm2tgm.py THIS HEADER COMMENT PREVENTS RECONVERSION, DO NOT REMOVE
"a" = (
/turf/open/space/basic,
/area/space)
"d" = (
/obj/effect/landmark/lv624/fog_blocker,
/turf/open/floor/plating/ground/mars/random/cave,
/area/bigredv2/caves/southwest)
"h" = (
/obj/effect/ai_node,
/turf/open/floor/plating/ground/mars/random/cave/rock,
/area/bigredv2/caves/southwest)
"j" = (
/obj/effect/landmark/weed_node,
/turf/open/floor/plating/ground/mars/random/cave/rock,
/area/bigredv2/caves/southwest)
"l" = (
/turf/closed/mineral/smooth/bigred,
/area/bigredv2/caves/rock)
"m" = (
/obj/effect/ai_node,
/turf/open/floor/plating/ground/mars/random/cave,
/area/bigredv2/caves/southwest)
"n" = (
/obj/effect/landmark/excavation_site_spawner,
/obj/effect/landmark/lv624/fog_blocker/xeno_spawn,
/turf/open/floor/plating/ground/mars/random/cave,
/area/bigredv2/caves/southwest)
"p" = (
/obj/effect/landmark/xeno_silo_spawn,
/turf/open/floor/plating/ground/mars/random/cave,
/area/bigredv2/caves/southwest)
"s" = (
/obj/effect/landmark/excavation_site_spawner,
/obj/effect/ai_node,
/turf/open/floor/plating/ground/mars/random/cave,
/area/bigredv2/caves/southwest)
"v" = (
/obj/effect/landmark/weed_node,
/obj/effect/landmark/weed_node,
/turf/open/floor/plating/ground/mars/random/cave,
/area/bigredv2/caves/southwest)
"w" = (
/obj/effect/landmark/lv624/fog_blocker/xeno_spawn,
/turf/open/floor/plating/ground/mars/random/cave/rock,
/area/bigredv2/caves/southwest)
"x" = (
/obj/effect/landmark/lv624/fog_blocker,
/turf/closed/mineral/smooth/bigred,
/area/bigredv2/caves/rock)
"y" = (
/turf/closed/mineral/smooth/bigred/indestructible,
/area/space)
"z" = (
/obj/effect/landmark/lv624/fog_blocker/xeno_spawn,
/turf/open/floor/plating/ground/mars/random/cave,
/area/bigredv2/caves/southwest)
"B" = (
/turf/open/floor/plating/ground/mars/random/cave,
/area/bigredv2/caves/southwest)
"D" = (
/obj/effect/landmark/excavation_site_spawner,
/turf/open/floor/plating/ground/mars/random/cave,
/area/bigredv2/caves/southwest)
"I" = (
/obj/effect/landmark/xeno_resin_door,
/turf/open/floor/plating/ground/mars/random/cave,
/area/bigredv2/caves/southwest)
"J" = (
/obj/effect/landmark/weed_node,
/obj/effect/landmark/lv624/fog_blocker/xeno_spawn,
/turf/open/floor/plating/ground/mars/random/cave,
/area/bigredv2/caves/southwest)
"K" = (
/obj/effect/landmark/weed_node,
/obj/effect/landmark/xeno_resin_wall,
/turf/open/floor/plating/ground/mars/random/cave,
/area/bigredv2/caves/southwest)
"Q" = (
/obj/effect/landmark/weed_node,
/turf/open/floor/plating/ground/mars/random/cave,
/area/bigredv2/caves/southwest)
"R" = (
/turf/open/floor/plating/ground/mars/random/cave/rock,
/area/bigredv2/caves/southwest)
"V" = (
/obj/effect/landmark/weed_node,
/obj/effect/ai_node,
/turf/open/floor/plating/ground/mars/random/cave,
/area/bigredv2/caves/southwest)
"W" = (
/obj/effect/landmark/lv624/fog_blocker/xeno_spawn,
/turf/closed/mineral/smooth/bigred,
/area/bigredv2/caves/rock)
"Y" = (
/obj/effect/landmark/xeno_resin_wall,
/turf/open/floor/plating/ground/mars/random/cave,
/area/bigredv2/caves/southwest)

(1,1,1) = {"
y
y
y
y
y
y
y
y
y
y
y
y
y
y
y
y
y
y
y
y
y
y
y
y
y
y
y
y
y
y
y
y
y
y
y
y
a
a
a
a
a
a
a
"}
(2,1,1) = {"
l
l
l
l
l
l
l
l
l
l
l
l
l
l
l
l
l
l
l
W
l
l
l
l
l
l
l
l
l
l
l
l
l
l
l
y
a
a
a
a
a
a
a
"}
(3,1,1) = {"
l
l
l
l
l
l
l
l
l
l
l
l
l
l
l
l
l
l
l
W
l
l
l
l
l
l
l
l
l
l
l
l
l
l
l
y
a
a
a
a
a
a
a
"}
(4,1,1) = {"
l
l
l
l
l
l
l
l
l
l
l
l
l
l
l
l
l
l
l
W
l
l
l
l
l
l
l
l
l
l
l
l
l
l
l
y
a
a
a
a
a
a
a
"}
(5,1,1) = {"
l
l
l
l
l
l
l
l
l
l
l
l
l
l
l
l
l
l
l
W
l
l
l
l
l
l
l
l
l
l
l
l
l
l
l
y
a
a
a
a
a
a
a
"}
(6,1,1) = {"
l
l
l
l
l
l
l
l
l
l
l
l
l
l
l
l
l
l
l
W
l
l
B
R
R
R
R
R
l
l
l
l
l
l
l
y
a
a
a
a
a
a
a
"}
(7,1,1) = {"
l
l
l
l
B
B
B
B
B
l
l
l
l
l
l
j
B
B
B
z
B
Y
B
B
B
B
B
B
R
l
l
l
l
l
l
y
a
a
a
a
a
a
a
"}
(8,1,1) = {"
l
l
B
B
B
Q
B
B
B
B
B
l
l
l
R
B
B
B
B
J
B
Y
B
B
Q
B
Q
B
R
l
l
l
l
l
l
y
a
a
a
a
a
a
a
"}
(9,1,1) = {"
l
B
B
B
B
B
B
B
B
B
B
B
B
B
B
B
B
B
B
z
B
Y
B
B
B
p
B
B
j
l
l
l
l
l
l
y
a
a
a
a
a
a
a
"}
(10,1,1) = {"
B
B
m
B
Q
Q
B
B
Q
B
Q
m
B
B
B
m
B
B
B
z
B
Y
B
B
Q
m
B
Q
B
R
l
l
l
l
l
y
a
a
a
a
a
a
a
"}
(11,1,1) = {"
Q
B
B
B
B
B
Q
B
B
B
B
B
B
B
B
B
B
B
Q
z
B
K
B
B
B
B
B
B
B
R
l
l
l
l
l
y
a
a
a
a
a
a
a
"}
(12,1,1) = {"
B
B
B
B
B
B
B
B
l
l
l
B
B
B
B
B
B
B
B
z
B
Y
B
B
B
B
B
B
B
B
B
B
l
l
l
y
a
a
a
a
a
a
a
"}
(13,1,1) = {"
B
B
l
l
l
l
l
l
l
l
l
B
B
B
B
Q
B
B
B
z
B
Y
Y
Y
Y
I
I
Y
Y
K
Y
Y
l
l
l
y
a
a
a
a
a
a
a
"}
(14,1,1) = {"
B
l
l
l
l
l
l
l
l
l
l
B
B
B
B
B
B
B
B
z
B
B
B
B
B
B
B
R
B
B
B
l
l
l
l
y
a
a
a
a
a
a
a
"}
(15,1,1) = {"
l
l
l
l
l
l
l
l
l
l
l
R
B
B
B
B
B
B
B
J
B
B
B
B
B
B
B
B
B
B
Q
l
l
l
l
y
a
a
a
a
a
a
a
"}
(16,1,1) = {"
l
l
l
l
l
l
l
l
l
l
l
l
B
B
B
m
Q
B
B
z
m
B
B
B
B
m
B
B
Q
B
B
l
l
l
l
y
a
a
a
a
a
a
a
"}
(17,1,1) = {"
l
l
l
l
l
l
l
l
l
l
l
l
B
B
B
B
B
B
B
n
z
z
z
z
z
z
z
w
z
z
z
W
W
W
W
y
a
a
a
a
a
a
a
"}
(18,1,1) = {"
l
l
l
l
l
l
l
l
l
l
l
l
B
B
Q
B
B
B
B
B
Q
B
B
v
B
B
B
B
B
B
l
l
l
l
l
y
a
a
a
a
a
a
a
"}
(19,1,1) = {"
l
l
l
l
l
l
l
l
l
l
l
l
B
B
B
B
B
B
B
B
B
Q
B
R
Q
B
B
B
l
l
l
l
l
l
l
y
a
a
a
a
a
a
a
"}
(20,1,1) = {"
l
l
l
l
l
l
l
l
l
l
B
R
B
B
B
B
B
B
B
B
B
B
B
R
B
B
B
l
l
l
l
l
l
l
l
y
a
a
a
a
a
a
a
"}
(21,1,1) = {"
l
l
l
l
l
l
l
l
l
B
B
R
B
B
B
Q
B
B
B
Q
B
B
R
B
B
Q
B
l
l
l
l
l
l
l
l
y
a
a
a
a
a
a
a
"}
(22,1,1) = {"
l
l
l
l
l
l
l
l
l
B
B
B
m
B
B
m
R
l
R
B
B
B
R
l
l
B
B
l
l
l
l
l
l
l
l
y
a
a
a
a
a
a
a
"}
(23,1,1) = {"
l
l
l
l
l
l
l
l
B
B
B
B
B
B
B
R
l
l
l
l
l
l
l
l
l
B
B
B
l
l
l
l
l
l
l
y
a
a
a
a
a
a
a
"}
(24,1,1) = {"
l
l
l
l
l
Q
B
B
R
B
B
R
B
Q
B
R
l
l
l
l
l
l
l
l
B
B
B
B
l
l
l
l
l
l
l
y
a
a
a
a
a
a
a
"}
(25,1,1) = {"
l
l
l
l
l
B
B
Q
B
B
j
B
B
B
B
l
l
l
l
l
l
l
l
l
B
V
B
B
l
l
l
l
l
l
l
y
a
a
a
a
a
a
a
"}
(26,1,1) = {"
l
l
l
l
m
B
B
B
B
B
B
Q
R
B
B
l
l
l
l
l
l
l
l
l
l
B
m
B
l
l
l
l
l
l
l
y
a
a
a
a
a
a
a
"}
(27,1,1) = {"
l
l
l
B
Q
m
B
B
B
B
B
B
m
B
B
l
l
l
l
l
l
l
l
l
l
B
B
Q
B
l
l
l
l
l
l
y
a
a
a
a
a
a
a
"}
(28,1,1) = {"
l
l
B
B
B
B
B
B
B
B
B
B
Q
B
R
l
l
l
l
l
l
l
l
l
l
l
B
B
B
l
l
l
l
l
l
y
a
a
a
a
a
a
a
"}
(29,1,1) = {"
l
l
B
B
B
B
B
Q
B
B
B
B
B
Q
B
l
l
l
l
l
l
l
l
l
l
l
B
Q
B
l
l
l
l
l
l
y
a
a
a
a
a
a
a
"}
(30,1,1) = {"
l
l
B
Q
B
B
B
B
Q
R
l
R
m
B
B
B
l
l
l
l
l
l
l
l
l
l
B
Q
B
B
l
l
l
l
l
y
a
a
a
a
a
a
a
"}
(31,1,1) = {"
l
B
B
B
B
B
B
B
B
R
l
l
R
m
Q
B
B
l
l
l
l
l
l
l
l
l
h
B
B
B
l
l
l
l
l
y
a
a
a
a
a
a
a
"}
(32,1,1) = {"
l
B
m
B
B
m
l
B
B
R
l
l
l
B
m
B
B
m
B
l
l
l
l
l
l
l
R
h
Q
B
l
l
l
l
l
y
a
a
a
a
a
a
a
"}
(33,1,1) = {"
l
B
B
B
l
l
l
R
R
l
l
l
l
B
B
B
Q
B
Q
B
R
l
l
l
l
l
l
R
m
B
B
l
l
l
l
y
a
a
a
a
a
a
a
"}
(34,1,1) = {"
l
B
B
B
l
l
l
l
l
l
l
l
l
l
B
B
B
B
B
B
B
R
l
l
l
l
l
l
B
B
B
B
l
l
l
y
a
a
a
a
a
a
a
"}
(35,1,1) = {"
l
B
B
l
l
l
l
l
l
l
l
l
l
B
B
B
B
B
B
B
R
l
l
l
l
l
l
l
B
B
B
l
l
l
l
y
a
a
a
a
a
a
a
"}
(36,1,1) = {"
l
B
B
l
l
l
l
l
l
l
l
l
l
R
B
B
B
B
Q
B
R
l
l
l
l
l
l
l
B
Q
B
l
l
l
l
y
a
a
a
a
a
a
a
"}
(37,1,1) = {"
B
B
B
l
l
l
l
l
l
l
l
l
l
l
l
l
B
s
B
B
B
h
l
l
l
l
l
l
B
D
B
l
l
l
l
y
a
a
a
a
a
a
a
"}
(38,1,1) = {"
B
B
B
l
l
l
l
l
l
l
l
l
l
l
l
l
B
B
B
B
B
R
l
l
l
l
R
j
B
Q
B
l
l
l
l
y
a
a
a
a
a
a
a
"}
(39,1,1) = {"
B
B
B
l
l
l
l
l
l
l
l
l
l
l
l
l
R
B
B
B
B
R
l
l
l
l
R
R
B
B
l
l
l
l
l
y
a
a
a
a
a
a
a
"}
(40,1,1) = {"
B
Q
B
l
l
l
l
l
l
l
l
l
l
l
l
l
l
l
l
Q
Q
B
R
R
l
l
l
l
B
B
l
l
l
l
l
y
a
a
a
a
a
a
a
"}
(41,1,1) = {"
d
d
d
x
x
x
x
x
x
x
x
x
x
x
l
l
l
l
l
B
B
B
B
R
l
l
l
l
B
Q
l
l
l
l
l
y
a
a
a
a
a
a
a
"}
