//MAP CONVERTED BY dmm2tgm.py THIS HEADER COMMENT PREVENTS RECONVERSION, DO NOT REMOVE
"b" = (
/obj/machinery/chem_dispenser,
/turf/open/floor/tile/whiteyellow{
	dir = 9
	},
/area/bigredv2/caves/lambda_lab)
"c" = (
/obj/machinery/miner/damaged/platinum,
/turf/open/floor/plating/ground/mars/random/cave,
/area/bigredv2/caves/northeast)
"h" = (
/turf/closed/wall/r_wall,
/area/bigredv2/caves/lambda_lab)
"i" = (
/obj/machinery/chem_master,
/turf/open/floor/tile/whiteyellow{
	dir = 5
	},
/area/bigredv2/caves/lambda_lab)
"j" = (
/turf/closed/mineral/smooth/bigred/indestructible,
/area/space)
"p" = (
/obj/structure/closet/crate/freezer/rations,
/turf/open/floor/plating,
/area/bigredv2/caves/lambda_lab)
"s" = (
/turf/closed/mineral/smooth/bigred,
/area/bigredv2/caves/rock)
"u" = (
/turf/closed/wall/r_wall,
/area/bigredv2/caves/rock)
"v" = (
/obj/effect/ai_node,
/turf/open/floor/plating/ground/mars/random/cave,
/area/bigredv2/caves/northeast)
"D" = (
/obj/effect/landmark/lv624/fog_blocker,
/turf/closed/mineral/smooth/bigred,
/area/bigredv2/caves/rock)
"E" = (
/turf/open/floor/plating/ground/mars/random/cave/rock,
/area/bigredv2/caves/northeast)
"F" = (
/obj/effect/landmark/xeno_resin_wall,
/turf/open/floor/plating/ground/mars/random/cave,
/area/bigredv2/caves/northeast)
"G" = (
/obj/effect/landmark/weed_node,
/turf/open/floor/plating/ground/mars/random/cave/rock,
/area/bigredv2/caves/northeast)
"I" = (
/obj/effect/ai_node,
/obj/effect/landmark/excavation_site_spawner,
/turf/open/floor/plating/ground/mars/random/cave,
/area/bigredv2/caves/northeast)
"J" = (
/obj/effect/landmark/lv624/fog_blocker,
/turf/open/floor/plating/ground/mars/random/cave,
/area/bigredv2/caves/northeast)
"M" = (
/obj/machinery/chem_dispenser,
/turf/open/floor/tile/whiteyellow{
	dir = 1
	},
/area/bigredv2/caves/lambda_lab)
"N" = (
/obj/effect/landmark/weed_node,
/turf/open/floor/plating/ground/mars/random/cave,
/area/bigredv2/caves/northeast)
"S" = (
/turf/open/space/basic,
/area/space)
"W" = (
/obj/structure/closet/crate/internals,
/turf/open/floor/plating,
/area/bigredv2/caves/lambda_lab)
"X" = (
/turf/open/floor/plating/ground/mars/random/cave,
/area/bigredv2/caves/northeast)
"Y" = (
/turf/open/floor/plating,
/area/bigredv2/caves/lambda_lab)

(1,1,1) = {"
S
S
S
S
S
S
S
S
S
j
j
j
j
j
j
s
s
s
s
s
s
s
s
s
s
X
X
X
X
E
s
s
"}
(2,1,1) = {"
S
S
S
S
S
S
S
S
S
j
s
s
s
s
s
s
s
s
s
s
s
s
s
E
E
N
X
X
X
E
s
s
"}
(3,1,1) = {"
S
S
S
S
S
S
S
S
S
j
s
s
s
s
s
s
s
s
s
s
s
s
X
X
X
X
X
X
X
E
s
s
"}
(4,1,1) = {"
S
S
S
S
S
S
S
S
S
j
s
s
s
s
s
s
s
s
s
s
s
X
X
X
X
X
X
X
X
X
E
s
"}
(5,1,1) = {"
S
S
S
S
S
S
S
S
S
j
s
s
s
s
s
s
s
s
s
s
X
X
v
X
v
X
X
N
X
v
E
s
"}
(6,1,1) = {"
S
S
S
S
S
S
S
S
S
j
s
s
s
s
s
s
s
v
X
X
X
v
X
G
X
X
X
X
X
X
E
s
"}
(7,1,1) = {"
S
S
S
S
S
S
S
S
S
j
s
s
s
s
s
s
X
X
X
X
X
X
X
s
s
E
X
X
X
X
E
s
"}
(8,1,1) = {"
S
S
S
S
S
S
S
S
S
j
s
s
s
s
s
s
X
X
X
s
X
X
s
s
s
s
X
X
X
X
N
E
"}
(9,1,1) = {"
S
S
S
S
S
S
S
S
S
j
s
s
s
s
s
s
X
v
X
s
s
s
s
s
s
s
G
X
X
X
X
X
"}
(10,1,1) = {"
S
S
S
S
S
S
S
S
S
j
s
s
s
s
s
X
v
X
X
s
s
s
s
s
s
s
s
E
X
v
X
X
"}
(11,1,1) = {"
S
S
S
S
S
S
S
S
S
j
s
s
s
s
X
X
X
X
X
s
s
s
s
s
s
s
s
s
s
X
v
X
"}
(12,1,1) = {"
S
S
S
S
S
S
S
S
S
j
s
s
s
s
X
X
X
X
X
s
s
s
s
s
s
s
s
s
s
E
X
v
"}
(13,1,1) = {"
S
S
S
S
S
S
S
S
S
j
s
s
s
X
X
X
X
X
s
s
s
s
s
s
s
s
s
s
s
s
s
s
"}
(14,1,1) = {"
S
S
S
S
S
S
S
S
S
j
s
s
v
X
X
X
v
s
s
s
s
s
s
s
s
s
s
s
s
s
s
s
"}
(15,1,1) = {"
S
S
S
S
S
S
S
S
S
j
s
s
X
X
X
s
s
s
s
s
s
s
s
s
s
s
s
u
u
u
u
u
"}
(16,1,1) = {"
S
S
S
S
S
S
S
S
S
j
s
s
X
X
X
s
s
s
s
s
s
s
s
s
s
s
s
u
s
F
F
F
"}
(17,1,1) = {"
S
S
S
S
S
S
S
S
S
j
s
X
X
X
s
s
s
s
s
s
s
s
s
s
s
s
s
u
s
X
X
X
"}
(18,1,1) = {"
S
S
S
S
S
S
S
S
S
j
s
X
v
X
s
s
s
s
s
s
s
s
s
s
s
s
s
u
s
X
X
v
"}
(19,1,1) = {"
S
S
S
S
S
S
S
S
S
j
s
v
X
X
X
s
s
s
s
s
s
s
s
s
s
s
s
s
s
X
X
X
"}
(20,1,1) = {"
S
S
S
S
S
S
S
S
S
j
s
s
X
X
X
X
X
s
s
s
s
s
s
s
s
s
s
s
s
X
X
X
"}
(21,1,1) = {"
S
S
S
S
S
S
S
S
S
j
s
s
X
X
X
X
X
X
X
s
s
s
s
s
s
s
s
s
s
s
X
X
"}
(22,1,1) = {"
S
S
S
S
S
S
S
S
S
j
s
s
v
X
X
X
v
X
X
s
s
s
s
s
s
s
s
s
s
s
X
X
"}
(23,1,1) = {"
S
S
S
S
S
S
S
S
S
j
s
s
s
X
X
X
X
X
X
s
s
s
s
s
s
s
s
s
s
s
X
v
"}
(24,1,1) = {"
S
S
S
S
S
S
S
S
S
j
s
s
s
s
X
X
X
X
X
X
s
s
s
s
s
s
s
s
s
s
N
X
"}
(25,1,1) = {"
S
S
S
S
S
S
S
S
S
j
s
s
s
s
X
X
X
s
X
X
s
s
s
s
s
s
s
s
s
s
s
X
"}
(26,1,1) = {"
S
S
S
S
S
S
S
S
S
j
s
s
s
X
X
X
X
s
X
X
X
s
s
s
s
s
s
s
s
s
s
s
"}
(27,1,1) = {"
S
S
S
S
S
S
S
S
S
j
s
s
X
X
X
X
X
X
X
X
X
s
s
s
s
s
s
s
s
s
s
s
"}
(28,1,1) = {"
S
S
S
S
S
S
S
S
S
j
s
s
v
X
X
X
v
X
X
X
X
s
s
s
s
s
s
s
s
s
s
D
"}
(29,1,1) = {"
S
S
S
S
S
S
S
S
S
j
s
s
X
X
X
s
X
v
X
X
v
s
s
s
s
s
s
s
s
s
D
s
"}
(30,1,1) = {"
S
S
S
S
S
S
S
S
S
j
s
s
X
X
s
s
s
X
X
X
s
s
s
s
s
s
s
s
s
D
s
s
"}
(31,1,1) = {"
S
S
S
S
S
S
S
S
S
j
s
s
X
X
s
s
s
X
X
X
s
s
s
s
s
s
s
s
s
D
s
h
"}
(32,1,1) = {"
S
S
S
S
S
S
S
S
S
j
s
s
X
X
s
s
s
X
X
X
s
s
s
s
s
s
s
s
s
D
s
h
"}
(33,1,1) = {"
S
S
S
S
S
S
S
S
S
j
s
X
X
X
s
s
s
X
X
X
s
s
s
s
s
s
s
s
s
D
s
h
"}
(34,1,1) = {"
S
S
S
S
S
S
S
S
S
j
s
X
X
X
s
s
X
X
X
X
X
s
s
s
s
s
s
s
s
D
s
h
"}
(35,1,1) = {"
S
S
S
S
S
S
S
S
S
j
s
X
X
X
X
X
X
X
X
X
X
s
s
s
s
s
s
s
s
D
s
h
"}
(36,1,1) = {"
S
S
S
S
S
S
S
S
S
j
s
s
v
X
X
X
X
v
X
X
X
X
s
s
s
s
s
s
s
D
s
s
"}
(37,1,1) = {"
S
S
S
S
S
S
S
S
S
j
s
s
s
s
X
X
X
X
X
X
X
X
X
s
s
s
s
s
s
D
s
s
"}
(38,1,1) = {"
S
S
S
S
S
S
S
S
S
j
s
s
s
s
s
s
s
v
X
X
X
X
X
v
X
s
s
s
s
D
s
s
"}
(39,1,1) = {"
S
S
S
S
S
S
S
S
S
j
s
s
s
s
s
s
s
s
s
s
s
X
X
X
X
X
X
s
s
D
h
h
"}
(40,1,1) = {"
S
S
S
S
S
S
S
S
S
j
j
j
j
j
j
j
j
j
j
j
s
X
X
X
X
X
N
X
s
D
h
Y
"}
(41,1,1) = {"
S
S
S
S
S
S
S
S
S
S
S
S
S
S
S
S
S
S
S
j
s
s
X
X
X
X
N
X
s
D
h
W
"}
(42,1,1) = {"
S
S
S
S
S
S
S
S
S
S
S
S
S
S
S
S
S
S
S
j
s
s
s
X
X
X
X
X
s
D
h
p
"}
(43,1,1) = {"
S
S
S
S
S
S
S
S
S
S
S
S
S
S
S
S
S
S
S
j
s
s
s
v
N
X
v
X
X
D
h
h
"}
(44,1,1) = {"
S
S
S
S
S
S
S
S
S
S
S
S
S
S
S
S
S
S
S
j
s
s
s
X
X
X
X
X
X
J
h
b
"}
(45,1,1) = {"
S
S
S
S
S
S
S
S
S
S
S
S
S
S
S
S
S
S
S
j
s
s
s
X
X
X
X
X
X
J
h
M
"}
(46,1,1) = {"
S
S
S
S
S
S
S
S
S
S
S
S
S
S
S
S
S
S
S
j
s
s
s
X
X
X
X
X
X
J
h
M
"}
(47,1,1) = {"
S
S
S
S
S
S
S
S
S
S
S
S
S
S
S
S
S
S
S
j
s
s
s
X
X
X
X
X
s
D
h
i
"}
(48,1,1) = {"
S
S
S
S
S
S
S
S
S
S
S
S
S
S
S
S
S
S
S
j
s
s
s
s
X
X
X
N
s
D
h
h
"}
(49,1,1) = {"
S
S
S
S
S
S
S
S
S
S
S
S
S
S
S
S
S
S
S
j
s
s
s
s
X
X
X
X
s
s
D
h
"}
(50,1,1) = {"
S
S
S
S
S
S
S
S
S
S
S
S
S
S
S
S
S
S
S
j
s
s
s
s
X
X
X
X
X
X
s
D
"}
(51,1,1) = {"
S
S
S
S
S
S
S
S
S
S
S
S
S
S
S
S
S
S
S
j
s
s
s
s
s
X
X
I
X
X
X
E
"}
(52,1,1) = {"
S
S
S
S
S
S
S
S
S
S
S
S
S
S
S
S
S
S
S
j
s
s
s
s
s
X
v
X
X
X
v
X
"}
(53,1,1) = {"
S
S
S
S
S
S
S
S
S
S
S
S
S
S
S
S
S
S
S
j
s
s
s
s
s
s
X
X
N
X
X
X
"}
(54,1,1) = {"
S
S
S
S
S
S
S
S
S
S
S
S
S
S
S
S
S
S
S
j
s
s
s
s
s
s
X
X
X
X
X
X
"}
(55,1,1) = {"
S
S
S
S
S
S
S
S
S
S
S
S
S
S
S
S
S
S
S
j
s
s
s
s
s
s
s
X
c
X
X
X
"}
(56,1,1) = {"
S
S
S
S
S
S
S
S
S
S
S
S
S
S
S
S
S
S
S
j
s
s
s
s
s
s
s
X
X
X
N
X
"}
(57,1,1) = {"
S
S
S
S
S
S
S
S
S
S
S
S
S
S
S
S
S
S
S
j
s
s
s
s
s
s
s
X
X
X
X
X
"}
(58,1,1) = {"
S
S
S
S
S
S
S
S
S
S
S
S
S
S
S
S
S
S
S
j
s
s
s
s
s
s
s
X
X
X
v
X
"}
(59,1,1) = {"
S
S
S
S
S
S
S
S
S
S
S
S
S
S
S
S
S
S
S
j
s
s
s
s
s
s
s
X
X
X
X
X
"}
(60,1,1) = {"
S
S
S
S
S
S
S
S
S
S
S
S
S
S
S
S
S
S
S
j
s
s
s
s
s
s
s
s
X
X
v
X
"}
(61,1,1) = {"
S
S
S
S
S
S
S
S
S
S
S
S
S
S
S
S
S
S
S
j
s
s
s
s
s
s
s
s
s
X
N
X
"}
(62,1,1) = {"
S
S
S
S
S
S
S
S
S
S
S
S
S
S
S
S
S
S
S
j
s
s
s
s
s
s
s
s
s
X
X
X
"}
(63,1,1) = {"
S
S
S
S
S
S
S
S
S
S
S
S
S
S
S
S
S
S
S
j
s
s
s
s
s
s
s
s
s
X
X
X
"}
(64,1,1) = {"
S
S
S
S
S
S
S
S
S
S
S
S
S
S
S
S
S
S
S
j
s
s
s
s
s
s
s
s
s
X
X
X
"}
(65,1,1) = {"
S
S
S
S
S
S
S
S
S
S
S
S
S
S
S
S
S
S
S
j
s
s
s
s
s
s
s
s
s
X
N
X
"}
