//MAP CONVERTED BY dmm2tgm.py THIS HEADER COMMENT PREVENTS RECONVERSION, DO NOT REMOVE
"d" = (
/turf/closed/wall/r_wall,
/area/bigredv2/caves/rock)
"e" = (
/atom/movable/effect/landmark/lv624/fog_blocker,
/turf/open/floor/plating/ground/mars/random/cave,
/area/bigredv2/caves/northeast)
"g" = (
/obj/machinery/miner/damaged/platinum,
/turf/open/floor/plating/ground/mars/random/cave,
/area/bigredv2/caves/northeast)
"h" = (
/turf/closed/wall/r_wall,
/area/bigredv2/caves/lambda_lab)
"k" = (
/turf/open/floor/plating,
/area/bigredv2/caves/lambda_lab)
"l" = (
/obj/machinery/chem_dispenser,
/turf/open/floor/tile/whiteyellow{
	dir = 9
	},
/area/bigredv2/caves/lambda_lab)
"r" = (
/turf/closed/mineral/smooth/bigred/indestructible,
/area/space)
"t" = (
/atom/movable/effect/landmark/xeno_resin_wall,
/turf/open/floor/plating/ground/mars/random/cave,
/area/bigredv2/caves/northeast)
"v" = (
/atom/movable/effect/ai_node,
/turf/open/floor/plating/ground/mars/random/cave,
/area/bigredv2/caves/northeast)
"x" = (
/turf/open/floor/plating/ground/mars/random/cave,
/area/bigredv2/caves/northeast)
"y" = (
/turf/open/floor/plating/ground/mars/random/cave/rock,
/area/bigredv2/caves/northeast)
"z" = (
/atom/movable/effect/landmark/weed_node,
/turf/open/floor/plating/ground/mars/random/cave/rock,
/area/bigredv2/caves/northeast)
"C" = (
/obj/machinery/chem_dispenser,
/turf/open/floor/tile/whiteyellow{
	dir = 1
	},
/area/bigredv2/caves/lambda_lab)
"E" = (
/atom/movable/effect/ai_node,
/atom/movable/effect/landmark/excavation_site_spawner,
/turf/open/floor/plating/ground/mars/random/cave,
/area/bigredv2/caves/northeast)
"F" = (
/atom/movable/effect/landmark/weed_node,
/turf/open/floor/plating/ground/mars/random/cave,
/area/bigredv2/caves/northeast)
"G" = (
/obj/machinery/chem_master,
/turf/open/floor/tile/whiteyellow{
	dir = 5
	},
/area/bigredv2/caves/lambda_lab)
"H" = (
/atom/movable/effect/landmark/weed_node,
/atom/movable/effect/ai_node,
/turf/open/floor/plating/ground/mars/random/cave,
/area/bigredv2/caves/northeast)
"I" = (
/atom/movable/effect/landmark/lv624/fog_blocker,
/turf/closed/mineral/smooth/bigred,
/area/bigredv2/caves/rock)
"M" = (
/turf/closed/mineral/smooth/bigred,
/area/bigredv2/caves/rock)
"N" = (
/obj/structure/closet/crate/internals,
/turf/open/floor/plating,
/area/bigredv2/caves/lambda_lab)
"V" = (
/atom/movable/effect/landmark/lv624/fog_blocker,
/atom/movable/effect/ai_node,
/turf/open/floor/plating/ground/mars/random/cave,
/area/bigredv2/caves/northeast)
"W" = (
/turf/open/space/basic,
/area/space)
"X" = (
/atom/movable/effect/landmark/excavation_site_spawner,
/turf/open/floor/plating/ground/mars/random/cave,
/area/bigredv2/caves/northeast)
"Y" = (
/obj/structure/closet/crate/freezer/rations,
/turf/open/floor/plating,
/area/bigredv2/caves/lambda_lab)

(1,1,1) = {"
W
W
W
W
W
W
W
W
W
W
W
W
W
W
r
r
r
r
r
r
M
M
M
M
M
x
x
x
x
y
M
M
"}
(2,1,1) = {"
W
W
W
W
W
W
W
W
W
W
W
W
W
W
W
W
W
W
W
r
M
M
M
y
y
F
x
x
x
y
M
M
"}
(3,1,1) = {"
W
W
W
W
W
W
W
W
W
W
W
W
W
W
W
W
W
W
W
r
M
M
M
x
x
x
x
x
x
y
M
M
"}
(4,1,1) = {"
W
W
W
W
W
W
W
W
W
W
W
W
W
W
W
W
W
W
W
r
M
M
M
x
x
x
x
x
x
x
y
M
"}
(5,1,1) = {"
W
W
W
W
W
W
W
W
W
W
W
W
W
W
W
W
W
W
W
r
M
M
M
x
v
x
x
F
x
v
y
M
"}
(6,1,1) = {"
W
W
W
W
W
W
W
W
W
W
W
W
W
W
W
W
W
W
W
r
M
M
M
z
x
x
x
x
x
x
y
M
"}
(7,1,1) = {"
W
W
W
W
W
W
W
W
W
W
W
W
W
W
W
W
W
W
W
r
M
M
M
M
M
y
x
x
x
x
y
M
"}
(8,1,1) = {"
W
W
W
W
W
W
W
W
W
W
W
W
W
W
W
W
W
W
W
r
M
M
M
M
M
M
x
x
x
x
F
y
"}
(9,1,1) = {"
W
W
W
W
W
W
W
W
W
W
W
W
W
W
W
W
W
W
W
r
M
M
M
M
M
M
z
x
x
x
x
x
"}
(10,1,1) = {"
W
W
W
W
W
W
W
W
W
W
W
W
W
W
W
W
W
W
W
r
M
M
M
M
M
M
M
y
x
v
x
x
"}
(11,1,1) = {"
W
W
W
W
W
W
W
W
W
W
W
W
W
W
W
W
W
W
W
r
M
M
M
M
M
M
M
M
M
x
v
x
"}
(12,1,1) = {"
W
W
W
W
W
W
W
W
W
W
W
W
W
W
W
W
W
W
W
r
M
M
M
M
M
M
M
M
M
y
x
v
"}
(13,1,1) = {"
W
W
W
W
W
W
W
W
W
W
W
W
W
W
W
W
W
W
W
r
M
M
M
M
M
M
M
M
M
M
M
M
"}
(14,1,1) = {"
W
W
W
W
W
W
W
W
W
W
W
W
W
W
W
W
W
W
W
r
M
M
M
M
M
M
M
M
M
M
M
M
"}
(15,1,1) = {"
W
W
W
W
W
W
W
W
W
W
W
W
W
W
W
W
W
W
W
r
M
M
M
M
M
M
M
d
d
d
d
d
"}
(16,1,1) = {"
W
W
W
W
W
W
W
W
W
W
W
W
W
W
W
W
W
W
W
r
M
M
M
M
M
M
M
d
t
t
t
t
"}
(17,1,1) = {"
W
W
W
W
W
W
W
W
W
W
W
W
W
W
W
W
W
W
W
r
M
M
M
M
M
M
M
d
t
x
x
x
"}
(18,1,1) = {"
W
W
W
W
W
W
W
W
W
W
W
W
W
W
W
W
W
W
W
r
M
M
M
M
M
M
M
d
t
x
x
v
"}
(19,1,1) = {"
W
W
W
W
W
W
W
W
W
W
W
W
W
W
W
W
W
W
W
r
M
M
M
M
M
M
M
t
t
x
x
x
"}
(20,1,1) = {"
W
W
W
W
W
W
W
W
W
W
W
W
W
W
W
W
W
W
W
r
M
M
M
M
M
M
X
x
x
x
x
x
"}
(21,1,1) = {"
W
W
W
W
W
W
W
W
W
W
W
W
W
W
W
W
W
W
W
r
M
M
M
M
M
M
x
x
x
F
x
x
"}
(22,1,1) = {"
W
W
W
W
W
W
W
W
W
W
W
W
W
W
W
W
W
W
W
r
M
M
M
M
M
x
x
x
x
x
x
x
"}
(23,1,1) = {"
W
W
W
W
W
W
W
W
W
W
W
W
W
W
W
W
W
W
W
r
M
M
M
M
M
x
v
x
x
x
x
v
"}
(24,1,1) = {"
W
W
W
W
W
W
W
W
W
W
W
W
W
W
W
W
W
W
W
r
M
M
M
M
x
x
x
x
x
x
F
x
"}
(25,1,1) = {"
W
W
W
W
W
W
W
W
W
W
W
W
W
W
W
W
W
W
W
r
M
M
M
x
x
x
x
x
x
x
x
x
"}
(26,1,1) = {"
W
W
W
W
W
W
W
W
W
W
W
W
W
W
W
W
W
W
W
r
M
M
M
x
F
x
x
x
x
x
x
M
"}
(27,1,1) = {"
W
W
W
W
W
W
W
W
W
W
W
W
W
W
W
W
W
W
W
r
M
M
x
x
x
x
x
x
x
x
M
M
"}
(28,1,1) = {"
W
W
W
W
W
W
W
W
W
W
W
W
W
W
W
W
W
W
W
r
M
M
v
x
x
x
H
x
x
x
M
I
"}
(29,1,1) = {"
W
W
W
W
W
W
W
W
W
W
W
W
W
W
W
W
W
W
W
r
M
M
x
x
x
x
x
x
x
M
I
M
"}
(30,1,1) = {"
W
W
W
W
W
W
W
W
W
W
W
W
W
W
W
W
W
W
W
r
M
M
M
x
x
x
x
x
M
I
M
M
"}
(31,1,1) = {"
W
W
W
W
W
W
W
W
W
W
W
W
W
W
W
W
W
W
W
r
M
M
M
x
x
x
x
x
M
I
M
h
"}
(32,1,1) = {"
W
W
W
W
W
W
W
W
W
W
W
W
W
W
W
W
W
W
W
r
M
M
M
x
x
x
x
x
M
I
M
h
"}
(33,1,1) = {"
W
W
W
W
W
W
W
W
W
W
W
W
W
W
W
W
W
W
W
r
M
M
M
x
x
x
H
x
M
I
M
h
"}
(34,1,1) = {"
W
W
W
W
W
W
W
W
W
W
W
W
W
W
W
W
W
W
W
r
M
M
M
x
x
x
x
x
M
I
M
h
"}
(35,1,1) = {"
W
W
W
W
W
W
W
W
W
W
W
W
W
W
W
W
W
W
W
r
M
M
M
x
x
x
x
x
M
I
M
h
"}
(36,1,1) = {"
W
W
W
W
W
W
W
W
W
W
W
W
W
W
W
W
W
W
W
r
M
M
M
x
x
F
x
x
M
I
M
M
"}
(37,1,1) = {"
W
W
W
W
W
W
W
W
W
W
W
W
W
W
W
W
W
W
W
r
M
M
M
x
x
x
x
x
M
I
M
M
"}
(38,1,1) = {"
W
W
W
W
W
W
W
W
W
W
W
W
W
W
W
W
W
W
W
r
M
M
M
x
x
x
x
x
M
I
M
M
"}
(39,1,1) = {"
W
W
W
W
W
W
W
W
W
W
W
W
W
W
W
W
W
W
W
r
M
M
M
x
x
x
x
x
x
I
h
h
"}
(40,1,1) = {"
W
W
W
W
W
W
W
W
W
W
W
W
W
W
W
W
W
W
W
r
M
M
M
x
x
x
F
x
x
e
h
k
"}
(41,1,1) = {"
W
W
W
W
W
W
W
W
W
W
W
W
W
W
W
W
W
W
W
r
M
M
M
x
x
x
F
x
x
e
h
N
"}
(42,1,1) = {"
W
W
W
W
W
W
W
W
W
W
W
W
W
W
W
W
W
W
W
r
M
M
M
x
x
x
x
x
x
e
h
Y
"}
(43,1,1) = {"
W
W
W
W
W
W
W
W
W
W
W
W
W
W
W
W
W
W
W
r
M
M
M
x
F
x
v
x
x
V
h
h
"}
(44,1,1) = {"
W
W
W
W
W
W
W
W
W
W
W
W
W
W
W
W
W
W
W
r
M
M
M
x
x
x
x
x
x
e
h
l
"}
(45,1,1) = {"
W
W
W
W
W
W
W
W
W
W
W
W
W
W
W
W
W
W
W
r
M
M
M
x
x
x
x
x
x
e
h
C
"}
(46,1,1) = {"
W
W
W
W
W
W
W
W
W
W
W
W
W
W
W
W
W
W
W
r
M
M
M
x
x
x
x
x
x
e
h
C
"}
(47,1,1) = {"
W
W
W
W
W
W
W
W
W
W
W
W
W
W
W
W
W
W
W
r
M
M
M
x
x
x
x
x
x
e
h
G
"}
(48,1,1) = {"
W
W
W
W
W
W
W
W
W
W
W
W
W
W
W
W
W
W
W
r
M
M
M
M
x
x
x
F
x
e
h
h
"}
(49,1,1) = {"
W
W
W
W
W
W
W
W
W
W
W
W
W
W
W
W
W
W
W
r
M
M
M
M
x
x
x
x
x
x
I
h
"}
(50,1,1) = {"
W
W
W
W
W
W
W
W
W
W
W
W
W
W
W
W
W
W
W
r
M
M
M
M
x
x
x
x
x
x
M
I
"}
(51,1,1) = {"
W
W
W
W
W
W
W
W
W
W
W
W
W
W
W
W
W
W
W
r
M
M
M
M
M
x
x
E
x
x
x
y
"}
(52,1,1) = {"
W
W
W
W
W
W
W
W
W
W
W
W
W
W
W
W
W
W
W
r
M
M
M
M
M
x
v
x
x
x
v
x
"}
(53,1,1) = {"
W
W
W
W
W
W
W
W
W
W
W
W
W
W
W
W
W
W
W
r
M
M
M
M
M
M
x
x
F
x
x
x
"}
(54,1,1) = {"
W
W
W
W
W
W
W
W
W
W
W
W
W
W
W
W
W
W
W
r
M
M
M
M
M
M
x
x
x
x
x
x
"}
(55,1,1) = {"
W
W
W
W
W
W
W
W
W
W
W
W
W
W
W
W
W
W
W
r
M
M
M
M
M
M
M
x
g
x
x
x
"}
(56,1,1) = {"
W
W
W
W
W
W
W
W
W
W
W
W
W
W
W
W
W
W
W
r
M
M
M
M
M
M
M
x
x
x
F
x
"}
(57,1,1) = {"
W
W
W
W
W
W
W
W
W
W
W
W
W
W
W
W
W
W
W
r
M
M
M
M
M
M
M
x
x
x
x
x
"}
(58,1,1) = {"
W
W
W
W
W
W
W
W
W
W
W
W
W
W
W
W
W
W
W
r
M
M
M
M
M
M
M
x
x
x
v
x
"}
(59,1,1) = {"
W
W
W
W
W
W
W
W
W
W
W
W
W
W
W
W
W
W
W
r
M
M
M
M
M
M
M
x
x
x
x
x
"}
(60,1,1) = {"
W
W
W
W
W
W
W
W
W
W
W
W
W
W
W
W
W
W
W
r
M
M
M
M
M
M
M
M
x
x
v
x
"}
(61,1,1) = {"
W
W
W
W
W
W
W
W
W
W
W
W
W
W
W
W
W
W
W
r
M
M
M
M
M
M
M
M
M
x
F
x
"}
(62,1,1) = {"
W
W
W
W
W
W
W
W
W
W
W
W
W
W
W
W
W
W
W
r
M
M
M
M
M
M
M
M
M
x
x
x
"}
(63,1,1) = {"
W
W
W
W
W
W
W
W
W
W
W
W
W
W
W
W
W
W
W
r
M
M
M
M
M
M
M
M
M
x
x
x
"}
(64,1,1) = {"
W
W
W
W
W
W
W
W
W
W
W
W
W
W
W
W
W
W
W
r
M
M
M
M
M
M
M
M
M
x
x
x
"}
(65,1,1) = {"
W
W
W
W
W
W
W
W
W
W
W
W
W
W
W
W
W
W
W
r
M
M
M
M
M
M
M
M
M
x
F
x
"}
