//MAP CONVERTED BY dmm2tgm.py THIS HEADER COMMENT PREVENTS RECONVERSION, DO NOT REMOVE
"c" = (
/obj/effect/landmark/patrol_point/som/som_11,
/turf/open/floor/plating/ground/mars/random/cave,
/area/bigredv2/caves/southwest)
"d" = (
/obj/effect/landmark/lv624/fog_blocker/xeno_spawn,
/turf/closed/mineral/smooth/bigred,
/area/bigredv2/caves/rock)
"f" = (
/obj/effect/landmark/weed_node,
/obj/effect/landmark/xeno_resin_wall,
/turf/open/floor/plating/ground/mars/random/cave,
/area/bigredv2/caves/southwest)
"i" = (
/obj/effect/landmark/weed_node,
/turf/open/floor/plating/ground/mars/random/cave,
/area/bigredv2/caves/southwest)
"l" = (
/turf/open/floor/plating/ground/mars/random/cave,
/area/bigredv2/caves/southwest)
"p" = (
/obj/effect/ai_node,
/turf/open/floor/plating/ground/mars/random/cave/rock,
/area/bigredv2/caves/southwest)
"q" = (
/obj/effect/landmark/xeno_resin_wall,
/turf/open/floor/plating/ground/mars/random/cave,
/area/bigredv2/caves/southwest)
"r" = (
/obj/effect/landmark/excavation_site_spawner,
/turf/open/floor/plating/ground/mars/random/cave,
/area/bigredv2/caves/southwest)
"t" = (
/obj/effect/ai_node,
/turf/open/floor/plating/ground/mars/random/cave,
/area/bigredv2/caves/southwest)
"u" = (
/obj/effect/landmark/patrol_point/som/som_14,
/turf/open/floor/plating/ground/mars/random/cave/rock,
/area/bigredv2/caves/southwest)
"w" = (
/obj/effect/landmark/lv624/fog_blocker,
/turf/closed/mineral/smooth/bigred,
/area/bigredv2/caves/rock)
"A" = (
/obj/effect/landmark/weed_node,
/turf/open/floor/plating/ground/mars/random/cave/rock,
/area/bigredv2/caves/southwest)
"B" = (
/obj/effect/landmark/patrol_point/som/som_12,
/turf/open/floor/plating/ground/mars/random/cave,
/area/bigredv2/caves/southwest)
"C" = (
/obj/effect/landmark/patrol_point/som/som_13,
/turf/open/floor/plating/ground/mars/random/cave,
/area/bigredv2/caves/southwest)
"E" = (
/obj/effect/landmark/xeno_resin_wall,
/turf/open/floor/plating/ground/mars/random/cave/rock,
/area/bigredv2/caves/southwest)
"F" = (
/obj/effect/landmark/excavation_site_spawner,
/obj/effect/ai_node,
/turf/open/floor/plating/ground/mars/random/cave,
/area/bigredv2/caves/southwest)
"I" = (
/obj/effect/landmark/weed_node,
/obj/effect/ai_node,
/turf/open/floor/plating/ground/mars/random/cave,
/area/bigredv2/caves/southwest)
"K" = (
/turf/closed/mineral/smooth/bigred/indestructible,
/area/space)
"L" = (
/obj/effect/landmark/xeno_tunnel_spawn,
/turf/open/floor/plating/ground/mars/random/cave,
/area/bigredv2/caves/southwest)
"M" = (
/obj/effect/landmark/weed_node,
/obj/effect/landmark/weed_node,
/turf/open/floor/plating/ground/mars/random/cave,
/area/bigredv2/caves/southwest)
"N" = (
/obj/effect/landmark/lv624/fog_blocker,
/turf/open/floor/plating/ground/mars/random/cave,
/area/bigredv2/caves/southwest)
"Q" = (
/turf/closed/mineral/smooth/bigred,
/area/bigredv2/caves/rock)
"S" = (
/obj/effect/landmark/xeno_silo_spawn,
/turf/open/floor/plating/ground/mars/random/cave,
/area/bigredv2/caves/southwest)
"U" = (
/obj/effect/landmark/xeno_resin_door,
/turf/open/floor/plating/ground/mars/random/cave,
/area/bigredv2/caves/southwest)
"V" = (
/obj/effect/landmark/lv624/fog_blocker/xeno_spawn,
/turf/open/floor/plating/ground/mars/random/cave,
/area/bigredv2/caves/southwest)
"Y" = (
/turf/open/floor/plating/ground/mars/random/cave/rock,
/area/bigredv2/caves/southwest)

(1,1,1) = {"
K
K
K
K
K
K
K
K
K
K
K
K
K
K
K
K
K
K
K
K
K
K
K
K
K
K
K
K
K
K
K
K
K
K
K
K
K
K
K
K
K
K
K
"}
(2,1,1) = {"
Q
Q
Q
Q
Q
Q
Q
Q
Q
Q
Q
Q
Q
Q
Q
Q
Q
Q
Q
Q
Q
Q
Q
Q
Q
Q
Q
Q
Q
Q
Q
Q
Q
Q
Q
Q
Q
Q
Q
Q
Q
Q
K
"}
(3,1,1) = {"
Q
Q
Q
Q
Q
Q
Q
Q
Q
Q
Q
Q
Q
Q
Q
Q
Q
Q
Q
Q
Q
Q
Q
Q
Q
Q
Q
Q
d
d
d
d
d
d
d
d
d
d
d
d
Q
Q
K
"}
(4,1,1) = {"
Q
Q
Q
Q
Q
Q
Q
Q
Q
Q
Q
Q
Q
Q
Q
Q
Q
Q
Q
Q
Q
Q
Q
Q
Q
Q
Q
Q
d
Q
Q
Q
Q
Q
Q
Q
Q
Q
Q
d
Q
Q
K
"}
(5,1,1) = {"
Q
Q
Q
Q
Q
Q
Q
Q
Q
Q
Q
Q
Q
Q
Q
Q
Q
Q
Q
Q
Q
Q
Q
Q
Q
Q
Q
Q
d
Q
Q
Q
Q
Q
l
l
t
i
Q
d
Q
Q
K
"}
(6,1,1) = {"
Q
Q
Q
Q
Q
Q
Q
Q
Q
Q
Q
Q
Q
Q
Q
Q
Q
Q
Q
Q
Q
Q
Q
Q
Q
Q
Q
Q
d
Q
Q
Q
Q
l
l
l
S
l
c
d
Q
Q
K
"}
(7,1,1) = {"
Q
Q
Q
Q
l
l
l
l
l
Q
Q
Q
Q
Q
Q
Q
Q
Q
Q
Q
Q
Q
Q
Q
Q
Q
Q
C
V
l
E
Q
l
i
l
l
l
l
i
d
Q
Q
K
"}
(8,1,1) = {"
Q
Q
l
l
l
i
Y
l
l
l
l
Q
Q
Q
Q
Q
Q
l
l
l
l
Y
l
l
l
l
l
l
V
l
E
l
l
l
l
l
l
l
L
d
Q
Q
K
"}
(9,1,1) = {"
Q
l
Y
l
l
l
l
l
l
l
l
l
l
l
l
l
l
l
l
l
l
l
l
l
l
l
i
l
V
l
E
l
i
l
l
l
i
l
Q
d
Q
Q
K
"}
(10,1,1) = {"
l
l
t
l
i
i
l
l
i
l
i
t
l
l
l
l
l
t
l
l
l
l
t
l
l
l
l
t
V
l
U
Y
l
t
i
l
t
l
Q
d
Q
Q
K
"}
(11,1,1) = {"
i
l
l
l
l
l
i
l
Y
l
l
l
l
Y
Y
l
l
l
l
Y
l
l
l
i
l
l
l
l
V
l
U
Y
i
l
l
l
l
Q
Q
d
Q
Q
K
"}
(12,1,1) = {"
l
l
l
l
l
l
l
l
l
l
Q
Q
Q
l
l
l
Y
l
l
l
l
l
l
l
l
l
l
l
V
l
q
l
l
B
Q
Q
Q
Q
Q
d
Q
Q
K
"}
(13,1,1) = {"
l
Y
p
Q
Q
Q
Q
Q
Q
Q
Q
Q
Q
Q
l
l
l
t
l
l
l
l
i
l
l
l
i
l
V
l
q
f
q
q
Q
Q
Q
Q
Q
d
Q
Q
K
"}
(14,1,1) = {"
l
l
Y
Q
Q
Q
Q
Q
Q
Q
Q
Q
Q
Q
Q
Q
Q
Q
l
l
l
l
l
l
l
l
l
l
V
l
l
l
l
l
Y
Q
Q
Q
Q
d
Q
Q
K
"}
(15,1,1) = {"
l
l
l
Y
Y
Q
Q
Q
Q
Q
Q
Q
Q
Q
Q
Q
Q
Q
Q
Q
l
l
l
l
l
l
i
l
V
V
V
V
V
V
V
d
d
d
d
d
Q
Q
K
"}
(16,1,1) = {"
l
l
M
l
Y
Q
Q
Q
Q
Q
Q
Q
Q
Q
Q
Q
Q
Q
Q
Q
l
l
t
i
l
l
l
t
l
l
l
l
t
l
l
Q
Q
Q
Q
Q
Q
Q
K
"}
(17,1,1) = {"
l
i
l
l
Y
Q
Q
Q
Q
Q
Q
Q
Q
Q
Q
Q
Q
Q
Q
Q
l
l
l
l
l
l
r
l
l
l
l
l
l
l
u
Q
Q
Q
Q
Q
Q
Q
K
"}
(18,1,1) = {"
l
l
l
l
Y
Q
Q
Q
Q
Q
Q
Q
Q
Q
Q
Q
Q
Q
Q
l
l
l
l
l
l
l
l
i
l
l
M
l
l
Q
Q
Q
Q
Q
Q
Q
Q
Q
K
"}
(19,1,1) = {"
l
i
t
l
p
Q
Q
Q
Q
Q
Q
Q
Q
Q
Q
Q
Q
l
l
Y
l
l
i
l
l
l
l
l
i
l
Y
l
l
Q
Q
Q
Q
Q
Q
Q
Q
Q
K
"}
(20,1,1) = {"
Q
l
l
l
i
Y
Q
Q
Q
Q
Q
Q
Q
Q
Q
l
l
l
i
l
l
l
l
l
l
A
l
l
l
l
Y
l
l
l
Q
Q
Q
Q
Q
Q
Q
Q
K
"}
(21,1,1) = {"
Q
Q
Q
l
l
Y
Q
Q
Q
Q
Q
Y
l
l
l
l
l
Y
l
l
l
l
i
l
l
l
l
l
l
Y
l
l
I
l
Q
Q
Q
Q
Q
Q
Q
Q
K
"}
(22,1,1) = {"
Q
Q
Q
i
l
l
Y
l
Q
Q
Q
l
t
l
l
i
l
l
l
l
l
l
t
Y
Q
Y
l
l
l
Y
Q
Q
l
t
i
l
t
Q
Q
Q
Q
Q
K
"}
(23,1,1) = {"
Q
Q
Q
l
l
l
l
l
l
Q
l
l
l
l
l
Y
Q
Q
Q
Q
Q
Q
Q
Q
Q
l
l
t
Q
Q
Q
Q
Q
l
l
l
i
Q
Q
Q
Q
Q
K
"}
(24,1,1) = {"
Q
Q
Q
l
l
i
l
l
Y
l
l
Y
l
i
l
Y
Q
Q
Q
Q
Q
Q
Q
Q
l
l
l
l
Q
Q
Q
Q
Q
l
Y
l
l
l
l
Q
Q
Q
K
"}
(25,1,1) = {"
Q
Q
Q
Y
l
l
l
i
l
l
A
l
l
l
l
Q
Q
Q
Q
Q
Q
Q
Q
Q
l
I
l
l
Q
Q
Q
Q
Q
Q
l
l
l
l
l
l
Q
Q
K
"}
(26,1,1) = {"
Q
Q
Q
Q
t
l
l
l
l
l
l
i
Y
l
l
Q
Q
Q
Q
Q
Q
Q
Q
Q
Q
l
t
l
Q
Q
Q
Q
Q
Q
Q
l
l
l
A
l
Q
Q
K
"}
(27,1,1) = {"
Q
Q
Q
l
i
t
l
l
l
l
l
l
t
l
l
Q
Q
Q
Q
Q
Q
Q
Q
Q
Q
l
l
i
l
Q
Q
Q
Q
Q
Q
l
l
l
l
l
Q
Q
K
"}
(28,1,1) = {"
Q
Q
l
l
l
l
l
l
l
l
l
l
i
l
Y
Q
Q
Q
Q
Q
Q
Q
Q
Q
Q
Q
l
l
l
Q
Q
Q
Q
Q
Q
l
A
l
i
l
Q
Q
K
"}
(29,1,1) = {"
Q
Q
l
l
l
l
l
i
l
l
l
l
l
i
l
Q
Q
Q
Q
Q
Q
Q
Q
Q
Q
Q
l
i
l
Q
Q
Q
Q
Q
Q
l
l
l
l
l
Q
Q
K
"}
(30,1,1) = {"
Q
Q
l
i
l
l
l
l
i
Y
Q
Y
t
l
l
l
Q
Q
Q
Q
Q
Q
Q
Q
Q
Q
l
i
l
l
Q
Q
Q
t
i
l
t
l
l
Q
Q
Q
K
"}
(31,1,1) = {"
Q
l
l
l
l
l
l
l
l
Y
Q
Q
Y
t
i
l
l
Q
Q
Q
Q
Q
Q
Q
Q
Q
p
l
l
l
l
l
l
l
l
l
Q
Q
Q
Q
Q
Q
K
"}
(32,1,1) = {"
Q
l
t
l
l
t
Q
l
l
Y
Q
Q
Q
l
t
l
l
t
l
Q
Q
Q
Q
Q
Q
Q
Y
p
i
l
l
i
l
l
Q
Q
Q
Q
Q
Q
Q
Q
K
"}
(33,1,1) = {"
Q
l
l
l
Q
Q
Q
Y
Y
Q
Q
Q
Q
l
l
l
i
l
i
l
Y
Q
Q
Q
Q
Q
Q
Y
t
l
l
l
l
t
Q
K
K
K
K
K
K
K
K
"}
(34,1,1) = {"
Q
l
l
l
Q
Q
Q
Q
Q
Q
Q
Q
Q
Q
l
l
l
l
l
l
l
Y
Q
Q
Q
Q
Q
Q
l
i
l
l
l
Q
Q
K
K
K
K
K
K
K
K
"}
(35,1,1) = {"
Q
l
l
Q
Q
Q
Q
Q
Q
Q
Q
Q
Q
l
l
l
l
l
l
l
Y
Q
Q
Q
Q
Q
Q
Q
l
l
l
Q
Q
Q
Q
K
K
K
K
K
K
K
K
"}
(36,1,1) = {"
Q
l
l
Q
Q
Q
Q
Q
Q
Q
Q
Q
Q
Y
t
l
l
t
i
l
Y
Q
Q
Q
Q
Q
Q
Q
l
i
l
Q
Q
Q
Q
K
K
K
K
K
K
K
K
"}
(37,1,1) = {"
l
l
l
Q
Q
Q
Q
Q
Q
Q
Q
Q
Q
Q
Q
Q
l
F
l
l
l
p
Q
Q
Q
Q
Q
Q
l
r
l
Q
Q
Q
Q
K
K
K
K
K
K
K
K
"}
(38,1,1) = {"
l
l
l
Q
Q
Q
Q
Q
Q
Q
Q
Q
Q
Q
Q
Q
l
l
l
l
l
Y
Q
Q
Q
Q
Y
A
l
i
l
Q
Q
Q
Q
K
K
K
K
K
K
K
K
"}
(39,1,1) = {"
l
l
l
Q
Q
Q
Q
Q
Q
Q
Q
Q
Q
Q
Q
Q
Y
l
l
l
l
Y
Q
Q
Q
Q
Y
Y
l
l
Q
Q
Q
Q
Q
K
K
K
K
K
K
K
K
"}
(40,1,1) = {"
l
i
l
Q
Q
Q
Q
Q
Q
Q
Q
Q
Q
Q
Q
Q
Q
Q
Q
i
i
l
Y
Y
Q
Q
Q
Q
t
l
Q
Q
Q
Q
Q
K
K
K
K
K
K
K
K
"}
(41,1,1) = {"
N
N
N
w
w
w
w
w
w
w
w
w
w
w
Q
Q
Q
Q
Q
l
l
l
l
Y
Q
Q
Q
Q
l
i
Q
Q
Q
Q
Q
K
K
K
K
K
K
K
K
"}
