//MAP CONVERTED BY dmm2tgm.py THIS HEADER COMMENT PREVENTS RECONVERSION, DO NOT REMOVE
"a" = (
/obj/structure/cable,
/obj/machinery/atmospherics/pipe/simple/green/hidden{
	dir = 5
	},
/turf/open/floor/marking/asteroidwarning{
	dir = 10
	},
/area/bigredv2/outside/c)
"b" = (
/obj/structure/table,
/atom/movable/effect/spawner/random/toolbox,
/atom/movable/effect/spawner/random/toolbox,
/obj/machinery/light{
	dir = 1
	},
/turf/open/floor,
/area/bigredv2/outside/storage)
"c" = (
/obj/machinery/atmospherics/pipe/manifold/green/hidden{
	dir = 1
	},
/obj/structure/cable,
/atom/movable/effect/ai_node,
/turf/open/floor/asteroidfloor,
/area/bigredv2/outside/c)
"d" = (
/obj/machinery/atmospherics/pipe/simple/green/hidden{
	dir = 4
	},
/obj/structure/cable,
/turf/open/floor/asteroidfloor,
/area/bigredv2/outside/c)
"e" = (
/obj/structure/table,
/atom/movable/effect/spawner/random/toolbox,
/atom/movable/effect/spawner/random/toolbox,
/turf/open/floor,
/area/bigredv2/outside/storage)
"f" = (
/obj/machinery/atmospherics/pipe/simple/green/hidden{
	dir = 4
	},
/obj/structure/cable,
/turf/open/floor,
/area/bigredv2/outside/storage)
"g" = (
/turf/open/floor/marking/asteroidwarning{
	dir = 4
	},
/area/bigredv2/outside/c)
"h" = (
/turf/open/floor/marking/asteroidwarning{
	dir = 1
	},
/area/bigredv2/outside/c)
"l" = (
/obj/machinery/atmospherics/pipe/simple/green/hidden{
	dir = 4
	},
/obj/structure/cable,
/obj/machinery/door/airlock/mainship/secure/locked/free_access{
	name = "\improper Emergency Vault"
	},
/turf/open/floor,
/area/bigredv2/outside/storage)
"m" = (
/atom/movable/effect/landmark/weed_node,
/turf/open/floor/marking/asteroidwarning{
	dir = 1
	},
/area/bigredv2/outside/c)
"n" = (
/obj/machinery/atmospherics/components/unary/vent_pump{
	dir = 1;
	on = 1
	},
/turf/open/floor,
/area/bigredv2/outside/storage)
"o" = (
/atom/movable/effect/ai_node,
/turf/open/floor,
/area/bigredv2/outside/storage)
"q" = (
/obj/structure/table,
/atom/movable/effect/spawner/random/toolbox,
/atom/movable/effect/spawner/random/toolbox,
/obj/structure/cable,
/obj/machinery/power/apc,
/turf/open/floor,
/area/bigredv2/outside/storage)
"r" = (
/turf/closed/wall,
/area/bigredv2/outside/storage)
"t" = (
/obj/machinery/atmospherics/pipe/simple/green/hidden,
/obj/structure/cable,
/turf/open/floor/marking/asteroidwarning{
	dir = 8
	},
/area/bigredv2/outside/c)
"u" = (
/obj/machinery/atmospherics/pipe/simple/green/hidden{
	dir = 4
	},
/obj/structure/cable,
/turf/open/floor/marking/asteroidwarning,
/area/bigredv2/outside/c)
"v" = (
/obj/structure/table,
/atom/movable/effect/spawner/random/toolbox,
/atom/movable/effect/spawner/random/toolbox,
/obj/machinery/light,
/turf/open/floor,
/area/bigredv2/outside/storage)
"A" = (
/obj/machinery/atmospherics/pipe/simple/green/hidden,
/obj/structure/cable,
/turf/open/floor/asteroidfloor,
/area/bigredv2/outside/c)
"B" = (
/turf/open/floor/marking/asteroidwarning{
	dir = 5
	},
/area/bigredv2/outside/c)
"C" = (
/obj/structure/cable,
/turf/open/floor,
/area/bigredv2/outside/storage)
"D" = (
/turf/open/floor/asteroidfloor,
/area/bigredv2/outside/c)
"E" = (
/turf/open/floor,
/area/bigredv2/outside/storage)
"F" = (
/turf/open/floor/marking/asteroidwarning{
	dir = 8
	},
/area/bigredv2/outside/c)
"I" = (
/obj/machinery/atmospherics/pipe/manifold/green/hidden{
	dir = 1
	},
/obj/structure/cable,
/turf/open/floor/asteroidfloor,
/area/bigredv2/outside/c)
"J" = (
/atom/movable/effect/ai_node,
/obj/structure/cable,
/obj/machinery/atmospherics/pipe/manifold/green/hidden{
	dir = 1
	},
/turf/open/floor/asteroidfloor,
/area/bigredv2/outside/c)
"L" = (
/obj/machinery/atmospherics/pipe/simple/green/hidden{
	dir = 9
	},
/obj/structure/cable,
/atom/movable/effect/ai_node,
/turf/open/floor/marking/asteroidwarning{
	dir = 6
	},
/area/bigredv2/outside/c)
"M" = (
/turf/open/floor/marking/asteroidwarning{
	dir = 9
	},
/area/bigredv2/outside/c)
"N" = (
/obj/structure/cable,
/obj/machinery/atmospherics/pipe/simple/green/hidden,
/turf/open/floor/marking/asteroidwarning{
	dir = 8
	},
/area/bigredv2/outside/c)
"O" = (
/atom/movable/effect/landmark/weed_node,
/turf/open/floor/plating/ground/mars/random/sand,
/area/bigredv2/outside/c)
"P" = (
/turf/open/floor/plating/ground/mars/random/sand,
/area/bigredv2/outside/c)
"S" = (
/obj/machinery/atmospherics/pipe/simple/green/hidden{
	dir = 10
	},
/obj/structure/cable,
/atom/movable/effect/landmark/weed_node,
/turf/open/floor/asteroidfloor,
/area/bigredv2/outside/c)
"W" = (
/obj/structure/cable,
/obj/machinery/atmospherics/pipe/simple/green/hidden{
	dir = 6
	},
/turf/open/floor,
/area/bigredv2/outside/storage)
"Y" = (
/obj/machinery/atmospherics/pipe/simple/green/hidden,
/obj/structure/cable,
/turf/open/floor/marking/asteroidwarning{
	dir = 4
	},
/area/bigredv2/outside/c)

(1,1,1) = {"
O
M
F
D
c
S
t
N
a
"}
(2,1,1) = {"
P
h
r
r
r
r
r
r
u
"}
(3,1,1) = {"
P
h
r
e
E
E
e
r
u
"}
(4,1,1) = {"
P
h
r
e
E
E
e
r
u
"}
(5,1,1) = {"
O
h
r
e
E
E
e
r
u
"}
(6,1,1) = {"
P
h
r
e
E
E
v
r
u
"}
(7,1,1) = {"
P
h
r
e
o
E
e
r
I
"}
(8,1,1) = {"
P
h
r
q
C
E
e
r
J
"}
(9,1,1) = {"
P
m
r
b
C
E
e
r
d
"}
(10,1,1) = {"
P
h
r
e
W
n
e
r
u
"}
(11,1,1) = {"
P
h
r
e
f
E
e
r
u
"}
(12,1,1) = {"
P
h
r
e
f
E
e
r
u
"}
(13,1,1) = {"
P
m
r
e
f
E
v
r
u
"}
(14,1,1) = {"
P
h
r
e
f
E
e
r
u
"}
(15,1,1) = {"
P
h
r
r
l
r
r
r
u
"}
(16,1,1) = {"
P
B
g
D
c
A
Y
Y
L
"}
