//MAP CONVERTED BY dmm2tgm.py THIS HEADER COMMENT PREVENTS RECONVERSION, DO NOT REMOVE
"ak" = (
/obj/structure/closet/crate/secure,
/obj/item/stack/sheet/metal,
/turf/open/floor/plating/ground/mars/random/cave,
/area/bigredv2/outside/nanotrasen_lab/inside)
"aS" = (
/obj/machinery/atmospherics/pipe/simple/green/hidden{
	dir = 4
	},
/turf/open/floor/plating/ground/mars/random/cave,
/area/bigredv2/outside/nanotrasen_lab/inside)
"aW" = (
/obj/effect/landmark/weed_node,
/obj/effect/landmark/lv624/fog_blocker/xeno_spawn,
/turf/open/floor/plating/ground/mars/random/cave,
/area/bigredv2/caves/south)
"cb" = (
/obj/structure/window_frame/colony/reinforced,
/turf/open/floor/plating/ground/mars/random/cave,
/area/bigredv2/outside/nanotrasen_lab/inside)
"cg" = (
/obj/effect/decal/sandedge/corner2,
/turf/open/floor/tile/dark,
/area/bigredv2/outside/nanotrasen_lab/inside)
"cQ" = (
/obj/effect/decal/sandedge/corner2{
	dir = 1
	},
/turf/open/floor/tile/dark/red2/corner{
	dir = 8
	},
/area/bigredv2/outside/nanotrasen_lab/inside)
"dB" = (
/obj/structure/xenoautopsy/tank/escaped,
/turf/open/floor/tile/dark/red2/corner{
	dir = 8
	},
/area/bigredv2/outside/nanotrasen_lab/inside)
"dM" = (
/obj/structure/reagent_dispensers/fueltank,
/turf/open/floor/plating,
/area/bigredv2/outside/nanotrasen_lab/inside)
"eY" = (
/obj/structure/bed/chair{
	dir = 8
	},
/turf/open/floor/plating/ground/mars/random/cave,
/area/bigredv2/outside/nanotrasen_lab/inside)
"fr" = (
/obj/effect/decal/sandedge/corner,
/turf/open/ground/jungle/clear,
/area/bigredv2/outside/nanotrasen_lab/inside)
"gk" = (
/obj/effect/landmark/lv624/fog_blocker/xeno_spawn,
/turf/open/floor/plating/ground/mars/random/cave,
/area/bigredv2/caves/south)
"gp" = (
/obj/effect/decal/cleanable/dirt,
/obj/effect/landmark/weed_node,
/obj/effect/ai_node,
/turf/open/floor/plating/ground/mars/random/cave,
/area/bigredv2/outside/nanotrasen_lab/inside)
"gD" = (
/turf/open/floor/tile/darkgreen/darkgreen2{
	dir = 4
	},
/area/bigredv2/outside/nanotrasen_lab/inside)
"gG" = (
/obj/structure/xenoautopsy/tank/broken,
/obj/effect/decal/sandedge,
/turf/open/floor/tile/dark/red2/corner{
	dir = 8
	},
/area/bigredv2/outside/nanotrasen_lab/inside)
"gP" = (
/obj/effect/landmark/start/job/xenomorph,
/turf/open/floor/plating/ground/mars/random/cave,
/area/bigredv2/outside/nanotrasen_lab/inside)
"hf" = (
/turf/open/floor/tile/darkgreen/darkgreen2{
	dir = 8
	},
/area/bigredv2/outside/nanotrasen_lab/inside)
"hJ" = (
/obj/effect/decal/sandedge/corner{
	dir = 1
	},
/turf/open/floor/tile/dark,
/area/bigredv2/outside/nanotrasen_lab/inside)
"hY" = (
/obj/machinery/door/airlock/mainship/research/glass/free_access{
	name = "\improper Eta Lab Cell"
	},
/turf/open/floor/tile/dark,
/area/bigredv2/outside/nanotrasen_lab/inside)
"iw" = (
/obj/effect/decal/sandedge/corner2{
	dir = 8
	},
/obj/effect/landmark/start/job/xenomorph,
/turf/open/floor/plating/ground/mars/random/sand,
/area/bigredv2/outside/nanotrasen_lab/inside)
"iN" = (
/turf/closed/wall/r_wall,
/area/bigredv2/outside/nanotrasen_lab/inside)
"jg" = (
/obj/effect/landmark/weed_node,
/turf/open/floor/tile/dark/red2{
	dir = 1
	},
/area/bigredv2/outside/nanotrasen_lab/inside)
"jy" = (
/obj/structure/cable,
/obj/machinery/door/airlock/mainship/maint/free_access{
	name = "\improper Eta Lab Maintenance Storage"
	},
/turf/open/floor/tile/dark,
/area/bigredv2/outside/nanotrasen_lab/inside)
"kg" = (
/obj/machinery/atmospherics/pipe/simple/green/hidden{
	dir = 4
	},
/obj/machinery/door/airlock/mainship/research/glass/free_access{
	name = "\improper Eta Lab Xenobiology Lab"
	},
/turf/open/floor/tile/dark,
/area/bigredv2/outside/nanotrasen_lab/inside)
"kq" = (
/obj/effect/landmark/weed_node,
/turf/open/floor/plating,
/area/bigredv2/outside/nanotrasen_lab/inside)
"kv" = (
/obj/machinery/computer/security,
/obj/effect/decal/sandedge/corner{
	dir = 8
	},
/turf/open/floor/tile/dark/red2/corner{
	dir = 4
	},
/area/bigredv2/outside/nanotrasen_lab/inside)
"kW" = (
/obj/effect/landmark/xeno_resin_wall,
/turf/open/floor/plating/ground/mars/random/cave,
/area/bigredv2/caves/south)
"lH" = (
/obj/effect/landmark/lv624/fog_blocker,
/obj/effect/landmark/xeno_resin_door,
/turf/open/floor/plating/ground/mars/random/cave,
/area/bigredv2/outside/nanotrasen_lab/inside)
"lQ" = (
/obj/effect/decal/cleanable/dirt,
/obj/effect/decal/sandedge/corner{
	dir = 8
	},
/turf/open/floor/tile/dark/red2/corner,
/area/bigredv2/outside/nanotrasen_lab/inside)
"mj" = (
/turf/open/space/basic,
/area/space)
"nN" = (
/obj/effect/decal/sandedge/corner{
	dir = 4
	},
/turf/open/floor/plating/ground/mars/random/sand,
/area/bigredv2/outside/nanotrasen_lab/inside)
"ob" = (
/obj/machinery/atmospherics/pipe/simple/green/hidden{
	dir = 4
	},
/obj/machinery/door/airlock/mainship/research/glass/free_access{
	locked = 1;
	name = "\improper Eta Lab Xenobiology Lab"
	},
/turf/open/floor/tile/dark,
/area/bigredv2/outside/nanotrasen_lab/inside)
"og" = (
/obj/effect/landmark/weed_node,
/obj/effect/decal/sandedge{
	dir = 8
	},
/turf/open/floor/plating/ground/mars/random/sand,
/area/bigredv2/outside/nanotrasen_lab/inside)
"op" = (
/obj/effect/landmark/lv624/fog_blocker,
/turf/open/floor/plating/ground/mars/random/cave,
/area/bigredv2/caves/rock)
"ow" = (
/obj/structure/bed/chair{
	dir = 8
	},
/obj/effect/landmark/weed_node,
/turf/open/floor/plating/ground/mars/random/cave,
/area/bigredv2/outside/nanotrasen_lab/inside)
"oG" = (
/obj/effect/landmark/weed_node,
/turf/open/floor/tile/dark,
/area/bigredv2/outside/nanotrasen_lab/inside)
"pk" = (
/obj/structure/cable,
/obj/effect/ai_node,
/turf/open/floor/plating,
/area/bigredv2/outside/nanotrasen_lab/inside)
"qE" = (
/obj/machinery/light{
	dir = 1
	},
/turf/open/floor/tile/dark/red2{
	dir = 9
	},
/area/bigredv2/outside/nanotrasen_lab/inside)
"qZ" = (
/obj/effect/decal/cleanable/dirt,
/obj/structure/table/flipped,
/turf/open/floor/plating/ground/mars/random/cave,
/area/bigredv2/outside/nanotrasen_lab/inside)
"rt" = (
/obj/effect/decal/sandedge{
	dir = 4
	},
/turf/open/floor/tile/dark/red2{
	dir = 4
	},
/area/bigredv2/outside/nanotrasen_lab/inside)
"rB" = (
/obj/effect/decal/sandedge{
	dir = 1
	},
/turf/open/ground/jungle/clear,
/area/bigredv2/outside/nanotrasen_lab/inside)
"rV" = (
/turf/open/floor/tile/dark/red2{
	dir = 8
	},
/area/bigredv2/outside/nanotrasen_lab/inside)
"sd" = (
/obj/structure/window/framed/colony,
/turf/open/floor/plating,
/area/bigredv2/outside/nanotrasen_lab/inside)
"si" = (
/obj/effect/landmark/corpsespawner/security,
/turf/open/floor/plating/ground/mars/random/cave,
/area/bigredv2/outside/nanotrasen_lab/inside)
"sx" = (
/turf/open/floor/tile/darkgreen/darkgreen2{
	dir = 10
	},
/area/bigredv2/outside/nanotrasen_lab/inside)
"sP" = (
/turf/open/floor/tile/dark/red2{
	dir = 1
	},
/area/bigredv2/outside/nanotrasen_lab/inside)
"th" = (
/obj/effect/landmark/corpsespawner/scientist,
/turf/open/floor/tile/darkgreen/darkgreen2{
	dir = 6
	},
/area/bigredv2/outside/nanotrasen_lab/inside)
"tn" = (
/obj/effect/landmark/weed_node,
/turf/open/ground/jungle/clear,
/area/bigredv2/outside/nanotrasen_lab/inside)
"tF" = (
/obj/effect/decal/cleanable/blood/gibs,
/turf/open/floor/plating/ground/mars/random/cave,
/area/bigredv2/caves/south)
"tW" = (
/obj/effect/decal/sandedge/corner{
	dir = 1
	},
/obj/effect/decal/cleanable/blood,
/turf/open/floor/tile/dark,
/area/bigredv2/outside/nanotrasen_lab/inside)
"um" = (
/obj/effect/landmark/xeno_resin_wall,
/obj/effect/landmark/excavation_site_spawner,
/turf/open/floor/plating/ground/mars/random/cave,
/area/bigredv2/caves/south)
"uu" = (
/turf/open/floor/plating/ground/mars/random/sand,
/area/bigredv2/outside/nanotrasen_lab/inside)
"uI" = (
/obj/effect/decal/sandedge{
	dir = 8
	},
/turf/open/floor/plating/ground/mars/random/sand,
/area/bigredv2/outside/nanotrasen_lab/inside)
"uV" = (
/obj/structure/closet/toolcloset,
/turf/open/floor/plating,
/area/bigredv2/outside/nanotrasen_lab/inside)
"ve" = (
/obj/item/tool/pen,
/obj/item/stack/sheet/metal,
/turf/open/floor/plating/ground/mars/random/cave,
/area/bigredv2/outside/nanotrasen_lab/inside)
"vI" = (
/obj/effect/decal/cleanable/dirt,
/obj/effect/landmark/weed_node,
/turf/open/floor/plating/ground/mars/random/cave,
/area/bigredv2/outside/nanotrasen_lab/inside)
"vV" = (
/obj/effect/decal/cleanable/dirt,
/obj/effect/ai_node,
/turf/open/floor/plating/ground/mars/random/cave,
/area/bigredv2/outside/nanotrasen_lab/inside)
"wj" = (
/obj/effect/landmark/lv624/fog_blocker/xeno_spawn,
/turf/open/floor/plating/ground/mars/random/cave/rock,
/area/bigredv2/caves/south)
"wO" = (
/obj/effect/landmark/xeno_silo_spawn,
/turf/open/floor/plating/ground/mars/random/cave,
/area/bigredv2/caves/south)
"xc" = (
/obj/structure/table,
/obj/effect/spawner/random/technology_scanner,
/obj/effect/decal/sandedge{
	dir = 1
	},
/turf/open/floor/tile/dark/red2/corner{
	dir = 4
	},
/area/bigredv2/outside/nanotrasen_lab/inside)
"xo" = (
/obj/structure/bed/chair{
	dir = 4
	},
/turf/open/floor/plating/ground/mars/random/cave,
/area/bigredv2/outside/nanotrasen_lab/inside)
"xw" = (
/turf/open/floor/tile/dark/red2{
	dir = 10
	},
/area/bigredv2/outside/nanotrasen_lab/inside)
"xD" = (
/obj/item/stack/sheet/metal,
/turf/open/floor/plating/ground/mars/random/cave,
/area/bigredv2/outside/nanotrasen_lab/inside)
"xT" = (
/obj/effect/decal/cleanable/dirt,
/obj/item/stack/sheet/metal,
/turf/open/floor/plating/ground/mars/random/cave,
/area/bigredv2/outside/nanotrasen_lab/inside)
"yX" = (
/obj/effect/decal/cleanable/dirt,
/obj/effect/landmark/corpsespawner/security,
/turf/open/floor/plating/ground/mars/random/cave,
/area/bigredv2/outside/nanotrasen_lab/inside)
"zh" = (
/obj/machinery/light{
	dir = 1
	},
/turf/open/floor/tile/dark/red2{
	dir = 5
	},
/area/bigredv2/outside/nanotrasen_lab/inside)
"zy" = (
/obj/structure/xenoautopsy/jar_shelf,
/turf/open/floor/plating/ground/mars/random/cave,
/area/bigredv2/outside/nanotrasen_lab/inside)
"zH" = (
/obj/machinery/atmospherics/components/unary/vent_pump{
	dir = 4;
	on = 1
	},
/turf/open/floor/plating/ground/mars/random/cave,
/area/bigredv2/outside/nanotrasen_lab/inside)
"Ai" = (
/obj/effect/landmark/weed_node,
/turf/open/floor/plating/ground/mars/random/sand,
/area/bigredv2/outside/nanotrasen_lab/inside)
"BJ" = (
/obj/effect/landmark/start/job/xenomorph,
/turf/open/floor/plating/ground/mars/random/sand,
/area/bigredv2/outside/nanotrasen_lab/inside)
"BZ" = (
/obj/effect/landmark/weed_node,
/obj/effect/decal/sandedge/corner2{
	dir = 4
	},
/turf/open/ground/jungle/clear,
/area/bigredv2/outside/nanotrasen_lab/inside)
"Ck" = (
/obj/structure/table,
/obj/item/alienjar,
/obj/effect/landmark/weed_node,
/obj/effect/decal/sandedge/corner{
	dir = 4
	},
/turf/open/floor/tile/dark/red2/corner{
	dir = 4
	},
/area/bigredv2/outside/nanotrasen_lab/inside)
"CE" = (
/obj/structure/window/framed/colony/reinforced,
/turf/open/floor/plating/ground/mars/random/cave,
/area/bigredv2/outside/nanotrasen_lab/inside)
"CG" = (
/obj/effect/decal/cleanable/dirt,
/obj/item/shard,
/obj/effect/landmark/corpsespawner/security,
/turf/open/floor/plating/ground/mars/random/cave,
/area/bigredv2/outside/nanotrasen_lab/inside)
"CR" = (
/turf/closed/mineral/smooth/bigred,
/area/bigredv2/caves/rock)
"Dm" = (
/turf/open/floor/tile/dark/red2/corner{
	dir = 8
	},
/area/bigredv2/outside/nanotrasen_lab/inside)
"DF" = (
/obj/machinery/atmospherics/pipe/simple/green/hidden{
	dir = 4
	},
/turf/open/floor/tile/dark,
/area/bigredv2/outside/nanotrasen_lab/inside)
"DS" = (
/obj/effect/decal/cleanable/dirt,
/turf/open/floor/plating/ground/mars/random/cave,
/area/bigredv2/outside/nanotrasen_lab/inside)
"DY" = (
/turf/open/floor/tile/dark/red2,
/area/bigredv2/outside/nanotrasen_lab/inside)
"El" = (
/obj/effect/ai_node,
/turf/open/floor/tile/dark,
/area/bigredv2/outside/nanotrasen_lab/inside)
"EK" = (
/turf/open/floor/plating,
/area/bigredv2/outside/nanotrasen_lab/inside)
"EZ" = (
/obj/item/shard,
/turf/open/floor/plating/ground/mars/random/cave,
/area/bigredv2/caves/south)
"Fp" = (
/obj/structure/xenoautopsy/tank,
/turf/open/floor/plating/ground/mars/random/cave,
/area/bigredv2/outside/nanotrasen_lab/inside)
"GM" = (
/obj/effect/spawner/random/technology_scanner,
/obj/item/xenos_claw,
/obj/effect/decal/sandedge,
/obj/structure/table/flipped,
/turf/open/floor/tile/dark/red2/corner{
	dir = 8
	},
/area/bigredv2/outside/nanotrasen_lab/inside)
"HX" = (
/obj/machinery/light,
/turf/open/floor/tile/darkgreen/darkgreen2,
/area/bigredv2/outside/nanotrasen_lab/inside)
"Ii" = (
/turf/open/floor/plating/ground/mars/random/cave,
/area/bigredv2/caves/rock)
"Jk" = (
/obj/effect/landmark/xeno_resin_door,
/obj/effect/landmark/lv624/fog_blocker,
/turf/open/floor/plating/ground/mars/random/cave,
/area/bigredv2/outside/nanotrasen_lab/inside)
"JD" = (
/obj/effect/decal/cleanable/dirt,
/obj/effect/decal/sandedge/corner,
/turf/open/floor/tile/dark,
/area/bigredv2/outside/nanotrasen_lab/inside)
"JN" = (
/obj/effect/landmark/weed_node,
/turf/open/floor/plating/ground/mars/random/cave/rock,
/area/bigredv2/caves/south)
"JW" = (
/obj/effect/landmark/lv624/fog_blocker/xeno_spawn,
/turf/closed/mineral/smooth/bigred,
/area/bigredv2/caves/rock)
"Kh" = (
/obj/effect/decal/cleanable/blood,
/turf/open/floor/plating/ground/mars/random/cave,
/area/bigredv2/outside/nanotrasen_lab/inside)
"Kp" = (
/turf/open/floor/plating/ground/mars/random/cave,
/area/bigredv2/caves/south)
"Kr" = (
/obj/structure/bed/chair{
	dir = 4
	},
/obj/effect/decal/sandedge{
	dir = 1
	},
/turf/open/floor/tile/dark/red2{
	dir = 4
	},
/area/bigredv2/outside/nanotrasen_lab/inside)
"Kt" = (
/obj/item/shard,
/obj/effect/landmark/weed_node,
/turf/open/floor/plating/ground/mars/random/cave,
/area/bigredv2/outside/nanotrasen_lab/inside)
"KJ" = (
/obj/effect/landmark/lv624/fog_blocker/xeno_spawn,
/turf/open/floor/plating/ground/mars/random/cave,
/area/bigredv2/caves/rock)
"KK" = (
/obj/structure/cable,
/obj/machinery/power/apc{
	dir = 1
	},
/turf/open/floor/plating,
/area/bigredv2/outside/nanotrasen_lab/inside)
"KR" = (
/obj/effect/landmark/xeno_resin_door,
/obj/effect/decal/sandedge{
	dir = 4
	},
/turf/open/floor/plating/ground/mars/random/sand,
/area/bigredv2/outside/nanotrasen_lab/inside)
"Ly" = (
/obj/effect/landmark/weed_node,
/obj/effect/ai_node,
/turf/open/floor/tile/dark,
/area/bigredv2/outside/nanotrasen_lab/inside)
"LP" = (
/obj/effect/ai_node,
/turf/open/floor/plating/ground/mars/random/cave/rock,
/area/bigredv2/caves/south)
"LZ" = (
/turf/open/floor/plating/ground/mars/random/cave,
/area/bigredv2/outside/nanotrasen_lab/inside)
"MY" = (
/obj/item/stack/sheet/metal,
/obj/item/shard,
/turf/open/floor/plating/ground/mars/random/cave,
/area/bigredv2/outside/nanotrasen_lab/inside)
"Nb" = (
/obj/effect/landmark/weed_node,
/obj/effect/landmark/xeno_resin_wall,
/turf/open/floor/plating/ground/mars/random/cave,
/area/bigredv2/caves/south)
"NK" = (
/obj/structure/cable,
/turf/open/floor/plating,
/area/bigredv2/outside/nanotrasen_lab/inside)
"NL" = (
/turf/open/floor/plating/ground/mars/random/cave/rock,
/area/bigredv2/caves/south)
"NO" = (
/obj/structure/table,
/obj/item/paper,
/obj/effect/decal/sandedge/corner{
	dir = 8
	},
/turf/open/floor/tile/dark/red2/corner,
/area/bigredv2/outside/nanotrasen_lab/inside)
"Od" = (
/obj/effect/decal/cleanable/dirt,
/obj/item/shard,
/turf/open/floor/plating/ground/mars/random/cave,
/area/bigredv2/outside/nanotrasen_lab/inside)
"Oh" = (
/obj/effect/landmark/weed_node,
/turf/open/floor/plating/ground/mars/random/cave,
/area/bigredv2/caves/south)
"Op" = (
/obj/effect/ai_node,
/obj/effect/decal/sandedge{
	dir = 8
	},
/turf/open/floor/tile/dark,
/area/bigredv2/outside/nanotrasen_lab/inside)
"Ot" = (
/obj/effect/landmark/weed_node,
/turf/open/floor/plating/ground/mars/random/cave,
/area/bigredv2/outside/nanotrasen_lab/inside)
"Oz" = (
/obj/structure/closet/l3closet/scientist,
/turf/open/floor/tile/darkgreen/darkgreen2{
	dir = 5
	},
/area/bigredv2/outside/nanotrasen_lab/inside)
"PE" = (
/turf/closed/mineral/smooth/bigred/indestructible,
/area/space)
"Qm" = (
/obj/effect/decal/sandedge{
	dir = 4
	},
/turf/open/ground/jungle/clear,
/area/bigredv2/outside/nanotrasen_lab/inside)
"Qx" = (
/obj/effect/landmark/xeno_resin_door,
/obj/effect/landmark/lv624/fog_blocker,
/turf/open/floor/plating/ground/mars/cavetodirt{
	dir = 1
	},
/area/bigredv2/outside/nanotrasen_lab/inside)
"QU" = (
/obj/structure/closet/firecloset,
/turf/open/floor/plating,
/area/bigredv2/outside/nanotrasen_lab/inside)
"Rw" = (
/obj/structure/closet/l3closet/scientist,
/turf/open/floor/tile/darkgreen/darkgreen2{
	dir = 1
	},
/area/bigredv2/outside/nanotrasen_lab/inside)
"RA" = (
/obj/item/target,
/turf/open/floor/tile/dark/red2{
	dir = 1
	},
/area/bigredv2/outside/nanotrasen_lab/inside)
"RE" = (
/turf/open/ground/jungle/clear,
/area/bigredv2/outside/nanotrasen_lab/inside)
"Sc" = (
/obj/structure/window/framed/colony/reinforced,
/turf/open/floor/plating,
/area/bigredv2/outside/nanotrasen_lab/inside)
"Sm" = (
/obj/machinery/atmospherics/components/unary/vent_pump{
	dir = 1;
	on = 1
	},
/turf/open/floor/tile/dark,
/area/bigredv2/outside/nanotrasen_lab/inside)
"Sq" = (
/obj/effect/decal/sandedge/corner2,
/turf/open/ground/jungle/clear,
/area/bigredv2/outside/nanotrasen_lab/inside)
"St" = (
/obj/effect/landmark/weed_node,
/turf/open/floor/tile/dark/red2,
/area/bigredv2/outside/nanotrasen_lab/inside)
"Tw" = (
/obj/effect/decal/sandedge/corner2{
	dir = 1
	},
/obj/effect/spawner/random/technology_scanner,
/turf/open/floor/tile/dark,
/area/bigredv2/outside/nanotrasen_lab/inside)
"TA" = (
/turf/open/floor/tile/dark/red2{
	dir = 4
	},
/area/bigredv2/outside/nanotrasen_lab/inside)
"TC" = (
/obj/effect/landmark/xeno_resin_door,
/turf/open/floor/plating/ground/mars/random/cave,
/area/bigredv2/caves/south)
"TK" = (
/obj/effect/landmark/excavation_site_spawner,
/turf/open/floor/plating/ground/mars/random/cave,
/area/bigredv2/caves/south)
"TN" = (
/obj/structure/xenoautopsy/tank/broken,
/turf/open/floor/tile/dark/red2/corner{
	dir = 8
	},
/area/bigredv2/outside/nanotrasen_lab/inside)
"TT" = (
/obj/effect/ai_node,
/turf/open/floor/plating/ground/mars/random/cave,
/area/bigredv2/caves/south)
"UT" = (
/obj/machinery/atmospherics/pipe/manifold/green/hidden{
	dir = 1
	},
/obj/effect/ai_node,
/turf/open/floor/tile/dark,
/area/bigredv2/outside/nanotrasen_lab/inside)
"Vm" = (
/turf/open/floor/tile/dark,
/area/bigredv2/outside/nanotrasen_lab/inside)
"Vq" = (
/obj/effect/landmark/lv624/fog_blocker,
/turf/closed/mineral/smooth/bigred,
/area/bigredv2/caves/rock)
"VI" = (
/obj/structure/bed/chair{
	dir = 4
	},
/obj/effect/landmark/excavation_site_spawner,
/obj/effect/decal/sandedge/corner,
/turf/open/floor/tile/dark/red2{
	dir = 4
	},
/area/bigredv2/outside/nanotrasen_lab/inside)
"Wa" = (
/obj/effect/landmark/lv624/fog_blocker,
/turf/closed/wall/r_wall,
/area/bigredv2/outside/nanotrasen_lab/inside)
"Yn" = (
/obj/machinery/atmospherics/pipe/simple/green/hidden{
	dir = 4
	},
/obj/effect/ai_node,
/turf/open/floor/plating/ground/mars/random/cave,
/area/bigredv2/outside/nanotrasen_lab/inside)
"Yp" = (
/obj/structure/closet/l3closet/scientist,
/turf/open/floor/tile/darkgreen/darkgreen2{
	dir = 9
	},
/area/bigredv2/outside/nanotrasen_lab/inside)
"YI" = (
/turf/open/floor/tile/dark/red2{
	dir = 6
	},
/area/bigredv2/outside/nanotrasen_lab/inside)
"YK" = (
/turf/closed/wall,
/area/bigredv2/outside/nanotrasen_lab/inside)
"YN" = (
/obj/structure/window_frame/colony/reinforced,
/obj/effect/decal/sandedge{
	dir = 1
	},
/obj/item/shard,
/obj/item/shard,
/turf/open/floor/plating,
/area/bigredv2/outside/nanotrasen_lab/inside)
"YO" = (
/obj/machinery/miner/damaged/platinum,
/turf/open/floor/plating/ground/mars/random/cave/rock,
/area/bigredv2/caves/south)
"Zo" = (
/obj/structure/window_frame/colony/reinforced,
/obj/item/shard,
/turf/open/floor/plating/ground/mars/random/cave,
/area/bigredv2/outside/nanotrasen_lab/inside)
"ZD" = (
/obj/effect/decal/sandedge/corner{
	dir = 1
	},
/turf/open/floor/tile/dark/red2/corner{
	dir = 8
	},
/area/bigredv2/outside/nanotrasen_lab/inside)
"ZR" = (
/obj/machinery/door/airlock/mainship/research/glass/free_access{
	dir = 1;
	locked = 1;
	name = "\improper Eta Lab Cell"
	},
/turf/open/floor/tile/dark,
/area/bigredv2/outside/nanotrasen_lab/inside)

(1,1,1) = {"
PE
mj
mj
mj
mj
mj
mj
mj
mj
mj
mj
mj
mj
mj
mj
mj
mj
mj
mj
mj
mj
mj
mj
mj
mj
mj
mj
mj
mj
mj
mj
mj
mj
mj
mj
mj
mj
mj
"}
(2,1,1) = {"
PE
mj
mj
mj
mj
mj
mj
mj
mj
mj
mj
mj
mj
mj
mj
mj
mj
mj
mj
mj
mj
mj
mj
mj
mj
mj
mj
mj
mj
mj
mj
mj
mj
mj
mj
mj
mj
mj
"}
(3,1,1) = {"
PE
mj
mj
mj
mj
mj
mj
mj
mj
mj
mj
mj
mj
mj
mj
mj
mj
mj
mj
mj
mj
mj
mj
mj
mj
mj
mj
mj
mj
mj
mj
mj
mj
mj
mj
mj
mj
mj
"}
(4,1,1) = {"
PE
mj
mj
mj
mj
mj
mj
mj
mj
mj
mj
mj
mj
mj
mj
mj
mj
mj
mj
mj
mj
mj
mj
mj
mj
mj
mj
mj
mj
mj
mj
mj
mj
mj
mj
mj
mj
mj
"}
(5,1,1) = {"
PE
mj
mj
mj
mj
mj
mj
mj
mj
mj
mj
mj
mj
mj
mj
mj
mj
mj
mj
mj
mj
mj
mj
mj
mj
mj
mj
mj
mj
mj
mj
mj
mj
mj
mj
mj
mj
mj
"}
(6,1,1) = {"
PE
mj
mj
mj
mj
mj
mj
mj
mj
mj
mj
mj
mj
mj
mj
mj
mj
mj
mj
mj
mj
mj
mj
mj
mj
mj
mj
mj
mj
mj
mj
mj
mj
mj
mj
mj
mj
mj
"}
(7,1,1) = {"
PE
mj
mj
mj
mj
mj
mj
mj
mj
mj
mj
mj
mj
mj
mj
mj
mj
mj
mj
mj
mj
mj
mj
mj
mj
mj
mj
mj
mj
mj
mj
mj
mj
mj
mj
mj
mj
mj
"}
(8,1,1) = {"
PE
mj
mj
mj
mj
mj
mj
mj
mj
mj
mj
mj
mj
mj
mj
mj
mj
mj
mj
mj
mj
mj
mj
mj
mj
mj
mj
mj
mj
mj
mj
mj
mj
mj
mj
mj
mj
mj
"}
(9,1,1) = {"
PE
mj
mj
mj
mj
mj
mj
mj
mj
mj
mj
mj
mj
mj
mj
mj
mj
mj
mj
mj
mj
mj
mj
mj
mj
mj
mj
mj
mj
mj
mj
mj
mj
mj
mj
mj
mj
mj
"}
(10,1,1) = {"
PE
mj
mj
mj
mj
mj
mj
mj
mj
mj
mj
mj
mj
mj
mj
mj
mj
mj
mj
mj
mj
mj
mj
mj
mj
mj
mj
mj
mj
mj
mj
mj
mj
mj
mj
mj
mj
mj
"}
(11,1,1) = {"
PE
mj
mj
mj
mj
mj
mj
mj
mj
mj
mj
mj
mj
mj
mj
mj
mj
mj
mj
mj
mj
mj
mj
mj
mj
mj
mj
mj
mj
mj
mj
mj
mj
mj
mj
mj
mj
mj
"}
(12,1,1) = {"
PE
mj
mj
mj
mj
mj
mj
mj
mj
mj
mj
mj
mj
mj
mj
mj
mj
mj
mj
mj
mj
mj
mj
mj
mj
mj
mj
mj
mj
mj
mj
mj
mj
mj
mj
mj
mj
mj
"}
(13,1,1) = {"
PE
mj
mj
mj
mj
mj
mj
mj
mj
mj
mj
mj
mj
mj
mj
mj
mj
mj
mj
mj
mj
mj
mj
mj
mj
mj
mj
mj
mj
mj
mj
mj
mj
mj
mj
mj
mj
mj
"}
(14,1,1) = {"
PE
mj
mj
mj
mj
mj
mj
mj
mj
mj
mj
mj
mj
mj
mj
mj
mj
mj
mj
mj
mj
mj
mj
mj
mj
mj
mj
mj
mj
mj
mj
mj
mj
mj
mj
mj
mj
mj
"}
(15,1,1) = {"
PE
mj
mj
mj
mj
mj
mj
mj
mj
mj
mj
mj
mj
mj
mj
mj
mj
mj
mj
mj
mj
mj
mj
mj
mj
mj
mj
mj
mj
mj
mj
mj
mj
mj
mj
mj
mj
mj
"}
(16,1,1) = {"
PE
mj
mj
mj
mj
mj
mj
mj
mj
mj
mj
mj
mj
mj
mj
mj
mj
mj
mj
mj
mj
mj
mj
mj
mj
mj
mj
mj
mj
mj
mj
mj
mj
mj
mj
mj
mj
mj
"}
(17,1,1) = {"
PE
mj
mj
mj
mj
mj
mj
mj
mj
mj
mj
mj
mj
mj
mj
mj
mj
mj
mj
mj
mj
mj
mj
mj
mj
mj
mj
mj
mj
mj
mj
mj
mj
mj
mj
mj
mj
mj
"}
(18,1,1) = {"
PE
mj
mj
mj
mj
mj
mj
mj
mj
mj
mj
mj
mj
mj
mj
mj
mj
mj
mj
mj
mj
mj
mj
mj
mj
mj
mj
mj
mj
mj
mj
mj
mj
mj
mj
mj
mj
mj
"}
(19,1,1) = {"
PE
mj
mj
mj
mj
mj
mj
mj
mj
mj
mj
mj
mj
mj
mj
mj
mj
mj
mj
mj
mj
mj
mj
mj
mj
mj
mj
mj
mj
mj
mj
mj
mj
mj
mj
mj
mj
mj
"}
(20,1,1) = {"
PE
mj
mj
mj
mj
mj
mj
mj
mj
mj
mj
mj
mj
mj
mj
mj
mj
mj
mj
mj
mj
mj
mj
mj
mj
mj
mj
mj
mj
mj
mj
mj
mj
mj
mj
mj
mj
mj
"}
(21,1,1) = {"
PE
mj
mj
mj
mj
mj
mj
mj
mj
mj
mj
mj
mj
mj
mj
mj
mj
mj
mj
mj
mj
mj
mj
mj
mj
mj
mj
mj
mj
mj
mj
mj
mj
mj
mj
mj
mj
mj
"}
(22,1,1) = {"
PE
mj
mj
mj
mj
mj
mj
mj
mj
mj
mj
mj
mj
mj
mj
mj
mj
mj
mj
mj
mj
mj
mj
mj
mj
mj
mj
mj
mj
mj
mj
mj
mj
mj
mj
mj
mj
mj
"}
(23,1,1) = {"
PE
mj
mj
mj
mj
mj
mj
mj
mj
mj
mj
mj
mj
mj
mj
mj
mj
mj
mj
mj
mj
mj
mj
mj
mj
mj
mj
mj
mj
mj
mj
mj
mj
mj
mj
mj
mj
mj
"}
(24,1,1) = {"
PE
mj
mj
mj
mj
mj
mj
mj
mj
mj
mj
mj
mj
mj
mj
mj
mj
mj
mj
mj
mj
mj
mj
mj
mj
mj
mj
mj
mj
mj
mj
mj
mj
mj
mj
mj
mj
mj
"}
(25,1,1) = {"
PE
mj
mj
mj
mj
mj
mj
mj
mj
mj
mj
mj
mj
mj
mj
mj
mj
mj
mj
mj
mj
mj
mj
mj
mj
mj
mj
mj
mj
mj
mj
mj
mj
mj
mj
mj
mj
mj
"}
(26,1,1) = {"
PE
mj
mj
mj
mj
mj
mj
mj
mj
mj
mj
mj
mj
mj
mj
mj
mj
mj
mj
mj
mj
mj
mj
mj
mj
mj
mj
mj
mj
mj
mj
mj
mj
mj
mj
mj
mj
mj
"}
(27,1,1) = {"
PE
mj
mj
mj
mj
mj
mj
mj
mj
mj
mj
mj
mj
mj
mj
mj
mj
mj
mj
mj
mj
mj
mj
mj
mj
mj
mj
mj
mj
mj
mj
mj
mj
mj
mj
mj
mj
mj
"}
(28,1,1) = {"
PE
mj
mj
mj
mj
mj
mj
mj
mj
mj
mj
mj
mj
mj
mj
mj
mj
mj
mj
mj
mj
mj
mj
mj
mj
mj
mj
mj
mj
mj
mj
mj
mj
mj
mj
mj
mj
mj
"}
(29,1,1) = {"
PE
PE
PE
PE
PE
PE
PE
PE
PE
PE
PE
PE
PE
PE
PE
PE
PE
PE
PE
PE
PE
PE
PE
PE
PE
PE
PE
PE
PE
PE
PE
PE
PE
PE
PE
PE
PE
PE
"}
(30,1,1) = {"
CR
CR
CR
CR
CR
CR
CR
CR
CR
CR
CR
CR
CR
CR
CR
CR
CR
CR
CR
CR
CR
CR
CR
CR
CR
CR
CR
CR
CR
CR
CR
CR
CR
CR
CR
CR
CR
PE
"}
(31,1,1) = {"
CR
CR
JW
JW
JW
JW
JW
JW
JW
JW
JW
JW
JW
JW
JW
CR
CR
CR
CR
CR
CR
CR
CR
CR
CR
CR
CR
CR
CR
CR
CR
CR
CR
CR
CR
CR
CR
PE
"}
(32,1,1) = {"
CR
CR
JW
CR
CR
CR
CR
CR
CR
NL
NL
CR
CR
CR
JW
CR
CR
CR
CR
CR
CR
CR
CR
CR
CR
CR
CR
CR
CR
CR
CR
CR
CR
CR
CR
CR
CR
PE
"}
(33,1,1) = {"
CR
CR
JW
CR
CR
CR
CR
CR
NL
Kp
Kp
NL
CR
CR
JW
CR
CR
CR
CR
CR
CR
CR
CR
CR
CR
CR
CR
CR
CR
CR
CR
CR
CR
CR
CR
CR
CR
PE
"}
(34,1,1) = {"
CR
CR
JW
CR
CR
CR
CR
NL
Kp
Oh
wO
Kp
NL
NL
JW
CR
CR
CR
CR
CR
CR
CR
CR
CR
CR
CR
CR
CR
CR
CR
CR
CR
CR
CR
CR
CR
CR
PE
"}
(35,1,1) = {"
CR
CR
JW
CR
CR
CR
NL
Kp
Kp
Kp
Kp
Kp
Kp
NL
JW
CR
CR
CR
CR
CR
CR
CR
CR
CR
CR
CR
CR
CR
CR
CR
CR
CR
CR
CR
CR
CR
CR
PE
"}
(36,1,1) = {"
CR
CR
JW
CR
CR
CR
Kp
Kp
Kp
Kp
Kp
Kp
Kp
Kp
JW
CR
CR
CR
CR
CR
CR
CR
CR
CR
CR
CR
CR
CR
CR
CR
CR
CR
CR
CR
CR
CR
CR
PE
"}
(37,1,1) = {"
CR
CR
JW
CR
kW
kW
kW
um
kW
TC
TC
kW
Nb
kW
JW
CR
CR
CR
CR
CR
CR
CR
CR
CR
CR
CR
CR
CR
CR
CR
CR
CR
CR
CR
CR
CR
CR
PE
"}
(38,1,1) = {"
CR
CR
JW
Kp
Kp
Kp
Kp
Oh
Kp
Kp
Kp
Kp
Oh
Kp
gk
Kp
CR
CR
CR
CR
CR
CR
CR
CR
CR
CR
CR
CR
CR
CR
CR
CR
CR
CR
CR
CR
CR
PE
"}
(39,1,1) = {"
Kp
Kp
gk
Kp
Kp
Kp
Kp
Kp
Kp
Kp
Kp
Kp
Kp
Kp
gk
Kp
Oh
Kp
Kp
Kp
Kp
Oh
CR
CR
CR
CR
CR
CR
CR
CR
CR
CR
CR
CR
CR
CR
CR
PE
"}
(40,1,1) = {"
Kp
NL
gk
Kp
JN
NL
Kp
Kp
Kp
Kp
Oh
NL
Kp
Kp
gk
Kp
Kp
Kp
Kp
Kp
Kp
Kp
Kp
CR
CR
CR
CR
CR
CR
CR
CR
CR
CR
CR
CR
CR
CR
PE
"}
(41,1,1) = {"
Kp
Kp
gk
Kp
Kp
Kp
Kp
Kp
Kp
TT
Kp
Kp
NL
JN
wj
NL
NL
NL
Oh
NL
LP
NL
Kp
Oh
Kp
TT
CR
CR
CR
CR
CR
CR
CR
CR
CR
CR
CR
PE
"}
(42,1,1) = {"
Kp
Oh
gk
Kp
Kp
Kp
Kp
Oh
Kp
Kp
Kp
Kp
Kp
Kp
gk
Kp
Kp
Kp
Kp
Kp
Kp
Kp
NL
Kp
Kp
Kp
Kp
CR
CR
CR
CR
CR
CR
CR
CR
CR
CR
PE
"}
(43,1,1) = {"
Kp
CR
JW
CR
CR
CR
CR
NL
Kp
Kp
Kp
Kp
Oh
Kp
aW
Kp
Oh
Kp
Kp
Kp
Kp
Kp
Kp
Kp
Kp
Kp
Kp
Oh
CR
CR
CR
CR
CR
CR
CR
CR
CR
PE
"}
(44,1,1) = {"
CR
CR
JW
JW
JW
JW
JW
JW
JW
JW
KJ
KJ
KJ
KJ
JW
CR
CR
Kp
CR
CR
NL
NL
CR
NL
Kp
Oh
Kp
Kp
CR
CR
CR
CR
CR
CR
CR
CR
CR
PE
"}
(45,1,1) = {"
CR
CR
CR
CR
CR
CR
CR
CR
CR
CR
Ii
Ii
Ii
Ii
CR
CR
CR
CR
CR
CR
CR
CR
CR
CR
Kp
Kp
Kp
Kp
Kp
CR
CR
CR
CR
CR
CR
CR
CR
PE
"}
(46,1,1) = {"
Vq
Vq
Vq
Vq
Vq
Vq
Vq
Vq
Vq
Vq
Vq
op
op
op
Vq
Vq
Vq
Vq
Vq
Vq
Vq
Vq
CR
CR
NL
Kp
Kp
Kp
Kp
Oh
CR
CR
CR
CR
CR
CR
CR
PE
"}
(47,1,1) = {"
iN
iN
iN
iN
iN
iN
iN
iN
iN
iN
iN
KR
KR
KR
iN
iN
iN
iN
iN
iN
iN
iN
Wa
CR
Kp
Kp
Kp
Kp
Kp
Kp
Kp
CR
CR
CR
CR
CR
CR
PE
"}
(48,1,1) = {"
qE
rV
rV
xw
iN
Fp
gG
dB
dB
TN
iN
uI
uI
uI
iN
uu
iw
uI
iN
uu
uu
uu
Wa
CR
Kp
TT
Oh
TK
Kp
Kp
Kp
CR
CR
CR
CR
CR
CR
PE
"}
(49,1,1) = {"
sP
Ly
Vm
Vm
ZR
Ot
hJ
Op
Tw
Dm
iN
LZ
Ot
LZ
iN
og
nN
xD
iN
uu
Ai
uu
Qx
NL
NL
Kp
Kp
Kp
Oh
Kp
Kp
CR
CR
CR
CR
CR
CR
PE
"}
(50,1,1) = {"
sP
Vm
Vm
DY
iN
LZ
CG
vI
tW
cQ
iN
LZ
gP
LZ
iN
LZ
LZ
LZ
iN
uu
BJ
uu
Wa
Kp
Kp
Kp
Oh
Kp
Kp
Kp
Oh
CR
CR
CR
CR
CR
CR
PE
"}
(51,1,1) = {"
RA
Vm
Vm
St
Sc
kv
DS
qZ
LZ
GM
iN
Zo
LZ
cb
iN
CE
hY
Zo
iN
Sc
hY
Sc
Wa
Kp
Oh
Kp
Kp
NL
Kp
Kp
Kp
Oh
CR
CR
CR
CR
CR
PE
"}
(52,1,1) = {"
jg
Vm
Vm
DY
Sc
xc
DS
DS
LZ
ZD
YK
eY
DS
MY
YK
LZ
LZ
eY
YK
ow
LZ
DS
Wa
Kp
Kp
Kp
Kp
YO
Kp
Kp
Kp
Kp
Kp
CR
CR
CR
CR
PE
"}
(53,1,1) = {"
RA
Vm
Vm
DY
Sc
Ck
LZ
xT
DS
LZ
LZ
LZ
Ot
DS
LZ
Kh
Ot
LZ
LZ
si
DS
Kt
lH
Kp
Kp
Kp
Kp
NL
Kp
Kp
Kp
Kp
Kp
CR
CR
CR
CR
PE
"}
(54,1,1) = {"
sP
El
oG
DY
Sc
zy
LZ
zH
DS
vI
LZ
DS
yX
DS
LZ
Od
DS
DS
LZ
Od
LZ
DS
lH
EZ
Kp
Kp
Kp
NL
Kp
Oh
Kp
Kp
Kp
CR
CR
CR
CR
PE
"}
(55,1,1) = {"
sP
Vm
Vm
DY
Sc
ve
LZ
Yn
Od
DS
vV
DS
DS
DS
DS
Od
JD
lQ
gp
LZ
xD
Ot
Jk
Kp
Oh
TT
Kp
Kp
Kp
Kp
Kp
Kp
TT
CR
CR
CR
CR
PE
"}
(56,1,1) = {"
zh
TA
TA
YI
Sc
NO
Kh
aS
LZ
ak
YK
Ot
Kh
VI
YK
rt
cg
Kr
YK
xo
LZ
xo
Wa
CR
NL
Kp
Kp
Oh
Kp
Oh
Kp
Kp
Kp
Kp
CR
CR
CR
PE
"}
(57,1,1) = {"
iN
iN
iN
iN
iN
YK
sd
ob
sd
YK
iN
Sc
hY
cb
iN
Sc
hY
Sc
iN
YN
hY
cb
Wa
CR
CR
CR
CR
Kp
Kp
Kp
Kp
Kp
Oh
Kp
CR
CR
CR
PE
"}
(58,1,1) = {"
dM
NK
NK
KK
YK
Yp
hf
DF
hf
sx
iN
LZ
LZ
LZ
iN
tn
RE
RE
iN
rB
DS
DS
Wa
CR
CR
CR
CR
Kp
CR
CR
Kp
Kp
Kp
Kp
Kp
CR
CR
PE
"}
(59,1,1) = {"
dM
pk
kq
QU
YK
Rw
oG
UT
Sm
HX
iN
LZ
LZ
fr
iN
RE
RE
RE
iN
rB
LZ
DS
Wa
CR
CR
CR
CR
CR
CR
CR
CR
Kp
Kp
Oh
Kp
CR
CR
PE
"}
(60,1,1) = {"
dM
NK
EK
uV
YK
Oz
gD
DF
gD
th
iN
Qm
Qm
Sq
iN
RE
RE
RE
iN
BZ
Qm
Qm
Wa
Vq
Vq
Vq
Vq
Vq
Vq
Vq
CR
Kp
TT
tF
Kp
CR
CR
PE
"}
(61,1,1) = {"
YK
jy
YK
YK
YK
YK
sd
kg
sd
YK
iN
iN
iN
iN
iN
iN
iN
iN
iN
iN
iN
iN
iN
iN
iN
iN
iN
iN
iN
Vq
CR
Kp
Oh
Kp
Kp
CR
CR
PE
"}
