//MAP CONVERTED BY dmm2tgm.py THIS HEADER COMMENT PREVENTS RECONVERSION, DO NOT REMOVE
"a" = (
/turf/open/space/basic,
/area/space)
"c" = (
/obj/effect/landmark/xeno_resin_door,
/turf/open/floor/plating/ground/mars/random/cave,
/area/bigredv2/caves/southeast)
"e" = (
/turf/open/floor/plating/ground/mars/random/cave/rock,
/area/bigredv2/caves/southeast)
"k" = (
/turf/open/floor/plating/ground/mars/random/cave,
/area/bigredv2/caves/east)
"r" = (
/obj/effect/landmark/weed_node,
/turf/open/floor/plating/ground/mars/random/cave,
/area/bigredv2/caves/southeast)
"s" = (
/turf/closed/wall/indestructible/mineral,
/area/space)
"v" = (
/turf/closed/mineral/bigred,
/area/bigredv2/caves/rock)
"w" = (
/obj/effect/landmark/weed_node,
/turf/open/floor/plating/ground/mars/random/cave/rock,
/area/bigredv2/caves/southeast)
"y" = (
/obj/effect/landmark/start/job/xenomorph,
/turf/open/floor/plating/ground/mars/random/cave,
/area/bigredv2/caves/southeast)
"B" = (
/turf/open/floor/plating/ground/mars/random/cave,
/area/bigredv2/caves/southeast)
"C" = (
/obj/effect/landmark/patrol_point{
	id = "TGMC_13";
	name = "TGMC exit point 13"
	},
/turf/open/floor/plating/ground/mars/random/cave,
/area/bigredv2/caves/southeast)
"H" = (
/obj/docking_port/stationary/crashmode,
/turf/closed/mineral/bigred,
/area/bigredv2/caves/rock)
"I" = (
/obj/effect/landmark/patrol_point{
	id = "TGMC_11";
	name = "TGMC exit point 11"
	},
/turf/open/floor/plating/ground/mars/random/cave,
/area/bigredv2/caves/southeast)
"K" = (
/obj/effect/landmark/start/job/xenomorph,
/obj/effect/landmark/weed_node,
/turf/open/floor/plating/ground/mars/random/cave,
/area/bigredv2/caves/southeast)
"L" = (
/obj/effect/landmark/patrol_point{
	id = "TGMC_14";
	name = "TGMC exit point 14"
	},
/turf/open/floor/plating/ground/mars/random/cave,
/area/bigredv2/caves/southeast)
"M" = (
/obj/effect/landmark/weed_node,
/obj/effect/ai_node,
/turf/open/floor/plating/ground/mars/random/cave,
/area/bigredv2/caves/southeast)
"R" = (
/obj/effect/landmark/patrol_point{
	id = "TGMC_12";
	name = "TGMC exit point 12"
	},
/turf/open/floor/plating/ground/mars/random/cave,
/area/bigredv2/caves/southeast)
"V" = (
/obj/machinery/miner/damaged/platinum,
/turf/open/floor/plating/ground/mars/random/cave,
/area/bigredv2/caves/southeast)
"W" = (
/obj/effect/ai_node,
/turf/open/floor/plating/ground/mars/random/cave/rock,
/area/bigredv2/caves/southeast)
"Z" = (
/obj/effect/ai_node,
/turf/open/floor/plating/ground/mars/random/cave,
/area/bigredv2/caves/southeast)

(1,1,1) = {"
v
v
v
v
v
v
v
v
v
v
v
v
v
v
v
v
Z
B
B
B
B
M
e
v
v
v
v
v
v
v
v
B
B
B
B
B
B
v
v
v
v
v
v
v
v
v
v
v
v
v
c
c
c
c
v
v
v
v
v
v
v
v
v
s
s
s
a
"}
(2,1,1) = {"
k
v
v
v
v
v
v
v
v
v
v
v
v
v
e
e
B
B
B
v
B
B
e
v
v
v
v
v
v
v
v
c
c
c
c
c
v
v
v
v
v
v
v
v
v
v
v
v
v
v
B
r
B
B
v
v
v
v
v
v
v
v
v
s
a
a
a
"}
(3,1,1) = {"
v
v
v
v
v
v
v
v
v
v
v
v
v
v
B
B
B
B
B
v
e
B
e
v
v
v
v
v
v
v
v
B
B
B
B
B
v
v
v
v
v
v
v
v
v
v
v
v
v
v
e
B
e
B
v
v
v
v
v
v
v
v
v
s
a
a
a
"}
(4,1,1) = {"
v
v
v
v
v
v
v
v
v
v
v
v
v
W
B
B
M
B
v
v
v
B
e
v
v
v
v
v
v
v
v
r
B
y
B
r
v
v
v
v
v
v
v
v
v
v
v
v
v
v
B
B
B
B
v
v
v
v
v
v
v
v
v
s
a
a
a
"}
(5,1,1) = {"
v
v
v
v
v
v
v
v
v
v
v
v
v
B
r
e
B
B
v
v
v
B
e
v
v
v
v
v
v
v
v
B
B
Z
B
B
v
v
v
v
v
v
v
v
v
v
v
v
v
v
B
B
Z
r
v
v
v
v
v
v
v
v
v
s
a
a
a
"}
(6,1,1) = {"
v
v
v
v
v
v
v
v
v
v
v
e
e
B
B
e
B
B
v
v
v
B
e
v
v
v
v
v
v
v
v
B
B
B
e
B
v
v
H
v
v
v
v
v
v
v
v
v
v
v
B
r
B
B
v
v
v
v
v
v
v
v
v
s
a
a
a
"}
(7,1,1) = {"
v
v
v
v
v
v
v
v
v
v
v
B
B
B
e
B
B
v
v
v
v
B
e
v
v
v
v
v
v
v
v
e
B
r
B
B
v
v
v
v
v
v
v
v
v
v
v
v
v
Z
B
B
Z
B
v
v
v
v
v
v
v
v
v
s
a
a
a
"}
(8,1,1) = {"
v
v
v
v
v
v
v
v
v
v
v
B
B
M
B
v
v
v
v
v
v
B
e
v
v
v
v
v
v
v
v
B
B
B
B
B
v
v
v
v
v
v
v
v
v
v
v
v
B
B
r
e
B
B
v
v
v
v
v
v
v
v
v
s
a
a
a
"}
(9,1,1) = {"
v
v
v
v
v
v
v
v
v
v
v
B
W
B
B
v
v
v
v
v
v
B
e
v
v
v
v
v
v
v
v
B
B
r
B
B
v
v
v
v
v
v
v
v
v
v
v
v
B
B
e
e
B
r
v
v
v
v
v
v
v
v
v
s
a
a
a
"}
(10,1,1) = {"
v
v
v
v
v
v
v
v
v
v
e
B
e
B
B
v
v
v
v
B
B
Z
w
v
v
v
v
v
v
v
B
B
B
B
B
v
v
v
v
v
v
v
v
v
v
B
B
B
B
B
B
r
B
v
v
v
v
v
v
v
v
v
v
s
a
a
a
"}
(11,1,1) = {"
v
v
v
v
v
v
v
v
v
v
B
B
e
B
e
e
e
e
e
B
B
B
e
v
v
v
v
v
v
B
B
B
B
Z
B
v
v
v
v
v
v
v
B
e
B
B
B
w
B
B
B
B
B
v
v
v
v
v
v
v
v
v
v
s
a
a
a
"}
(12,1,1) = {"
H
v
v
v
v
v
v
v
v
v
B
K
B
e
B
B
B
B
e
B
r
B
B
B
v
v
v
B
Z
B
B
B
Z
B
B
v
v
v
v
v
B
B
Z
e
B
w
B
B
B
Z
v
v
v
v
v
v
v
v
v
v
v
v
v
s
a
a
a
"}
(13,1,1) = {"
v
v
v
v
v
v
v
v
v
v
B
B
B
B
B
r
Z
B
r
B
B
B
B
B
B
B
B
B
B
B
B
B
r
B
B
v
v
e
B
B
B
r
B
B
B
B
e
B
B
v
v
v
v
v
v
v
v
v
v
v
v
v
v
s
a
a
a
"}
(14,1,1) = {"
e
B
v
v
v
v
v
v
v
e
B
B
B
B
B
Z
B
B
B
B
B
W
B
r
B
B
B
B
M
B
B
Z
e
B
B
B
B
B
B
B
B
e
B
B
B
r
B
v
v
v
v
v
v
v
v
v
v
v
v
v
v
v
v
s
a
a
a
"}
(15,1,1) = {"
W
v
v
v
v
v
v
v
v
B
Z
B
Z
r
B
B
Z
B
B
e
v
B
B
B
B
B
B
B
B
B
B
B
Z
B
B
e
r
Z
B
e
e
B
Z
v
v
v
v
v
v
v
v
v
v
v
v
v
v
v
v
v
v
v
v
s
a
a
a
"}
(16,1,1) = {"
e
v
v
v
v
v
v
e
e
B
e
B
B
B
B
B
B
B
B
v
v
v
v
B
r
B
B
B
B
B
B
B
B
B
B
B
B
B
B
r
B
v
v
v
v
v
v
v
v
v
v
v
v
v
v
v
v
v
v
v
v
v
v
s
a
a
a
"}
(17,1,1) = {"
B
v
v
v
v
v
v
B
B
B
e
B
B
B
v
v
v
v
v
v
v
v
v
v
v
v
B
B
B
B
B
B
B
B
B
B
v
v
v
v
v
v
v
v
v
v
v
v
v
v
v
v
v
v
v
v
v
v
v
v
v
v
v
s
a
a
a
"}
(18,1,1) = {"
B
v
v
v
v
v
v
e
B
e
B
B
B
v
v
v
v
v
v
v
v
v
v
v
v
v
B
B
B
B
r
B
B
B
B
B
v
v
v
v
v
v
v
v
v
v
v
v
v
v
v
v
v
v
v
v
v
v
v
v
v
v
v
s
a
a
a
"}
(19,1,1) = {"
B
v
v
v
v
v
B
B
B
e
B
v
v
v
v
v
v
v
v
v
v
v
v
v
v
B
B
B
Z
B
B
B
B
Z
B
B
v
v
v
v
v
v
v
v
v
v
v
v
v
v
v
v
v
v
v
v
v
v
v
v
v
v
v
s
a
a
a
"}
(20,1,1) = {"
B
v
v
B
B
B
Z
B
B
B
Z
v
v
v
v
v
v
v
v
B
B
B
B
B
B
B
B
B
B
B
r
B
B
e
B
B
v
v
v
v
v
v
v
v
v
v
v
v
v
v
v
v
v
v
v
v
v
v
v
v
v
v
v
s
a
a
a
"}
(21,1,1) = {"
B
B
B
B
B
B
B
B
e
B
v
v
v
v
v
v
v
v
v
B
Z
B
B
B
Z
B
r
B
Z
B
B
B
e
B
B
B
B
v
v
v
v
v
v
v
v
v
v
v
v
v
v
v
v
v
v
v
v
v
v
v
v
v
v
s
a
a
a
"}
(22,1,1) = {"
Z
B
B
B
e
e
B
B
B
B
v
v
v
v
v
v
v
B
B
B
B
B
B
B
B
B
e
B
B
B
V
B
B
r
B
B
B
v
v
v
v
v
v
v
v
v
v
v
v
v
v
v
v
v
v
v
v
v
v
v
v
v
v
s
a
a
a
"}
(23,1,1) = {"
V
Z
B
e
B
B
Z
B
B
v
v
v
v
v
B
B
B
B
e
B
B
B
e
B
B
B
e
B
B
B
B
B
B
B
B
B
v
v
v
v
v
v
v
v
v
v
v
v
v
v
v
v
v
v
v
v
v
v
v
v
v
v
v
s
a
a
a
"}
(24,1,1) = {"
B
e
w
B
B
B
B
e
v
v
v
v
v
v
B
B
B
B
B
B
B
B
B
B
B
B
B
B
B
B
B
B
B
B
B
B
v
v
v
v
v
v
v
v
v
v
v
v
v
v
v
v
v
v
v
v
v
v
v
v
v
v
v
s
a
a
a
"}
(25,1,1) = {"
e
B
B
e
v
v
v
v
v
v
v
v
B
B
W
B
B
B
r
B
Z
B
B
B
Z
B
B
B
r
Z
B
B
B
B
B
B
v
v
v
v
v
v
v
v
v
v
v
v
v
v
v
v
v
v
v
v
v
v
v
v
v
v
v
s
a
a
a
"}
(26,1,1) = {"
B
B
B
e
v
v
v
v
v
v
v
v
r
B
B
B
B
B
B
B
B
B
r
e
v
B
B
B
Z
B
B
r
B
Z
B
v
v
v
v
v
v
v
v
v
v
v
v
v
v
v
v
v
v
v
v
v
v
v
v
v
v
v
v
s
a
a
a
"}
(27,1,1) = {"
v
v
v
v
v
v
v
v
v
v
B
Z
B
B
Z
B
B
r
B
B
B
B
B
v
v
v
B
B
B
B
B
B
B
B
B
v
v
v
v
v
v
v
v
v
v
v
v
v
v
v
v
v
v
v
v
v
v
v
v
v
v
v
v
s
a
a
a
"}
(28,1,1) = {"
v
v
v
v
v
v
v
v
v
B
B
e
B
B
B
B
B
B
B
B
B
B
B
v
v
v
B
B
B
e
B
B
B
B
v
v
v
v
v
v
v
v
v
v
v
v
v
v
v
v
v
v
v
v
v
v
v
v
v
v
v
v
v
s
a
a
a
"}
(29,1,1) = {"
v
v
v
v
v
v
v
v
v
B
B
B
B
e
B
B
B
r
B
B
v
v
v
v
v
v
B
B
B
B
B
B
B
v
v
v
v
v
v
v
v
v
v
v
v
v
v
v
v
v
v
v
v
v
v
v
v
v
v
v
v
v
v
s
a
a
a
"}
(30,1,1) = {"
v
v
v
v
v
v
v
v
v
B
B
r
r
B
B
B
B
B
B
B
v
v
v
v
v
v
v
v
B
B
B
B
v
v
v
v
v
v
v
v
v
v
v
v
v
v
v
v
v
v
v
v
v
v
v
v
v
v
v
v
v
v
v
s
a
a
a
"}
(31,1,1) = {"
v
v
v
v
v
v
v
Z
B
B
B
B
B
B
Z
e
B
v
v
v
v
v
v
v
v
v
v
v
v
B
B
v
v
v
v
v
v
v
v
v
v
v
v
v
v
v
v
v
v
v
v
v
v
v
v
v
v
v
v
v
v
v
v
s
a
a
a
"}
(32,1,1) = {"
B
B
v
v
v
v
v
C
B
B
e
B
e
B
B
B
B
v
v
v
v
v
v
v
v
v
v
v
v
v
v
v
v
v
v
v
v
v
v
v
v
v
v
v
v
v
v
v
v
v
v
v
v
v
v
v
v
v
v
v
v
v
v
s
a
a
a
"}
(33,1,1) = {"
Z
B
r
B
Z
v
v
B
B
B
B
B
B
B
B
v
v
v
v
v
v
v
v
v
v
v
v
v
v
v
v
v
v
v
v
v
v
v
v
v
v
v
v
v
v
v
v
v
v
v
v
v
v
v
v
v
v
v
v
v
v
v
v
s
a
a
a
"}
(34,1,1) = {"
B
B
B
B
B
B
B
B
B
B
B
B
B
B
v
v
v
v
v
v
v
v
v
v
v
v
v
v
v
v
v
v
v
v
v
v
v
v
v
v
v
v
v
v
v
v
v
v
v
v
v
v
v
v
v
v
v
v
v
v
v
v
v
s
a
a
a
"}
(35,1,1) = {"
B
B
B
B
B
e
B
B
e
r
B
B
B
v
v
v
v
v
v
v
v
v
v
v
v
v
v
v
v
v
v
v
v
v
v
v
v
v
v
v
v
v
v
v
v
v
v
v
v
v
v
v
v
v
v
v
v
v
v
v
v
v
v
s
a
a
a
"}
(36,1,1) = {"
B
B
B
B
B
B
B
B
B
B
B
B
v
v
v
v
v
v
v
v
v
v
v
v
v
v
v
v
v
v
v
v
v
v
v
v
v
v
v
v
v
v
v
v
v
v
v
v
v
v
v
v
v
v
v
v
v
v
v
v
v
v
v
s
a
a
a
"}
(37,1,1) = {"
Z
e
B
B
Z
r
B
Z
B
B
B
Z
v
v
v
v
v
v
v
v
v
v
v
v
v
v
v
v
v
v
v
v
v
v
v
v
v
v
v
v
v
v
v
v
v
v
v
v
v
v
v
v
v
v
v
v
v
v
v
v
v
v
v
s
a
a
a
"}
(38,1,1) = {"
v
v
B
B
B
B
B
B
B
B
B
B
B
B
v
v
v
v
v
v
v
v
v
v
v
v
v
v
v
v
v
v
v
v
v
v
v
v
v
v
v
v
v
v
v
v
v
v
v
v
v
v
v
v
v
v
v
v
v
v
v
v
v
s
a
a
a
"}
(39,1,1) = {"
v
v
B
B
B
e
B
Z
e
B
e
B
B
B
Z
B
Z
B
v
v
v
v
v
v
v
v
v
v
v
v
v
v
v
v
v
v
v
v
v
v
v
v
v
v
v
v
v
v
v
v
v
v
v
v
v
v
v
v
v
v
v
v
v
s
a
a
a
"}
(40,1,1) = {"
v
v
B
B
B
B
B
e
B
B
B
B
B
B
B
B
B
B
B
v
v
v
v
v
v
v
v
v
v
v
v
v
v
v
v
v
v
v
v
v
v
v
v
v
v
v
v
v
v
v
v
v
v
v
v
v
v
v
v
v
v
v
v
s
a
a
a
"}
(41,1,1) = {"
B
B
B
B
B
B
B
B
B
B
r
r
e
B
B
B
r
B
B
B
v
v
v
v
v
v
v
v
v
v
v
v
v
v
v
v
v
v
v
v
v
v
v
v
v
v
v
v
v
v
v
v
v
v
v
v
v
v
v
v
v
v
v
s
a
a
a
"}
(42,1,1) = {"
B
B
B
B
B
r
B
B
B
B
B
B
B
B
B
B
Z
r
B
B
Z
v
v
v
v
v
v
v
v
v
v
v
v
v
v
v
v
v
v
v
v
v
v
v
v
v
v
v
v
v
v
v
v
v
v
v
v
v
v
v
v
v
v
s
a
a
a
"}
(43,1,1) = {"
B
e
B
r
B
B
B
B
e
B
B
B
B
B
B
V
B
B
e
B
B
v
v
v
v
v
v
v
v
v
v
v
v
v
v
v
v
v
v
v
v
v
v
v
v
v
v
v
v
v
v
v
v
v
v
v
v
v
v
v
v
v
v
s
a
a
a
"}
(44,1,1) = {"
B
B
B
B
B
B
B
r
B
B
B
e
r
B
B
B
B
e
B
B
B
I
v
v
v
v
v
v
v
v
v
v
v
v
v
v
v
v
v
v
v
v
v
v
v
v
v
v
v
v
v
v
v
v
v
v
v
v
v
v
v
v
v
s
a
a
a
"}
(45,1,1) = {"
B
Z
B
B
B
B
e
Z
B
B
B
B
B
B
M
B
B
B
B
B
Z
B
v
v
v
v
v
v
v
v
v
v
v
v
v
v
s
s
s
s
s
s
s
s
s
s
s
s
s
s
s
s
s
s
s
s
s
s
s
s
s
s
s
s
a
a
a
"}
(46,1,1) = {"
B
B
B
B
e
B
B
B
B
v
B
B
B
B
B
B
B
B
B
r
e
B
v
v
v
v
v
v
v
v
v
v
v
v
v
v
s
a
a
a
a
a
a
a
a
a
a
a
a
a
a
a
a
a
a
a
a
a
a
a
a
a
a
a
a
a
a
"}
(47,1,1) = {"
B
B
r
B
B
B
B
B
L
v
v
v
R
B
B
B
e
B
r
B
B
B
v
v
v
v
v
v
v
v
v
v
v
v
v
v
s
a
a
a
a
a
a
a
a
a
a
a
a
a
a
a
a
a
a
a
a
a
a
a
a
a
a
a
a
a
a
"}
(48,1,1) = {"
B
B
B
B
B
B
B
v
v
v
v
v
v
v
v
B
Z
B
B
B
Z
B
v
v
v
v
v
v
v
v
v
v
v
v
v
v
s
a
a
a
a
a
a
a
a
a
a
a
a
a
a
a
a
a
a
a
a
a
a
a
a
a
a
a
a
a
a
"}
(49,1,1) = {"
B
Z
B
B
B
B
v
v
v
v
v
v
v
v
v
v
v
B
B
B
B
B
v
v
v
v
v
v
v
v
v
v
v
v
v
v
s
a
a
a
a
a
a
a
a
a
a
a
a
a
a
a
a
a
a
a
a
a
a
a
a
a
a
a
a
a
a
"}
(50,1,1) = {"
B
B
B
v
v
v
v
v
v
v
v
v
v
v
v
v
v
v
v
B
B
v
v
v
v
v
v
v
v
v
v
v
v
v
v
v
s
a
a
a
a
a
a
a
a
a
a
a
a
a
a
a
a
a
a
a
a
a
a
a
a
a
a
a
a
a
a
"}
(51,1,1) = {"
B
B
B
v
v
v
v
v
v
v
v
v
v
v
v
v
v
v
v
v
v
v
v
v
v
v
v
v
v
v
v
v
v
v
v
v
s
a
a
a
a
a
a
a
a
a
a
a
a
a
a
a
a
a
a
a
a
a
a
a
a
a
a
a
a
a
a
"}
(52,1,1) = {"
v
v
v
v
v
v
v
v
v
v
v
v
v
v
v
v
v
v
v
v
v
v
v
v
v
v
v
v
v
v
v
v
v
v
v
v
s
a
a
a
a
a
a
a
a
a
a
a
a
a
a
a
a
a
a
a
a
a
a
a
a
a
a
a
a
a
a
"}
(53,1,1) = {"
v
v
v
v
v
v
v
v
v
v
v
v
v
v
v
v
v
v
v
v
v
v
v
v
v
v
v
v
v
v
v
v
v
v
v
v
s
a
a
a
a
a
a
a
a
a
a
a
a
a
a
a
a
a
a
a
a
a
a
a
a
a
a
a
a
a
a
"}
(54,1,1) = {"
v
v
v
v
v
v
v
v
v
v
v
v
v
v
v
v
v
v
v
v
v
v
v
v
v
v
v
v
v
v
v
v
v
v
v
v
s
a
a
a
a
a
a
a
a
a
a
a
a
a
a
a
a
a
a
a
a
a
a
a
a
a
a
a
a
a
a
"}
(55,1,1) = {"
v
v
v
v
v
v
v
v
v
v
v
v
v
v
v
v
v
v
v
v
v
v
v
v
v
v
v
v
v
v
v
v
v
v
v
v
s
a
a
a
a
a
a
a
a
a
a
a
a
a
a
a
a
a
a
a
a
a
a
a
a
a
a
a
a
a
a
"}
(56,1,1) = {"
v
v
v
v
v
v
v
v
v
v
v
v
v
v
v
v
v
v
v
v
v
v
v
v
v
v
v
v
v
v
v
v
v
v
v
v
s
a
a
a
a
a
a
a
a
a
a
a
a
a
a
a
a
a
a
a
a
a
a
a
a
a
a
a
a
a
a
"}
(57,1,1) = {"
v
v
v
v
v
v
v
v
v
v
v
v
v
v
v
v
v
v
v
v
v
v
v
v
v
v
v
v
v
v
v
v
v
v
v
v
s
a
a
a
a
a
a
a
a
a
a
a
a
a
a
a
a
a
a
a
a
a
a
a
a
a
a
a
a
a
a
"}
(58,1,1) = {"
v
v
v
v
v
v
v
v
v
v
v
v
v
v
v
v
v
v
v
v
v
v
v
v
v
v
v
v
v
v
v
v
v
v
v
v
s
a
a
a
a
a
a
a
a
a
a
a
a
a
a
a
a
a
a
a
a
a
a
a
a
a
a
a
a
a
a
"}
(59,1,1) = {"
v
v
v
v
v
v
v
v
v
v
v
v
v
v
v
v
v
v
v
v
v
v
v
v
v
v
v
v
v
v
v
v
v
v
v
v
s
a
a
a
a
a
a
a
a
a
a
a
a
a
a
a
a
a
a
a
a
a
a
a
a
a
a
a
a
a
a
"}
(60,1,1) = {"
v
v
v
v
v
v
v
v
v
v
v
v
v
v
v
v
v
v
v
v
v
v
v
v
v
v
v
v
v
v
v
v
v
v
v
v
s
a
a
a
a
a
a
a
a
a
a
a
a
a
a
a
a
a
a
a
a
a
a
a
a
a
a
a
a
a
a
"}
(61,1,1) = {"
v
v
v
v
v
v
v
v
v
v
v
v
v
v
v
v
v
v
v
v
v
v
v
v
v
v
v
v
v
v
v
v
v
v
v
v
s
a
a
a
a
a
a
a
a
a
a
a
a
a
a
a
a
a
a
a
a
a
a
a
a
a
a
a
a
a
a
"}
(62,1,1) = {"
v
v
v
v
v
v
v
v
v
v
v
v
v
v
v
v
v
v
v
v
v
v
v
v
v
v
v
v
v
v
v
v
v
v
v
v
s
a
a
a
a
a
a
a
a
a
a
a
a
a
a
a
a
a
a
a
a
a
a
a
a
a
a
a
a
a
a
"}
(63,1,1) = {"
s
s
s
s
s
s
s
s
s
s
s
s
s
s
s
s
s
s
s
s
s
s
s
s
s
s
s
s
s
s
s
s
s
s
s
s
s
a
a
a
a
a
a
a
a
a
a
a
a
a
a
a
a
a
a
a
a
a
a
a
a
a
a
a
a
a
a
"}
(64,1,1) = {"
a
a
a
a
a
a
a
a
a
a
a
a
a
a
a
a
a
a
a
a
a
a
a
a
a
a
a
a
a
a
a
a
a
a
a
a
a
a
a
a
a
a
a
a
a
a
a
a
a
a
a
a
a
a
a
a
a
a
a
a
a
a
a
a
a
a
a
"}
(65,1,1) = {"
a
a
a
a
a
a
a
a
a
a
a
a
a
a
a
a
a
a
a
a
a
a
a
a
a
a
a
a
a
a
a
a
a
a
a
a
a
a
a
a
a
a
a
a
a
a
a
a
a
a
a
a
a
a
a
a
a
a
a
a
a
a
a
a
a
a
a
"}
(66,1,1) = {"
a
a
a
a
a
a
a
a
a
a
a
a
a
a
a
a
a
a
a
a
a
a
a
a
a
a
a
a
a
a
a
a
a
a
a
a
a
a
a
a
a
a
a
a
a
a
a
a
a
a
a
a
a
a
a
a
a
a
a
a
a
a
a
a
a
a
a
"}
(67,1,1) = {"
a
a
a
a
a
a
a
a
a
a
a
a
a
a
a
a
a
a
a
a
a
a
a
a
a
a
a
a
a
a
a
a
a
a
a
a
a
a
a
a
a
a
a
a
a
a
a
a
a
a
a
a
a
a
a
a
a
a
a
a
a
a
a
a
a
a
a
"}
(68,1,1) = {"
a
a
a
a
a
a
a
a
a
a
a
a
a
a
a
a
a
a
a
a
a
a
a
a
a
a
a
a
a
a
a
a
a
a
a
a
a
a
a
a
a
a
a
a
a
a
a
a
a
a
a
a
a
a
a
a
a
a
a
a
a
a
a
a
a
a
a
"}
(69,1,1) = {"
a
a
a
a
a
a
a
a
a
a
a
a
a
a
a
a
a
a
a
a
a
a
a
a
a
a
a
a
a
a
a
a
a
a
a
a
a
a
a
a
a
a
a
a
a
a
a
a
a
a
a
a
a
a
a
a
a
a
a
a
a
a
a
a
a
a
a
"}
(70,1,1) = {"
a
a
a
a
a
a
a
a
a
a
a
a
a
a
a
a
a
a
a
a
a
a
a
a
a
a
a
a
a
a
a
a
a
a
a
a
a
a
a
a
a
a
a
a
a
a
a
a
a
a
a
a
a
a
a
a
a
a
a
a
a
a
a
a
a
a
a
"}
(71,1,1) = {"
a
a
a
a
a
a
a
a
a
a
a
a
a
a
a
a
a
a
a
a
a
a
a
a
a
a
a
a
a
a
a
a
a
a
a
a
a
a
a
a
a
a
a
a
a
a
a
a
a
a
a
a
a
a
a
a
a
a
a
a
a
a
a
a
a
a
a
"}
