//MAP CONVERTED BY dmm2tgm.py THIS HEADER COMMENT PREVENTS RECONVERSION, DO NOT REMOVE
"aa" = (
/turf/open/floor/plating/ground/mars/random/cave/rock,
/area/bigredv2/caves/east/garbledradio)
"ab" = (
/turf/open/floor/plating/ground/mars/random/cave,
/area/bigredv2/caves/east/garbledradio)
"ac" = (
/obj/effect/landmark/weed_node,
/turf/open/floor/plating/ground/mars/random/cave,
/area/bigredv2/caves/east/garbledradio)
"ad" = (
/obj/effect/ai_node,
/turf/open/floor/plating/ground/mars/random/cave,
/area/bigredv2/caves/east/garbledradio)
"ae" = (
/turf/closed/mineral/smooth/bigred/indestructible,
/area/space)
"af" = (
/obj/machinery/miner/damaged/platinum,
/turf/open/floor/plating/ground/mars/random/cave,
/area/bigredv2/caves/east/garbledradio)
"ag" = (
/obj/machinery/miner/damaged/platinum,
/turf/open/floor/plating/ground/mars/random/cave,
/area/bigredv2/caves/east)
"ah" = (
/obj/effect/landmark/weed_node,
/turf/open/floor/plating/ground/mars/random/cave/rock,
/area/bigredv2/caves/east/garbledradio)
"ai" = (
/obj/effect/landmark/xeno_resin_door,
/turf/open/floor/plating/ground/mars/random/cave,
/area/bigredv2/caves/east/garbledradio)
"aj" = (
/obj/effect/landmark/lv624/fog_blocker,
/turf/closed/mineral/smooth/bigred,
/area/bigredv2/caves/rock)
"ak" = (
/obj/structure/fence,
/obj/effect/landmark/lv624/fog_blocker,
/turf/open/floor/plating/ground/mars/random/cave,
/area/bigredv2/caves/east/garbledradio)
"am" = (
/obj/docking_port/stationary/crashmode,
/turf/open/floor/plating/ground/mars/random/cave,
/area/bigredv2/caves/east/garbledradio)
"ao" = (
/turf/open/floor/plating/ground/mars/random/sand,
/area/bigredv2/outside/se)
"aq" = (
/obj/effect/landmark/lv624/fog_blocker/xeno_spawn,
/obj/effect/landmark/lv624/fog_blocker/xeno_spawn,
/turf/closed/mineral/smooth/bigred,
/area/bigredv2/caves/rock)
"at" = (
/obj/effect/landmark/lv624/fog_blocker/xeno_spawn,
/turf/closed/mineral/smooth/bigred,
/area/bigredv2/caves/rock)
"ay" = (
/turf/open/floor/plating/ground/mars/random/cave/rock,
/area/bigredv2/caves/east)
"az" = (
/obj/effect/landmark/lv624/fog_blocker/xeno_spawn,
/turf/open/floor/plating/ground/mars/random/cave/rock,
/area/bigredv2/caves/east/garbledradio)
"aC" = (
/obj/effect/landmark/xeno_resin_door,
/turf/open/floor/plating/ground/mars/random/cave,
/area/bigredv2/caves/east)
"aD" = (
/obj/effect/landmark/xeno_resin_wall,
/turf/open/floor/plating/ground/mars/random/cave,
/area/bigredv2/caves/east/garbledradio)
"aF" = (
/obj/docking_port/stationary/crashmode,
/turf/closed/mineral/smooth/bigred,
/area/bigredv2/caves/rock)
"aG" = (
/obj/effect/ai_node,
/turf/open/floor/plating/ground/mars/random/cave,
/area/bigredv2/caves/east)
"aH" = (
/obj/effect/landmark/weed_node,
/turf/open/floor/plating/ground/mars/random/cave,
/area/bigredv2/caves/east)
"aI" = (
/obj/effect/landmark/lv624/fog_blocker/xeno_spawn,
/turf/open/floor/plating/ground/mars/random/cave,
/area/bigredv2/caves/east/garbledradio)
"aK" = (
/obj/effect/landmark/lv624/fog_blocker/xeno_spawn,
/obj/effect/ai_node,
/turf/open/floor/plating/ground/mars/random/cave,
/area/bigredv2/caves/east/garbledradio)
"aM" = (
/obj/effect/landmark/xeno_silo_spawn,
/turf/open/floor/plating/ground/mars/random/cave,
/area/bigredv2/caves/east/garbledradio)
"aN" = (
/turf/closed/mineral/smooth/bigred,
/area/bigredv2/caves/rock)
"aP" = (
/obj/effect/landmark/weed_node,
/turf/open/floor/plating/ground/mars/random/cave/rock,
/area/bigredv2/caves/east)
"aR" = (
/obj/effect/landmark/excavation_site_spawner,
/turf/open/floor/plating/ground/mars/random/cave,
/area/bigredv2/caves/east)
"aT" = (
/turf/open/floor/plating/ground/mars/random/cave,
/area/bigredv2/caves/east)
"aU" = (
/obj/effect/landmark/xeno_resin_door,
/obj/effect/ai_node,
/turf/open/floor/plating/ground/mars/random/cave,
/area/bigredv2/caves/east/garbledradio)
"aV" = (
/obj/effect/landmark/weed_node,
/obj/effect/ai_node,
/turf/open/floor/plating/ground/mars/random/cave,
/area/bigredv2/caves/east/garbledradio)
"aX" = (
/obj/effect/landmark/lv624/fog_blocker/xeno_spawn,
/obj/effect/landmark/xeno_resin_wall,
/turf/open/floor/plating/ground/mars/random/cave,
/area/bigredv2/caves/east/garbledradio)
"aY" = (
/obj/effect/landmark/lv624/fog_blocker/xeno_spawn,
/obj/effect/landmark/lv624/fog_blocker/xeno_spawn,
/turf/open/floor/plating/ground/mars/random/cave,
/area/bigredv2/caves/east/garbledradio)
"aZ" = (
/obj/effect/ai_node,
/turf/open/floor/plating/ground/mars/random/cave/rock,
/area/bigredv2/caves/east/garbledradio)
"hE" = (
/obj/effect/ai_node,
/turf/open/floor/plating/ground/mars/random/sand,
/area/bigredv2/outside/se)
"vG" = (
/obj/effect/landmark/xeno_resin_door,
/turf/open/floor/plating/ground/mars/random/cave/rock,
/area/bigredv2/caves/east/garbledradio)
"zv" = (
/obj/effect/landmark/weed_node,
/turf/open/floor/plating/ground/mars/random/sand,
/area/bigredv2/outside/se)
"GC" = (
/obj/effect/landmark/xeno_tunnel_spawn,
/turf/open/floor/plating/ground/mars/random/cave/rock,
/area/bigredv2/caves/east/garbledradio)
"Hg" = (
/obj/effect/landmark/xeno_tunnel_spawn,
/turf/open/floor/plating/ground/mars/random/cave,
/area/bigredv2/caves/east/garbledradio)

(1,1,1) = {"
ao
ao
ao
ao
ao
ao
ao
ao
ao
ao
ao
aN
aN
aN
ak
ab
ac
ab
ab
ac
ab
ab
ab
ab
ab
ac
ab
ab
aN
aN
aN
aN
aN
aN
aN
aN
aN
ab
ac
ab
ab
ac
"}
(2,1,1) = {"
ao
ao
zv
ao
ao
ao
zv
ao
ao
ao
ao
aN
aN
aN
aj
ab
ab
ab
ab
ab
ab
ab
ab
ab
ab
ab
ab
ab
aN
aN
aN
aN
aN
aN
aN
aN
aN
aN
ab
ab
ad
ab
"}
(3,1,1) = {"
ao
ao
ao
ao
ao
ao
ao
ao
ao
ao
ao
aN
aN
aN
aj
ab
ab
ab
ab
ab
ab
aN
aN
aN
aN
aN
ab
ab
ab
aN
aN
aN
aN
aN
aN
aN
aN
aN
ab
ab
ab
ab
"}
(4,1,1) = {"
ao
aN
aN
aN
aN
ao
ao
ao
zv
ao
ao
zv
aN
aN
aj
ab
ab
ab
ac
ab
ab
aN
aN
aN
aN
aN
aa
ab
ab
ab
ab
ac
ab
ab
ab
aN
aa
aa
ab
ab
ab
ab
"}
(5,1,1) = {"
ao
aN
aN
aN
aN
aN
aN
ao
ao
ao
ao
ao
ao
aN
aj
aN
ab
aY
aI
aI
at
at
at
at
at
at
aI
az
aY
ab
ab
ab
ab
ab
ac
aa
ab
ab
ac
ab
ab
ac
"}
(6,1,1) = {"
ao
ao
aN
aN
aN
aN
aN
aN
ao
ao
ao
ao
ao
aN
aj
aN
aN
aI
ab
aN
aN
aN
aN
aN
aN
ab
ab
ab
az
ah
ad
ab
ab
ab
ab
ab
ab
ab
ab
ab
ad
aa
"}
(7,1,1) = {"
ao
ao
ao
ao
ao
ao
ao
ao
ao
ao
ao
ao
ao
aN
aj
aN
aN
aX
aD
aD
ab
aN
ab
aN
aN
ab
ad
ab
aI
ad
ab
ab
ac
ab
ab
ab
ab
ac
ab
af
ab
aa
"}
(8,1,1) = {"
ao
zv
ao
ao
zv
ao
ao
ao
zv
ao
ao
zv
ao
aN
aj
aN
aN
at
ab
ab
ab
aV
ab
ab
aU
ad
ab
ab
aI
ab
ab
ab
ab
ab
ab
ab
aa
ab
ab
ab
aa
aN
"}
(9,1,1) = {"
ao
ao
ao
ao
ao
hE
ao
ao
ao
hE
ao
ao
ao
aN
aj
aN
aN
at
ab
ab
ab
ab
ab
ab
ai
ab
ab
aN
at
aN
aN
aN
ab
ab
ab
ab
ac
aa
ab
ab
ab
aa
"}
(10,1,1) = {"
ao
ao
ao
ao
ao
ao
ao
ao
ao
ao
ao
ao
aN
aN
aj
aN
aN
at
aN
aN
ab
ab
ab
ab
aD
aN
aN
aN
at
aN
aN
aN
aN
aN
aN
aN
ab
ab
ab
ac
ac
aa
"}
(11,1,1) = {"
ao
ao
aN
ao
ao
ao
ao
ao
ao
ao
ao
aN
aN
aN
aj
aN
aN
at
aN
ab
ab
ab
ab
ab
aD
aD
aN
aN
at
aN
aN
aN
aN
aN
aN
aN
ab
ab
ab
ab
ab
aa
"}
(12,1,1) = {"
ao
aN
aN
ao
zv
ao
ao
ao
zv
aN
aN
aN
aN
aN
aj
aN
aN
at
ab
aa
ab
ab
ah
ac
ab
ab
aN
aN
at
aN
aN
aN
aN
aN
aN
aN
ab
ab
ab
ac
ab
aa
"}
(13,1,1) = {"
aN
aN
aN
ao
ao
ao
ao
ao
ao
aN
aN
aN
aN
aN
aj
aN
aN
at
ab
ac
ab
ab
ab
ab
ab
ab
aN
aN
at
aN
aN
aN
aN
aN
aN
aN
aa
ab
ac
ab
aa
aN
"}
(14,1,1) = {"
aN
aN
ao
ao
ao
ao
ao
ao
ao
aN
aN
aN
aN
aN
aj
aN
aN
at
ab
ab
ab
ad
aM
ab
ab
ac
ab
aN
at
aN
aN
aN
aN
aN
aN
aN
ab
ab
ac
ab
ad
aa
"}
(15,1,1) = {"
aN
ao
ao
ao
ao
ao
aN
aN
aN
aN
aN
aN
aN
aN
aj
aN
aN
at
Hg
ab
ab
ab
ab
ab
ac
ab
aN
aN
at
aN
aN
aN
aN
aN
aN
aN
aN
aa
ab
ab
ab
aa
"}
(16,1,1) = {"
zv
ao
ao
ao
zv
hE
aN
aN
aN
aN
aN
aN
aN
aN
aj
aN
aN
at
aN
aN
aN
ab
ab
ab
ab
aN
aN
aN
at
aN
aN
aN
aN
aN
aN
aN
aN
aN
ai
ai
ai
ai
"}
(17,1,1) = {"
ao
ao
ao
ao
ao
ao
aN
aN
aN
aN
aN
aN
aN
aN
aj
aN
aN
at
aN
aN
aN
aN
aN
aN
aN
aN
aN
aN
at
aN
aN
aN
aN
aN
aN
aN
aN
aN
ab
ab
ab
ab
"}
(18,1,1) = {"
aN
aN
aN
aN
aN
aN
aN
aN
aN
aN
aN
aN
aN
aN
aj
aN
aN
aq
at
at
at
at
at
at
at
at
at
at
aq
aN
aN
aN
aN
aN
aN
aN
ab
ab
ab
ab
ab
ab
"}
(19,1,1) = {"
aj
aj
aj
aj
aj
aj
aj
aj
aj
aj
aj
aj
aj
aj
aj
aN
aN
aN
aN
aN
aN
aN
aN
aN
aN
aN
aN
aN
aN
aN
aN
aN
aN
aN
aN
ab
ab
ab
ab
ac
ab
ab
"}
(20,1,1) = {"
aN
aN
aN
aN
aN
aN
aN
aN
aN
aN
aN
aN
aN
aN
aN
aN
aN
aN
aN
aN
aN
aN
aN
aN
aN
aF
aN
aN
aN
aN
aN
aN
aN
aN
ab
ab
ab
ab
ab
ab
ab
ab
"}
(21,1,1) = {"
aN
aN
aN
aN
aN
aN
aN
aN
aN
aN
aN
aN
aN
aN
aN
aN
aN
aN
aN
aN
aN
aN
aN
aN
aN
aN
aN
aN
aN
aN
aN
aN
ab
ab
ab
ac
ab
ab
ab
aa
ab
ab
"}
(22,1,1) = {"
aN
aa
aa
aa
aa
aa
aN
aN
aN
aN
aN
aN
aN
aN
aN
aN
aN
aN
aN
aN
aN
aN
aa
aa
aa
aa
aa
aN
aN
aN
ab
ab
ab
ad
ab
ab
ab
ab
ab
ab
ad
ab
"}
(23,1,1) = {"
aN
ad
ab
ac
ab
ab
aZ
aN
aN
aN
aN
aN
aN
aN
aN
aN
aN
aN
aZ
aa
aa
aa
ab
ab
ad
ab
ab
aa
ah
ab
ab
ab
ad
ac
ab
ab
aa
aN
aN
ab
ac
ab
"}
(24,1,1) = {"
aN
aa
ab
ab
ab
ab
aa
aN
aN
aN
aN
aN
aN
aN
aN
aN
aN
aN
ab
ab
ab
ab
ab
ab
ab
ac
ab
ab
ab
ab
aa
ab
ab
aa
ab
ab
aa
aN
aN
ab
ab
ab
"}
(25,1,1) = {"
aN
aN
aN
aa
ab
ab
aa
ab
ab
ab
ab
aN
aN
aN
aN
aN
aN
aa
ab
ab
ab
ab
ab
ab
ab
ab
ab
ab
ab
ab
ab
ab
aa
ab
ab
aa
aN
aN
aN
ab
ab
ab
"}
(26,1,1) = {"
aN
aN
aN
aN
aN
ab
aa
ab
ab
ab
ab
aN
aN
aN
aN
aa
aa
ab
ab
ab
ac
ab
ab
ac
ab
ab
ab
ab
ab
ab
ac
ab
ab
ab
aa
aN
aN
aN
aN
ab
ad
ab
"}
(27,1,1) = {"
aa
aa
aa
aa
aa
ab
aa
ac
ab
ab
ab
ab
ai
ab
ab
ab
ab
ab
ab
ab
ab
ab
ab
ab
ab
ab
ac
ab
ab
ab
ab
ab
ab
ab
ab
aa
aN
aa
aa
ab
ab
ab
"}
(28,1,1) = {"
ab
ab
ab
ab
ab
ab
ad
aa
aa
aa
aa
aa
vG
aa
ab
ab
aZ
ab
ad
ab
ab
ab
ab
ab
ab
af
ab
ab
ab
ab
ac
ab
ab
ab
ab
ab
aa
ab
ab
ab
ab
ab
"}
(29,1,1) = {"
ab
ab
ab
ac
ab
ab
ab
ab
ab
ab
ac
ab
ai
ab
ab
ab
aa
ab
ab
aa
ab
ab
ab
ab
ab
ab
ab
ab
ab
ab
ab
ab
ab
ab
ac
ab
ab
ab
ab
ac
ab
ab
"}
(30,1,1) = {"
ab
ab
ab
ab
ab
ab
ab
ab
ab
ab
ab
ab
ai
ab
ab
ab
aZ
ab
ab
ab
ab
ab
ab
ab
ad
aa
ab
ab
ab
ab
ac
ab
ab
ad
ab
ab
ab
ab
ab
ab
aZ
aN
"}
(31,1,1) = {"
ac
ab
ab
ab
ab
ab
ab
ab
ab
ab
ab
aa
aN
aN
ab
ab
aa
aI
aI
aI
aI
aI
aI
aI
aI
aK
aI
aI
aI
ab
ab
ab
ab
ab
ab
ab
ab
ab
ab
ab
aa
aN
"}
(32,1,1) = {"
aa
ab
ab
ab
ab
ab
ab
aN
aN
aN
aN
aN
aN
aN
aN
ab
aa
aI
aD
aD
aD
aD
aD
aD
aD
ai
ai
aD
aX
ab
ab
ab
ab
ab
ab
ab
ac
ab
ab
aa
ab
aN
"}
(33,1,1) = {"
ab
ab
ab
ac
af
ab
ab
aN
aN
aN
aN
aN
aN
aN
aN
ab
aa
aI
aD
ab
ad
ab
ab
ab
ab
ab
ab
ab
at
aN
aN
aN
aN
aN
ab
ab
ab
ab
aa
ab
ab
ab
"}
(34,1,1) = {"
aa
ab
ab
aa
ab
ab
ab
aN
aN
aN
aN
aN
aN
aN
aa
ab
ab
aI
aD
ab
ab
ab
ab
ab
ab
ab
ab
aN
at
aN
aN
aN
aN
aN
ac
ab
ab
ab
aa
ab
ab
ab
"}
(35,1,1) = {"
aN
aa
ab
ab
ab
ab
ab
ab
aN
aN
aN
aN
aN
aa
ab
ab
ab
aI
aD
ab
ab
ab
aM
ab
ac
ab
ab
aa
at
aN
aN
aN
aN
aN
aN
aN
aN
aN
aN
ai
ai
ai
"}
(36,1,1) = {"
aN
aN
aN
ab
ab
aa
ab
ab
ab
aN
aN
aN
aa
ab
ab
ab
ab
aI
aD
ab
ab
ab
ab
ab
ab
ab
ab
aa
at
aN
aN
aN
aN
aN
aN
aN
aN
aN
aN
aN
ad
ab
"}
(37,1,1) = {"
aN
aN
aN
ab
ab
ah
ad
ab
am
aa
ab
ab
ab
ab
ab
ab
aZ
at
aN
ab
ab
ac
ab
ab
ab
ac
ab
aa
at
aN
aN
aN
aN
aN
aN
aN
aN
aN
aN
aN
ab
ab
"}
(38,1,1) = {"
aN
aN
aN
ab
ab
ab
ab
ab
ab
ab
ab
ab
ab
ab
ab
aa
aa
at
aN
ab
ad
ab
ab
ab
ac
ad
aa
aN
at
aN
aN
aN
aN
aN
aN
aN
aN
aN
aN
aN
aN
ab
"}
(39,1,1) = {"
aN
aN
aN
aN
ab
ab
ab
ab
ab
ab
ab
ab
ab
ac
ab
aN
aN
at
aN
aN
aa
ab
ab
ab
ab
GC
aN
aN
at
aN
aN
aN
aN
aN
aN
aN
aN
aN
aN
aN
aN
aN
"}
(40,1,1) = {"
aN
aN
aN
aN
ab
ab
ab
ab
ab
ab
ab
ab
ab
ab
ab
aN
aN
at
at
at
aN
aN
aN
aN
aN
aN
aN
at
at
aN
aN
aN
aN
aN
aN
aN
aN
aN
aN
aN
aN
aN
"}
(41,1,1) = {"
aN
aN
aN
ab
ab
ab
ab
ab
ab
ab
ab
ab
ab
ab
aN
aN
aN
aN
aN
aN
at
at
at
at
at
at
at
aN
aN
aN
aN
aN
aN
aN
aN
aN
aN
aN
aN
aN
aN
aN
"}
(42,1,1) = {"
aN
aN
aN
ab
ab
ab
ac
ab
ab
aN
aN
aN
aN
aN
aN
aN
aN
aN
aN
aN
aN
aN
aN
aN
aN
aN
aN
aN
aN
aN
aN
aN
aN
aN
aN
aN
aN
aN
aN
aN
aN
aN
"}
(43,1,1) = {"
aN
aN
ab
ab
ab
ab
ab
ab
ab
aN
aN
aN
aN
aN
aN
aN
aN
aN
aN
aN
aN
aN
aN
aN
aN
aN
aN
aN
aN
aN
aN
aN
aN
aN
aN
aN
aN
aN
aN
aN
aN
aN
"}
(44,1,1) = {"
aN
aN
aC
aC
aC
aC
aC
aC
aN
aN
aN
aN
aN
aN
aN
aN
aN
aN
aN
aN
aN
aN
aN
aN
aN
aN
aN
aN
aN
aN
aN
aN
aN
aN
aN
aN
aN
aN
aN
aN
aN
aN
"}
(45,1,1) = {"
aN
aN
aT
aT
aT
aT
aT
aT
aN
aN
aN
aN
aN
aN
aN
aN
aN
aN
aN
aN
aN
aN
aN
aN
aN
aN
aN
aN
aN
aN
aN
aN
aN
aN
aN
aN
aN
aN
aN
aN
aN
aN
"}
(46,1,1) = {"
aT
aT
aT
aT
aT
aH
aT
aT
aN
aN
aN
aN
aN
aN
aN
aN
aN
aN
aN
aN
aN
aN
aN
aN
aN
aN
aN
aN
aN
aN
aN
aN
aN
aN
aT
aT
aT
aT
aT
aT
aT
aT
"}
(47,1,1) = {"
aT
aT
aG
aT
aT
aT
aG
aN
aN
aN
aN
aN
aN
aN
aN
aN
aN
aN
aN
aN
aN
aN
aN
aN
aN
aN
aN
aN
aN
aN
aN
aN
aN
aN
aT
aT
aT
aT
aT
aT
aT
aT
"}
(48,1,1) = {"
aT
aT
aH
aT
aT
aT
aT
aN
aN
aN
aN
aN
aN
aN
aN
aN
aN
aN
aN
aN
aN
aN
aN
aN
aN
aN
aN
aN
aN
aN
aN
aN
aN
aT
aT
aT
aT
aT
aT
aG
aT
aT
"}
(49,1,1) = {"
aT
aT
aG
aT
aH
aT
aN
aN
aN
aN
aN
aN
aN
aN
aN
aN
aN
aN
aN
aN
aN
aN
aN
aN
aN
aN
aN
aN
aN
aN
aN
aN
aN
aT
aT
aT
aH
aT
aT
aT
aH
aT
"}
(50,1,1) = {"
aT
aT
aT
aT
aT
aT
aN
aN
aN
aN
aN
aN
aN
aN
aN
aN
aN
aN
aN
aN
aT
aT
aT
aT
aT
aT
aT
aT
aT
aT
aT
aT
aT
aT
aT
aT
aT
aT
aT
aT
aT
aT
"}
(51,1,1) = {"
aT
aT
aT
aT
aT
aT
aN
aN
aN
aN
aN
aN
aN
aN
aN
aN
aN
aN
aN
aN
aT
aT
aT
aT
aT
aT
aT
aT
aT
aT
aT
aT
aT
aT
aT
aT
aT
aT
aT
aT
aT
aT
"}
(52,1,1) = {"
aT
aP
aT
aT
aT
aH
aN
aN
aN
aT
aT
aT
aT
aT
aT
aT
aT
aT
aT
aT
aT
aT
aT
aT
aT
aT
aT
aT
aT
aT
aG
aH
aT
aT
aT
aT
aR
aT
aH
aG
aT
aT
"}
(53,1,1) = {"
aT
aT
aT
aT
aT
aT
aN
aN
aN
aT
aT
aT
aT
aT
aT
aH
aT
aH
aT
aT
aT
aT
aT
ay
aH
aT
aT
aT
aT
aT
aT
aT
aT
aT
ay
aT
aT
aT
aT
aT
aT
aT
"}
(54,1,1) = {"
aT
aT
aT
aT
aT
aT
aT
aT
aT
aT
aT
aT
aT
aT
aT
aT
aT
aT
aT
aR
aH
aT
aT
aT
aT
aT
aT
ag
aT
aT
aT
aT
aT
aT
aT
aT
aT
aT
aT
aT
aT
aT
"}
(55,1,1) = {"
aH
aT
aG
aT
aT
aH
aT
aT
aT
aT
aT
aH
aG
aT
aT
aH
aT
aT
aT
aT
aG
aT
aT
aT
aT
aH
aT
aT
aT
aT
aG
aT
aT
aT
aT
aT
aT
aT
aT
aT
aT
aT
"}
(56,1,1) = {"
aT
aT
aT
aT
aT
aT
aT
aT
aT
aT
aT
ay
aT
aT
aT
aT
aT
aT
aT
aT
aT
aT
aT
aT
aT
aT
aT
aT
aT
aT
aT
aH
aT
aT
aN
aN
aN
aN
aN
aN
aN
aN
"}
(57,1,1) = {"
aT
aT
aT
aN
aT
aT
aT
aT
aT
aT
aT
aT
aT
aT
aT
aT
aT
aP
aT
aT
aT
aT
aT
aT
aT
aT
aT
aT
aT
aT
aT
aT
aT
aT
aN
aN
aN
aN
aN
aN
aN
aN
"}
(58,1,1) = {"
aT
aT
aT
aN
aN
aN
aN
aN
aN
aT
aT
aT
aT
aT
aT
aT
aT
aT
aT
aT
aT
aT
aT
aT
aT
aT
aN
aN
aN
aN
aN
aN
aN
aN
aN
aN
aN
aN
aN
aN
aN
aN
"}
(59,1,1) = {"
aT
aT
aN
aN
aN
aN
aN
aN
aN
aT
aT
aT
aT
aT
aT
aT
aT
aT
aT
aT
aT
aT
aT
aT
aT
aT
aN
aN
aN
aN
aN
aN
aN
aN
aN
aN
aN
aN
aN
aN
aN
aN
"}
(60,1,1) = {"
aN
aN
aN
aN
aN
aN
aN
aN
aN
aN
aN
aN
aN
aT
aT
aT
aT
aT
aN
aN
aN
aN
aN
aN
aN
aN
aN
aN
aN
aN
aN
aN
aN
aN
aN
aN
aN
aN
aN
aN
aN
aN
"}
(61,1,1) = {"
aN
aN
aN
aN
aN
aN
aN
aN
aN
aN
aN
aN
aN
aN
aN
aN
aN
aN
aN
aN
aN
aN
aN
aN
aN
aN
aN
aN
aN
aN
aN
aN
aN
aN
aN
aN
aN
aN
aN
aN
aN
aN
"}
(62,1,1) = {"
at
at
aN
aN
aN
aN
aN
aN
aN
aN
aN
aN
aN
aN
aN
aN
aN
aN
aN
aN
aN
aN
aN
aN
aN
aN
aN
aN
aN
aN
aN
aN
aN
aN
aN
aN
aN
aN
aN
aN
aN
aN
"}
(63,1,1) = {"
aN
at
at
aN
aN
aN
aN
aN
aN
aN
aN
aN
aN
aN
aN
aN
aN
aN
aN
aN
aN
aN
aN
aN
aN
aN
aN
aN
aN
aN
aN
aN
aN
aN
aN
aN
aN
aN
aN
aN
aN
aN
"}
(64,1,1) = {"
aN
aN
at
aN
aN
aN
aN
aN
aN
aN
aN
aN
aN
aN
aN
aN
aN
aN
aN
aN
aN
aN
aN
aN
aN
aN
aN
aN
aN
aN
aN
aN
aN
aN
aN
aN
aN
aN
aN
aN
aN
aN
"}
(65,1,1) = {"
aN
aN
at
aN
aN
aN
aN
aN
aN
aN
aN
aN
aN
aN
aN
aN
aN
aN
aN
aN
aN
aN
aN
aN
aN
aN
aN
aN
aN
aN
aN
aN
aN
aN
aN
aN
aN
aN
aN
aN
aN
aN
"}
(66,1,1) = {"
aT
aN
ae
ae
ae
ae
ae
ae
ae
ae
ae
ae
ae
ae
ae
ae
ae
ae
ae
ae
ae
ae
ae
ae
ae
ae
ae
ae
ae
ae
ae
ae
ae
ae
ae
ae
ae
ae
ae
ae
ae
ae
"}
