//MAP CONVERTED BY dmm2tgm.py THIS HEADER COMMENT PREVENTS RECONVERSION, DO NOT REMOVE
"c" = (
/obj/effect/ai_node,
/turf/open/floor/plating/ground/mars/random/cave,
/area/bigredv2/caves/southwest)
"j" = (
/obj/effect/ai_node,
/turf/open/floor/plating/ground/mars/random/cave/rock,
/area/bigredv2/caves/southwest)
"p" = (
/obj/effect/landmark/weed_node,
/turf/open/floor/plating/ground/mars/random/cave/rock,
/area/bigredv2/caves/southwest)
"r" = (
/turf/open/floor/plating/ground/mars/random/cave,
/area/bigredv2/caves/southwest)
"t" = (
/turf/open/floor/plating/ground/mars/random/cave/rock,
/area/bigredv2/caves/southwest)
"u" = (
/obj/effect/landmark/lv624/fog_blocker,
/obj/effect/ai_node,
/turf/open/floor/plating/ground/mars/random/cave,
/area/bigredv2/caves/south)
"x" = (
/turf/open/floor/plating,
/area/bigredv2/caves/south)
"y" = (
/obj/effect/landmark/lv624/fog_blocker,
/turf/closed/mineral/smooth/bigred,
/area/bigredv2/caves/rock)
"z" = (
/obj/effect/landmark/lv624/fog_blocker,
/turf/open/floor/plating/ground/mars/random/cave,
/area/bigredv2/caves/southwest)
"A" = (
/obj/effect/landmark/weed_node,
/turf/open/floor/plating/ground/mars/random/cave,
/area/bigredv2/caves/south)
"B" = (
/obj/effect/landmark/weed_node,
/obj/effect/ai_node,
/turf/open/floor/plating/ground/mars/random/cave,
/area/bigredv2/caves/south)
"G" = (
/turf/closed/mineral/smooth/bigred,
/area/bigredv2/caves/rock)
"H" = (
/obj/machinery/miner/damaged/platinum,
/turf/open/floor/plating/ground/mars/random/cave,
/area/bigredv2/caves/south)
"J" = (
/turf/open/floor/plating/ground/mars/random/cave,
/area/bigredv2/caves/south)
"K" = (
/obj/effect/landmark/weed_node,
/turf/open/floor/plating/ground/mars/random/cave,
/area/bigredv2/caves/southwest)
"L" = (
/turf/open/floor/plating/ground/mars/random/cave/rock,
/area/bigredv2/caves/south)
"M" = (
/obj/effect/landmark/weed_node,
/turf/open/floor/plating/ground/mars/random/cave/rock,
/area/bigredv2/caves/south)
"Q" = (
/obj/effect/ai_node,
/turf/open/floor/plating/ground/mars/random/cave,
/area/bigredv2/caves/south)
"T" = (
/obj/effect/landmark/lv624/fog_blocker,
/turf/open/floor/plating/ground/mars/random/cave,
/area/bigredv2/caves/south)
"V" = (
/obj/effect/landmark/excavation_site_spawner,
/obj/effect/ai_node,
/turf/open/floor/plating/ground/mars/random/cave,
/area/bigredv2/caves/south)
"Z" = (
/obj/effect/landmark/lv624/fog_blocker,
/obj/effect/landmark/weed_node,
/turf/open/floor/plating/ground/mars/random/cave/rock,
/area/bigredv2/caves/southwest)

(1,1,1) = {"
y
G
G
G
G
G
t
r
r
r
t
G
G
G
G
r
K
G
G
G
G
G
"}
(2,1,1) = {"
z
G
G
G
G
G
G
r
c
K
t
G
G
G
G
r
r
r
G
G
G
G
"}
(3,1,1) = {"
z
G
G
G
G
G
G
r
r
r
t
G
G
G
t
r
r
G
G
G
G
G
"}
(4,1,1) = {"
z
G
G
G
G
G
r
r
K
r
t
G
G
G
t
r
K
G
G
G
G
G
"}
(5,1,1) = {"
z
t
G
G
G
G
r
r
r
r
r
G
G
t
r
r
r
G
G
G
G
G
"}
(6,1,1) = {"
z
t
G
G
t
t
r
K
r
r
r
G
G
r
K
c
G
G
G
G
G
G
"}
(7,1,1) = {"
z
K
t
j
r
r
r
r
c
r
G
G
G
r
c
G
G
G
G
G
G
G
"}
(8,1,1) = {"
z
r
r
t
r
r
r
r
r
G
G
G
r
K
r
G
G
G
G
G
G
G
"}
(9,1,1) = {"
z
p
r
r
K
r
r
G
G
G
G
G
r
r
r
G
G
G
G
G
G
G
"}
(10,1,1) = {"
Z
r
r
c
G
G
G
G
G
G
G
G
r
r
r
G
G
r
G
G
G
G
"}
(11,1,1) = {"
y
G
G
G
G
G
G
G
G
G
G
G
r
K
r
r
r
r
G
G
G
G
"}
(12,1,1) = {"
G
y
G
G
G
G
G
G
G
G
G
G
r
r
r
r
K
r
G
G
G
G
"}
(13,1,1) = {"
G
G
y
y
G
G
G
G
G
G
G
G
r
r
K
r
r
G
G
G
G
G
"}
(14,1,1) = {"
G
G
G
G
y
G
G
G
G
G
G
G
r
r
r
r
G
G
G
G
G
G
"}
(15,1,1) = {"
G
G
G
G
G
y
G
G
G
G
G
G
G
r
r
t
G
G
G
G
G
G
"}
(16,1,1) = {"
G
G
G
G
G
G
y
G
G
G
G
G
G
r
c
t
t
G
G
G
G
G
"}
(17,1,1) = {"
r
G
G
G
G
G
y
G
G
G
G
G
G
r
p
t
G
G
G
G
G
G
"}
(18,1,1) = {"
K
c
G
G
G
G
y
G
G
G
G
G
G
r
r
r
G
G
G
G
G
G
"}
(19,1,1) = {"
r
r
G
G
G
G
y
G
G
G
G
G
r
r
r
r
r
G
G
G
G
G
"}
(20,1,1) = {"
t
r
G
G
G
G
y
G
G
G
r
r
r
r
K
t
K
G
G
G
G
G
"}
(21,1,1) = {"
t
r
r
G
G
G
y
G
G
G
r
r
r
r
r
t
r
G
G
G
G
G
"}
(22,1,1) = {"
K
r
r
r
K
G
y
G
G
G
K
r
r
r
r
G
G
G
G
G
G
G
"}
(23,1,1) = {"
r
r
r
r
r
G
y
G
G
G
r
r
K
r
r
G
G
G
G
G
G
G
"}
(24,1,1) = {"
r
r
r
r
r
G
y
r
r
r
r
r
r
r
r
G
G
G
G
G
G
G
"}
(25,1,1) = {"
r
r
r
r
r
c
z
r
r
r
r
t
K
r
c
G
G
G
G
G
G
G
"}
(26,1,1) = {"
A
J
J
J
A
J
T
J
J
J
J
J
J
L
G
G
G
G
G
G
G
G
"}
(27,1,1) = {"
J
Q
J
J
J
Q
T
J
J
G
G
G
G
G
G
G
G
G
G
G
G
G
"}
(28,1,1) = {"
L
J
J
J
J
J
y
G
G
G
G
G
G
G
G
G
G
G
G
G
G
G
"}
(29,1,1) = {"
L
A
J
J
J
G
y
G
G
G
G
G
G
G
G
G
J
Q
J
J
G
G
"}
(30,1,1) = {"
J
J
J
J
A
G
y
G
G
G
G
G
G
G
G
G
J
J
A
J
J
G
"}
(31,1,1) = {"
J
J
A
J
J
G
y
G
G
G
G
G
G
G
G
J
J
J
J
J
J
G
"}
(32,1,1) = {"
J
J
J
J
J
G
y
G
G
G
G
G
G
G
G
J
J
A
J
J
J
J
"}
(33,1,1) = {"
J
J
J
J
J
G
y
G
G
G
G
G
G
G
G
G
J
J
J
J
A
J
"}
(34,1,1) = {"
L
J
J
J
G
G
y
G
G
G
G
G
G
G
G
G
G
Q
J
J
Q
J
"}
(35,1,1) = {"
L
J
A
J
G
G
y
G
G
G
G
G
G
G
G
G
G
J
J
J
L
J
"}
(36,1,1) = {"
L
J
J
J
G
G
y
G
G
G
G
G
G
G
G
G
G
G
J
A
J
J
"}
(37,1,1) = {"
J
J
J
J
G
G
y
G
G
G
G
G
G
G
G
G
G
G
J
J
J
J
"}
(38,1,1) = {"
J
Q
J
J
J
J
u
G
G
G
G
G
G
G
G
G
G
A
J
J
J
J
"}
(39,1,1) = {"
J
J
A
J
J
J
T
J
J
G
G
G
G
G
G
J
J
J
J
Q
J
J
"}
(40,1,1) = {"
J
J
J
J
J
J
T
J
J
J
J
G
G
G
A
J
J
J
H
J
B
J
"}
(41,1,1) = {"
J
J
J
G
G
J
u
J
J
J
J
J
Q
J
J
J
J
J
L
J
J
J
"}
(42,1,1) = {"
J
J
G
G
G
G
y
J
J
J
J
J
J
J
J
J
J
J
J
V
J
J
"}
(43,1,1) = {"
J
G
G
G
G
G
y
G
G
G
G
J
Q
J
L
B
J
J
Q
M
G
G
"}
(44,1,1) = {"
G
G
G
G
G
G
y
G
G
G
G
G
J
L
x
J
J
L
G
G
G
G
"}
