//MAP CONVERTED BY dmm2tgm.py THIS HEADER COMMENT PREVENTS RECONVERSION, DO NOT REMOVE
"a" = (
/turf/closed/mineral/bigred,
/area/bigredv2/caves/rock)
"d" = (
/atom/movable/effect/landmark/lv624/fog_blocker,
/atom/movable/effect/landmark/weed_node,
/turf/open/floor/plating/ground/mars/random/cave/rock,
/area/bigredv2/caves/southwest)
"g" = (
/atom/movable/effect/landmark/weed_node,
/turf/open/floor/plating/ground/mars/random/cave/rock,
/area/bigredv2/caves/southwest)
"i" = (
/atom/movable/effect/ai_node,
/turf/open/floor/plating/ground/mars/random/cave/rock,
/area/bigredv2/caves/southwest)
"k" = (
/atom/movable/effect/landmark/excavation_site_spawner,
/atom/movable/effect/ai_node,
/turf/open/floor/plating/ground/mars/random/cave,
/area/bigredv2/caves/south)
"l" = (
/atom/movable/effect/landmark/weed_node,
/turf/open/floor/plating/ground/mars/random/cave/rock,
/area/bigredv2/caves/south)
"m" = (
/atom/movable/effect/landmark/weed_node,
/turf/open/floor/plating/ground/mars/random/cave,
/area/bigredv2/caves/south)
"n" = (
/atom/movable/effect/landmark/weed_node,
/atom/movable/effect/ai_node,
/turf/open/floor/plating/ground/mars/random/cave,
/area/bigredv2/caves/south)
"o" = (
/atom/movable/effect/landmark/weed_node,
/turf/open/floor/plating/ground/mars/random/cave,
/area/bigredv2/caves/southwest)
"r" = (
/turf/open/floor/plating/ground/mars/random/cave,
/area/bigredv2/caves/southwest)
"t" = (
/turf/open/floor/plating/ground/mars/random/cave/rock,
/area/bigredv2/caves/southwest)
"w" = (
/atom/movable/effect/landmark/lv624/fog_blocker,
/turf/open/floor/plating/ground/mars/random/cave,
/area/bigredv2/caves/south)
"x" = (
/turf/open/floor/plating,
/area/bigredv2/caves/south)
"E" = (
/atom/movable/effect/landmark/lv624/fog_blocker,
/atom/movable/effect/ai_node,
/turf/open/floor/plating/ground/mars/random/cave,
/area/bigredv2/caves/south)
"H" = (
/obj/machinery/miner/damaged/platinum,
/turf/open/floor/plating/ground/mars/random/cave,
/area/bigredv2/caves/south)
"J" = (
/turf/open/floor/plating/ground/mars/random/cave,
/area/bigredv2/caves/south)
"L" = (
/turf/open/floor/plating/ground/mars/random/cave/rock,
/area/bigredv2/caves/south)
"N" = (
/atom/movable/effect/landmark/lv624/fog_blocker,
/turf/closed/mineral/bigred,
/area/bigredv2/caves/rock)
"O" = (
/atom/movable/effect/ai_node,
/turf/open/floor/plating/ground/mars/random/cave,
/area/bigredv2/caves/southwest)
"S" = (
/atom/movable/effect/ai_node,
/turf/open/floor/plating/ground/mars/random/cave,
/area/bigredv2/caves/south)
"U" = (
/atom/movable/effect/landmark/lv624/fog_blocker,
/turf/open/floor/plating/ground/mars/random/cave,
/area/bigredv2/caves/southwest)

(1,1,1) = {"
N
a
a
a
a
a
t
r
r
r
t
a
a
a
a
r
o
a
a
a
a
a
"}
(2,1,1) = {"
U
a
a
a
a
a
a
r
O
o
t
a
a
a
a
r
r
r
a
a
a
a
"}
(3,1,1) = {"
U
a
a
a
a
a
a
r
r
r
t
a
a
a
t
r
r
a
a
a
a
a
"}
(4,1,1) = {"
U
a
a
a
a
a
r
r
o
r
t
a
a
a
t
r
o
a
a
a
a
a
"}
(5,1,1) = {"
U
t
a
a
a
a
r
r
r
r
r
a
a
t
r
r
r
a
a
a
a
a
"}
(6,1,1) = {"
U
t
a
a
t
t
r
o
r
r
r
a
a
r
o
O
a
a
a
a
a
a
"}
(7,1,1) = {"
U
o
t
i
r
r
r
r
O
r
a
a
a
r
O
a
a
a
a
a
a
a
"}
(8,1,1) = {"
U
r
r
t
r
r
r
r
r
a
a
a
r
o
r
a
a
a
a
a
a
a
"}
(9,1,1) = {"
U
g
r
r
o
r
r
a
a
a
a
a
r
r
r
a
a
a
a
a
a
a
"}
(10,1,1) = {"
d
r
r
O
a
a
a
a
a
a
a
a
r
r
r
a
a
r
a
a
a
a
"}
(11,1,1) = {"
N
a
a
a
a
a
a
a
a
a
a
a
r
o
r
r
r
r
a
a
a
a
"}
(12,1,1) = {"
a
N
a
a
a
a
a
a
a
a
a
a
r
r
r
r
o
r
a
a
a
a
"}
(13,1,1) = {"
a
a
N
N
a
a
a
a
a
a
a
a
r
r
o
r
r
a
a
a
a
a
"}
(14,1,1) = {"
a
a
a
a
N
a
a
a
a
a
a
a
r
r
r
r
a
a
a
a
a
a
"}
(15,1,1) = {"
a
a
a
a
a
N
a
a
a
a
a
a
a
r
r
t
a
a
a
a
a
a
"}
(16,1,1) = {"
a
a
a
a
a
a
N
a
a
a
a
a
a
r
O
t
t
a
a
a
a
a
"}
(17,1,1) = {"
r
a
a
a
a
a
N
a
a
a
a
a
a
r
g
t
a
a
a
a
a
a
"}
(18,1,1) = {"
o
O
a
a
a
a
N
a
a
a
a
a
a
r
r
r
a
a
a
a
a
a
"}
(19,1,1) = {"
r
r
a
a
a
a
N
a
a
a
a
a
r
r
r
r
r
a
a
a
a
a
"}
(20,1,1) = {"
t
r
a
a
a
a
N
a
a
a
r
r
r
r
o
t
o
a
a
a
a
a
"}
(21,1,1) = {"
t
r
r
a
a
a
N
a
a
a
r
r
r
r
r
t
r
a
a
a
a
a
"}
(22,1,1) = {"
o
r
r
r
o
a
N
a
a
a
o
r
r
r
r
a
a
a
a
a
a
a
"}
(23,1,1) = {"
r
r
r
r
r
a
N
a
a
a
r
r
o
r
r
a
a
a
a
a
a
a
"}
(24,1,1) = {"
r
r
r
r
r
a
N
r
r
r
r
r
r
r
r
a
a
a
a
a
a
a
"}
(25,1,1) = {"
r
r
r
r
r
O
U
r
r
r
r
t
o
r
O
a
a
a
a
a
a
a
"}
(26,1,1) = {"
m
J
J
J
m
J
w
J
J
J
J
J
J
L
a
a
a
a
a
a
a
a
"}
(27,1,1) = {"
J
S
J
J
J
S
w
J
J
a
a
a
a
a
a
a
a
a
a
a
a
a
"}
(28,1,1) = {"
L
J
J
J
J
J
N
a
a
a
a
a
a
a
a
a
a
a
a
a
a
a
"}
(29,1,1) = {"
L
m
J
J
J
a
N
a
a
a
a
a
a
a
a
a
J
S
J
J
a
a
"}
(30,1,1) = {"
J
J
J
J
m
a
N
a
a
a
a
a
a
a
a
a
J
J
m
J
J
a
"}
(31,1,1) = {"
J
J
m
J
J
a
N
a
a
a
a
a
a
a
a
J
J
J
J
J
J
a
"}
(32,1,1) = {"
J
J
J
J
J
a
N
a
a
a
a
a
a
a
a
J
J
m
J
J
J
J
"}
(33,1,1) = {"
J
J
J
J
J
a
N
a
a
a
a
a
a
a
a
a
J
J
J
J
m
J
"}
(34,1,1) = {"
L
J
J
J
a
a
N
a
a
a
a
a
a
a
a
a
a
S
J
J
S
J
"}
(35,1,1) = {"
L
J
m
J
a
a
N
a
a
a
a
a
a
a
a
a
a
J
J
J
L
J
"}
(36,1,1) = {"
L
J
J
J
a
a
N
a
a
a
a
a
a
a
a
a
a
a
J
m
J
J
"}
(37,1,1) = {"
J
J
J
J
a
a
N
a
a
a
a
a
a
a
a
a
a
a
J
J
J
J
"}
(38,1,1) = {"
J
S
J
J
J
J
E
a
a
a
a
a
a
a
a
a
a
m
J
J
J
J
"}
(39,1,1) = {"
J
J
m
J
J
J
w
J
J
a
a
a
a
a
a
J
J
J
J
S
J
J
"}
(40,1,1) = {"
J
J
J
J
J
J
w
J
J
J
J
a
a
a
m
J
J
J
H
J
n
J
"}
(41,1,1) = {"
J
J
J
a
a
J
E
J
J
J
J
J
S
J
J
J
J
J
L
J
J
J
"}
(42,1,1) = {"
J
J
a
a
a
a
N
J
J
J
J
J
J
J
J
J
J
J
J
k
J
J
"}
(43,1,1) = {"
J
a
a
a
a
a
N
a
a
a
a
J
S
J
L
n
J
J
S
l
a
a
"}
(44,1,1) = {"
a
a
a
a
a
a
N
a
a
a
a
a
J
L
x
J
J
L
a
a
a
a
"}
