//MAP CONVERTED BY dmm2tgm.py THIS HEADER COMMENT PREVENTS RECONVERSION, DO NOT REMOVE
"a" = (
/turf/open/space/basic,
/area/space)
"b" = (
/obj/effect/landmark/xeno_silo_spawn,
/turf/open/floor/plating/ground/mars/random/cave,
/area/bigredv2/caves/southeast)
"d" = (
/obj/effect/landmark/xeno_resin_wall,
/turf/open/floor/plating/ground/mars/random/cave,
/area/bigredv2/caves/southeast)
"e" = (
/obj/effect/ai_node,
/turf/open/floor/plating/ground/mars/random/cave,
/area/bigredv2/caves/southeast/garbledradio)
"f" = (
/obj/effect/landmark/weed_node,
/turf/open/floor/plating/ground/mars/random/cave,
/area/bigredv2/caves/southeast)
"h" = (
/turf/open/floor/plating/ground/mars/random/cave,
/area/bigredv2/caves/southeast)
"i" = (
/obj/effect/landmark/lv624/fog_blocker/xeno_spawn,
/turf/closed/mineral/smooth/bigred,
/area/bigredv2/caves/rock)
"j" = (
/obj/docking_port/stationary/crashmode,
/turf/closed/mineral/smooth/bigred,
/area/bigredv2/caves/rock)
"k" = (
/obj/effect/landmark/start/job/xenomorph,
/turf/open/floor/plating/ground/mars/random/cave,
/area/bigredv2/caves/southeast)
"o" = (
/obj/effect/landmark/patrol_point/tgmc_13,
/turf/open/floor/plating/ground/mars/random/cave,
/area/bigredv2/caves/southeast)
"p" = (
/obj/machinery/miner/damaged/platinum,
/turf/open/floor/plating/ground/mars/random/cave,
/area/bigredv2/caves/southeast)
"s" = (
/obj/machinery/miner/damaged/platinum,
/turf/open/floor/plating/ground/mars/random/cave,
/area/bigredv2/caves/southeast/garbledradio)
"t" = (
/obj/effect/landmark/lv624/fog_blocker/xeno_spawn,
/turf/open/floor/plating/ground/mars/random/cave,
/area/bigredv2/caves/southeast)
"u" = (
/turf/closed/mineral/smooth/bigred,
/area/bigredv2/caves/rock)
"v" = (
/obj/effect/landmark/weed_node,
/turf/open/floor/plating/ground/mars/random/cave,
/area/bigredv2/caves/southeast/garbledradio)
"x" = (
/turf/open/floor/plating/ground/mars/random/cave/rock,
/area/bigredv2/caves/southeast/garbledradio)
"A" = (
/obj/effect/ai_node,
/turf/open/floor/plating/ground/mars/random/cave,
/area/bigredv2/caves/southeast)
"C" = (
/obj/effect/ai_node,
/turf/open/floor/plating/ground/mars/random/cave/rock,
/area/bigredv2/caves/southeast/garbledradio)
"E" = (
/obj/effect/landmark/patrol_point/tgmc_12,
/turf/open/floor/plating/ground/mars/random/cave,
/area/bigredv2/caves/southeast)
"F" = (
/turf/open/floor/plating/ground/mars/random/cave,
/area/bigredv2/caves/east)
"H" = (
/turf/closed/mineral/smooth/bigred/indestructible,
/area/bigredv2/caves/rock)
"I" = (
/obj/effect/landmark/patrol_point/tgmc_11,
/turf/open/floor/plating/ground/mars/random/cave,
/area/bigredv2/caves/southeast)
"L" = (
/obj/effect/landmark/xeno_resin_door,
/turf/open/floor/plating/ground/mars/random/cave,
/area/bigredv2/caves/southeast/garbledradio)
"N" = (
/turf/open/floor/plating/ground/mars/random/cave,
/area/bigredv2/caves/southeast/garbledradio)
"O" = (
/obj/effect/landmark/weed_node,
/turf/open/floor/plating/ground/mars/random/cave/rock,
/area/bigredv2/caves/southeast/garbledradio)
"P" = (
/obj/effect/landmark/patrol_point/tgmc_14,
/turf/open/floor/plating/ground/mars/random/cave,
/area/bigredv2/caves/southeast)
"Q" = (
/obj/effect/landmark/weed_node,
/obj/effect/ai_node,
/turf/open/floor/plating/ground/mars/random/cave,
/area/bigredv2/caves/southeast/garbledradio)
"R" = (
/obj/effect/landmark/start/job/xenomorph,
/obj/effect/landmark/weed_node,
/turf/open/floor/plating/ground/mars/random/cave,
/area/bigredv2/caves/southeast/garbledradio)
"S" = (
/obj/effect/landmark/xeno_resin_door,
/turf/open/floor/plating/ground/mars/random/cave,
/area/bigredv2/caves/southeast)
"X" = (
/turf/closed/mineral/smooth/bigred/indestructible,
/area/space)
"Z" = (
/obj/effect/landmark/weed_node,
/obj/effect/ai_node,
/turf/open/floor/plating/ground/mars/random/cave,
/area/bigredv2/caves/southeast)

(1,1,1) = {"
u
u
u
u
u
u
u
u
u
u
u
u
u
u
u
u
N
N
N
N
N
v
x
u
u
u
u
u
u
u
u
h
h
h
h
h
h
u
u
u
u
u
u
u
u
u
u
u
u
u
S
S
S
S
u
u
u
u
u
u
u
u
u
u
X
X
a
"}
(2,1,1) = {"
F
u
u
u
u
u
u
u
u
u
u
u
u
u
x
x
N
N
N
u
N
N
x
u
u
u
u
u
u
u
u
S
S
S
S
S
u
u
u
u
u
u
u
u
u
u
u
u
u
u
h
f
h
h
u
u
u
u
u
u
u
u
u
u
u
X
a
"}
(3,1,1) = {"
u
u
u
u
u
u
u
u
u
u
u
u
u
u
N
N
N
N
N
u
x
N
x
u
u
u
u
u
u
u
u
h
h
h
h
h
u
u
u
u
u
u
u
u
u
u
u
u
u
u
h
h
h
h
u
u
u
u
u
u
u
u
u
u
u
X
a
"}
(4,1,1) = {"
u
u
u
u
u
u
u
u
u
u
u
u
u
C
N
N
Q
N
u
u
u
N
x
u
u
u
u
u
u
u
u
h
h
k
h
h
u
u
u
u
u
u
u
u
u
u
u
u
u
u
h
h
h
h
u
u
u
u
u
u
u
u
u
u
u
X
a
"}
(5,1,1) = {"
u
u
u
u
u
u
u
u
u
u
u
u
u
N
v
x
N
N
u
u
u
N
O
u
u
u
u
u
u
u
u
h
h
h
h
h
u
u
u
u
u
u
u
u
u
u
u
u
u
u
h
h
A
f
u
u
u
u
u
u
u
u
u
u
u
X
a
"}
(6,1,1) = {"
u
u
u
u
u
u
u
u
u
u
u
x
x
N
N
x
N
N
u
u
u
N
x
N
u
u
u
u
u
u
u
h
h
h
h
h
u
u
j
u
u
u
u
u
u
u
u
u
u
u
h
f
h
h
u
u
u
u
u
u
u
u
u
u
u
X
a
"}
(7,1,1) = {"
u
u
u
u
u
u
u
u
u
u
u
N
N
N
x
N
N
u
u
u
u
N
x
N
L
h
h
h
u
u
u
h
h
f
h
h
u
u
u
u
u
u
u
u
u
u
u
u
u
u
h
h
h
h
u
u
u
u
u
u
u
u
u
u
u
X
a
"}
(8,1,1) = {"
u
u
u
u
u
u
u
u
u
u
u
N
N
Q
N
u
u
u
u
u
u
N
x
N
L
N
h
h
h
h
u
h
h
h
h
h
u
u
u
u
u
u
u
u
u
u
u
u
u
u
h
h
h
h
u
u
u
u
u
u
u
u
u
u
u
X
a
"}
(9,1,1) = {"
u
u
u
u
u
u
u
u
u
u
u
N
C
N
N
u
u
u
u
u
u
N
x
N
L
h
h
f
h
h
h
h
h
f
h
h
u
u
u
u
u
u
u
u
u
u
u
u
u
u
h
h
h
h
u
u
u
u
u
u
u
u
u
u
u
X
a
"}
(10,1,1) = {"
u
u
u
u
u
u
u
u
u
u
x
N
x
N
N
u
u
u
u
N
N
e
O
N
L
h
h
h
h
h
h
h
h
h
h
h
u
u
u
u
u
u
u
u
u
u
u
u
u
u
h
h
f
h
u
u
u
u
u
u
u
u
u
u
u
X
a
"}
(11,1,1) = {"
u
u
u
u
u
u
u
u
u
u
N
N
x
N
x
x
x
x
x
N
N
N
x
u
u
u
h
h
h
h
f
h
h
A
h
h
h
u
u
u
u
u
u
u
u
u
u
u
u
u
h
h
h
h
u
u
u
u
u
u
u
u
u
u
u
X
a
"}
(12,1,1) = {"
j
u
u
u
u
u
u
u
u
u
N
R
N
x
N
N
N
N
x
N
v
N
u
u
u
u
u
u
u
h
h
h
A
h
h
h
h
u
u
u
u
u
u
u
u
u
u
u
u
u
h
f
h
u
u
u
u
u
u
u
u
u
u
u
u
X
a
"}
(13,1,1) = {"
u
u
u
u
u
u
u
u
u
u
v
N
N
N
N
v
e
N
v
N
N
N
u
u
u
u
u
u
u
h
h
h
f
h
h
h
h
u
u
u
u
u
u
u
u
u
u
u
u
h
h
h
h
u
u
u
u
u
u
u
u
u
u
u
u
X
a
"}
(14,1,1) = {"
x
N
u
u
u
u
u
u
u
x
N
N
N
N
N
N
N
N
N
N
N
u
u
u
u
u
u
u
u
h
h
h
h
h
h
h
h
h
h
u
u
u
u
u
u
u
u
u
u
h
h
h
A
u
u
u
u
u
u
u
u
u
u
u
u
X
a
"}
(15,1,1) = {"
x
u
u
u
u
u
u
u
u
N
e
N
e
v
N
N
e
N
N
x
u
u
u
u
u
u
u
u
u
h
h
f
h
h
h
h
f
h
h
h
h
u
u
u
u
u
u
u
h
h
h
A
h
u
u
u
u
u
u
u
u
u
u
u
u
X
a
"}
(16,1,1) = {"
x
u
u
u
u
u
u
x
x
N
x
N
N
N
N
N
N
N
N
N
u
u
u
u
u
u
u
u
u
h
h
h
h
h
h
h
h
h
h
h
h
h
h
h
h
u
u
u
h
h
h
h
h
u
u
u
u
u
u
u
u
u
u
u
u
X
a
"}
(17,1,1) = {"
N
u
u
u
u
u
u
N
N
N
x
v
N
N
u
u
u
u
u
u
u
u
u
u
u
u
u
h
h
h
h
h
h
h
h
f
h
h
h
h
h
h
h
h
h
h
h
h
h
f
h
h
u
u
u
u
u
u
u
u
u
u
u
u
u
X
a
"}
(18,1,1) = {"
N
u
u
u
u
u
u
x
N
x
N
N
N
u
u
u
u
u
u
u
u
u
u
u
u
u
u
h
h
h
f
h
h
h
h
f
h
h
h
h
h
f
h
f
h
h
h
h
h
h
h
h
u
u
u
u
u
u
u
u
u
u
u
u
u
X
a
"}
(19,1,1) = {"
N
u
u
u
u
u
N
N
v
x
N
u
u
u
u
u
u
u
u
u
u
u
u
u
u
h
h
h
A
h
h
h
h
A
h
h
h
h
h
h
h
h
A
h
h
h
h
p
h
A
h
A
u
u
u
u
u
u
u
u
u
u
u
u
u
H
a
"}
(20,1,1) = {"
N
u
u
N
N
N
e
N
N
N
e
u
u
u
u
u
u
u
u
u
u
u
u
u
u
h
h
h
h
h
f
h
h
h
h
h
h
h
h
f
h
h
h
h
h
h
f
h
h
h
h
h
u
u
u
u
u
u
u
u
u
u
u
u
u
H
a
"}
(21,1,1) = {"
N
N
N
N
N
N
N
N
x
N
u
u
u
u
u
u
u
i
i
i
i
i
i
i
i
t
f
h
A
h
h
h
h
h
h
h
h
h
h
h
h
h
h
h
f
h
h
h
h
h
h
u
u
u
u
u
u
u
u
u
u
u
u
u
u
H
a
"}
(22,1,1) = {"
N
N
N
N
x
x
N
N
N
N
u
u
u
u
u
u
u
i
u
u
u
h
h
f
d
t
h
h
h
h
p
h
h
f
h
h
h
u
u
u
u
h
h
h
h
h
h
h
h
h
u
u
u
u
u
u
u
u
u
u
u
u
u
u
u
H
a
"}
(23,1,1) = {"
s
e
N
x
N
N
e
N
N
u
u
u
u
u
u
u
u
i
u
u
h
h
f
h
d
t
h
h
h
h
h
h
h
h
h
h
u
u
u
u
u
u
u
u
u
u
u
u
u
u
u
u
u
u
u
u
u
u
u
u
u
u
u
u
u
H
a
"}
(24,1,1) = {"
N
x
O
N
N
N
N
x
u
u
u
u
u
u
u
u
u
i
u
h
h
h
h
h
d
t
h
h
h
h
h
h
h
h
h
h
u
u
u
u
u
u
u
u
u
u
u
u
u
u
u
u
u
u
u
u
u
u
u
u
u
u
u
u
u
H
a
"}
(25,1,1) = {"
x
N
N
x
u
u
u
u
u
u
u
u
u
u
u
u
u
i
u
h
f
h
b
h
d
t
h
h
f
A
h
h
h
h
h
h
u
u
u
u
u
u
u
u
u
u
u
u
u
u
u
u
u
u
u
u
u
u
u
u
u
u
u
u
u
H
a
"}
(26,1,1) = {"
N
N
N
x
u
u
u
u
u
u
u
u
u
u
u
u
u
i
u
h
h
h
h
h
S
t
h
h
A
h
h
f
h
A
h
u
u
u
u
u
u
u
u
u
u
u
u
u
u
u
u
u
u
u
u
u
u
u
u
u
u
u
u
u
u
H
a
"}
(27,1,1) = {"
u
u
u
u
u
u
u
u
u
u
u
u
u
u
u
u
u
i
u
u
h
h
h
h
S
t
h
h
h
h
h
h
h
h
h
u
u
u
u
u
u
u
u
u
u
u
u
u
u
u
u
u
u
u
u
u
u
u
u
u
u
u
u
u
u
H
a
"}
(28,1,1) = {"
u
u
u
u
u
u
u
u
u
u
u
u
u
u
u
u
u
i
u
u
h
h
h
f
S
t
h
h
h
h
h
h
h
h
u
u
u
u
u
u
u
u
u
u
u
u
u
u
u
u
u
u
u
u
u
u
u
u
u
u
u
u
u
u
u
H
a
"}
(29,1,1) = {"
u
u
u
u
u
u
u
u
u
u
u
u
u
u
u
u
u
i
u
u
f
h
h
h
d
t
h
h
h
h
h
h
h
u
u
u
u
u
u
u
u
u
u
u
u
u
u
u
u
u
u
u
u
u
u
u
u
u
u
u
u
u
u
u
u
H
a
"}
(30,1,1) = {"
u
u
u
u
u
u
u
u
u
u
u
u
u
u
u
u
u
i
u
u
u
h
f
h
d
t
h
h
A
h
h
h
u
u
u
u
u
u
u
u
u
u
u
u
u
u
u
u
u
u
u
u
u
u
u
u
u
u
u
u
u
u
u
u
u
H
a
"}
(31,1,1) = {"
u
u
u
u
u
u
u
u
u
u
u
u
u
u
u
u
u
i
u
u
u
u
u
h
d
t
h
Z
h
h
h
u
u
u
u
u
u
u
u
u
u
u
u
u
u
u
u
u
u
u
u
u
u
u
u
u
u
u
u
u
u
u
u
u
u
H
a
"}
(32,1,1) = {"
h
h
u
u
u
u
u
u
u
u
u
u
u
u
u
u
u
i
u
u
u
u
u
u
d
t
h
h
f
h
u
u
u
u
u
u
u
u
u
u
u
u
u
u
u
u
u
u
u
u
u
u
u
u
u
u
u
u
u
u
u
u
u
u
u
H
a
"}
(33,1,1) = {"
h
h
f
h
A
u
u
u
u
u
u
u
u
u
u
u
u
i
i
i
i
i
i
i
i
t
h
h
h
h
u
u
u
u
u
u
u
u
u
u
u
u
u
u
u
u
u
u
u
u
u
u
u
u
u
u
u
u
u
u
u
u
u
u
u
H
a
"}
(34,1,1) = {"
h
h
h
h
h
h
h
u
u
u
u
u
u
u
u
u
u
u
u
u
u
u
u
u
u
h
h
h
h
h
u
u
u
u
u
u
u
u
u
u
u
u
u
u
u
u
u
u
u
u
u
u
u
u
u
u
u
u
u
u
u
u
u
u
u
H
a
"}
(35,1,1) = {"
h
f
h
h
h
h
h
u
u
u
u
u
u
u
u
u
u
u
u
u
u
u
u
u
u
h
h
h
f
u
u
u
u
u
u
u
u
u
u
u
u
u
u
u
u
u
u
u
u
u
u
u
u
u
u
u
u
u
u
u
u
u
u
u
u
H
a
"}
(36,1,1) = {"
h
h
h
h
h
h
h
h
u
h
u
u
u
u
u
u
u
u
u
u
u
u
u
u
h
h
h
h
h
u
u
u
u
u
u
u
u
u
u
u
u
u
u
u
u
u
u
u
u
u
u
u
u
u
u
u
u
u
u
u
u
u
u
u
u
H
a
"}
(37,1,1) = {"
h
h
h
h
A
f
h
A
h
h
h
h
u
u
u
u
u
u
u
u
u
u
u
u
h
h
h
h
h
u
u
u
u
u
u
u
u
u
u
u
u
u
u
u
u
u
u
u
u
u
u
u
u
u
u
u
u
u
u
u
u
u
u
u
u
H
a
"}
(38,1,1) = {"
u
u
h
h
h
h
h
h
h
h
h
h
h
P
u
u
u
u
u
u
u
u
u
u
h
h
h
h
E
u
u
u
u
u
u
u
u
u
u
u
u
u
u
u
u
u
u
u
u
u
u
u
u
u
u
u
u
u
u
u
u
u
u
X
X
X
a
"}
(39,1,1) = {"
u
u
h
h
h
h
h
A
h
h
h
h
h
h
A
h
h
h
u
u
u
u
u
h
h
h
f
h
h
u
u
u
u
u
u
u
u
u
u
u
u
u
u
u
u
u
u
u
u
u
u
u
u
u
u
u
u
u
u
u
u
u
u
X
X
X
a
"}
(40,1,1) = {"
u
u
h
h
h
h
h
h
h
h
h
h
h
h
h
h
h
h
h
u
u
u
u
h
h
h
h
h
f
u
u
u
u
u
u
u
u
u
u
u
u
u
u
u
u
u
u
u
u
u
u
u
u
u
u
u
u
u
u
u
u
u
u
X
X
X
a
"}
(41,1,1) = {"
h
h
h
h
h
h
f
h
h
h
f
h
h
h
h
h
f
h
h
h
u
u
h
h
h
h
h
h
h
u
u
u
u
u
u
u
u
u
u
u
u
u
u
u
u
u
u
u
u
u
u
u
u
u
u
u
u
u
u
u
u
u
u
X
X
X
a
"}
(42,1,1) = {"
h
h
h
h
h
h
h
h
h
h
h
h
h
h
h
h
h
h
f
h
h
h
h
h
f
h
h
h
h
u
u
u
u
u
u
u
u
u
u
u
u
u
u
u
u
u
u
u
u
u
u
u
u
u
u
u
u
u
u
u
u
u
u
X
X
X
a
"}
(43,1,1) = {"
h
h
h
f
h
h
h
h
h
h
h
h
h
h
h
p
h
h
h
h
h
h
h
h
h
h
h
h
h
u
u
u
u
u
u
u
u
u
u
u
u
u
u
u
u
u
u
u
u
u
u
u
u
u
u
u
u
u
u
u
u
u
u
X
X
X
a
"}
(44,1,1) = {"
h
h
h
h
h
h
h
f
h
h
h
h
f
h
h
h
h
h
h
h
h
h
h
h
h
h
h
h
h
u
u
u
u
u
u
u
u
u
u
u
u
u
u
u
u
u
u
u
u
u
u
u
u
u
u
u
u
u
u
u
u
u
u
X
X
X
a
"}
(45,1,1) = {"
h
A
h
h
h
h
h
A
h
h
h
h
h
h
Z
h
h
h
h
h
h
h
h
h
h
f
h
h
h
u
u
u
u
u
u
u
u
u
u
u
u
u
u
u
u
u
u
u
u
u
u
u
u
u
u
u
u
u
u
u
u
u
u
X
X
X
a
"}
(46,1,1) = {"
h
h
h
h
h
h
h
h
h
u
h
h
h
h
h
h
h
h
h
f
h
h
h
h
h
h
h
h
u
u
u
u
u
u
u
u
u
u
u
u
u
u
u
u
u
u
u
u
u
u
u
u
u
u
u
u
u
u
u
u
u
u
u
X
X
X
a
"}
(47,1,1) = {"
h
h
f
h
h
h
h
h
h
u
u
u
h
h
h
h
h
h
f
h
h
h
h
f
h
h
h
h
u
u
u
u
u
u
u
u
u
u
u
u
u
u
u
u
u
u
u
u
u
u
u
u
u
u
u
u
u
u
u
u
u
u
u
X
X
X
a
"}
(48,1,1) = {"
h
h
h
h
h
h
h
u
u
u
u
u
u
u
u
h
h
h
h
h
h
h
h
h
h
h
h
u
u
u
u
u
u
u
u
u
u
u
u
u
u
u
u
u
u
u
u
u
u
u
u
u
u
u
u
u
u
u
u
u
u
u
u
X
X
X
a
"}
(49,1,1) = {"
h
A
h
h
h
h
u
u
u
u
u
u
u
u
u
u
u
I
h
h
h
h
h
h
h
h
o
u
u
u
u
u
u
u
u
u
u
u
u
u
u
u
u
u
u
u
u
u
u
u
u
u
u
u
u
u
u
u
u
u
u
u
u
X
X
X
a
"}
(50,1,1) = {"
h
h
h
u
u
u
u
u
u
u
u
u
u
u
u
u
u
u
u
h
h
h
h
h
h
u
u
u
u
u
u
u
u
u
u
u
u
u
u
u
u
u
u
u
u
u
u
u
u
u
u
u
u
u
u
u
u
u
u
u
u
u
u
X
X
X
a
"}
(51,1,1) = {"
h
h
h
u
u
u
u
u
u
u
u
u
u
u
u
u
u
u
u
u
u
u
h
h
u
u
u
u
u
u
u
u
u
u
u
u
u
u
u
u
u
u
u
u
u
u
u
u
u
u
u
u
u
u
u
u
u
u
u
u
u
u
u
X
X
X
a
"}
(52,1,1) = {"
u
u
u
u
u
u
u
u
u
u
u
u
u
u
u
u
u
u
u
u
u
u
u
u
u
u
u
u
u
u
u
u
u
u
u
u
u
u
u
u
u
u
u
u
u
u
u
u
u
u
u
u
u
u
u
u
u
u
u
u
u
u
u
X
X
X
a
"}
(53,1,1) = {"
u
u
u
u
u
u
u
u
u
u
u
u
u
u
u
u
u
u
u
u
u
u
u
u
u
u
u
u
u
u
u
u
u
u
u
u
u
u
u
u
u
u
u
u
u
u
u
u
u
u
u
u
u
u
u
u
u
u
u
u
u
u
u
X
X
X
a
"}
(54,1,1) = {"
u
u
u
u
u
u
u
u
u
u
u
u
u
u
u
u
u
u
u
u
u
u
u
u
u
u
u
u
u
u
u
u
u
u
u
u
u
u
u
u
u
u
u
u
u
u
u
u
u
u
u
u
u
u
u
u
u
u
u
u
u
u
u
X
X
X
a
"}
(55,1,1) = {"
u
u
u
u
u
u
u
u
u
u
u
u
u
u
u
u
u
u
u
u
u
u
u
u
u
u
u
u
u
u
u
u
u
u
u
u
u
u
u
u
u
u
u
u
u
u
u
u
u
u
u
u
u
u
u
u
u
u
u
u
u
u
u
X
X
X
a
"}
(56,1,1) = {"
u
u
u
u
u
u
u
u
u
u
u
u
u
u
u
u
u
u
u
u
u
u
u
u
u
u
u
u
u
u
u
u
u
u
u
u
u
u
u
u
u
u
u
u
u
u
u
u
u
u
u
u
u
u
u
u
u
u
u
u
u
u
u
X
X
X
a
"}
(57,1,1) = {"
u
u
u
u
u
u
u
u
u
u
u
u
u
u
u
u
u
u
u
u
u
u
u
u
u
u
u
u
u
u
u
u
u
u
u
u
u
u
u
u
u
u
u
u
u
u
u
u
u
u
u
u
u
u
u
u
u
u
u
u
u
u
u
X
X
X
a
"}
(58,1,1) = {"
u
u
u
u
u
u
u
u
u
u
u
u
u
u
u
u
u
u
u
u
u
u
u
u
u
u
u
u
u
u
u
u
u
u
u
u
u
u
u
u
u
u
u
u
u
u
u
u
u
u
u
u
u
u
u
u
u
u
u
u
u
u
u
X
X
X
a
"}
(59,1,1) = {"
u
u
u
u
u
u
u
u
u
u
u
u
u
u
u
u
u
u
u
u
u
u
u
u
u
u
u
u
u
u
u
u
u
u
u
u
u
u
u
u
u
u
u
u
u
u
u
u
u
u
u
u
u
u
u
u
u
u
u
u
u
u
u
X
X
X
a
"}
(60,1,1) = {"
u
u
u
u
u
u
u
u
u
u
u
u
u
u
u
u
u
u
u
u
u
u
u
u
u
u
u
u
u
u
u
u
u
u
u
u
u
u
u
u
u
u
u
u
u
u
u
u
u
u
u
u
u
u
u
u
u
u
u
u
u
u
u
X
X
X
a
"}
(61,1,1) = {"
u
u
u
u
u
u
u
u
u
u
u
u
u
u
u
u
u
u
u
u
u
u
u
u
u
u
u
u
u
u
u
u
u
u
u
u
u
u
u
u
u
u
u
u
u
u
u
u
u
u
u
u
u
u
u
u
u
u
u
u
u
u
u
X
X
X
a
"}
(62,1,1) = {"
u
u
u
u
u
u
u
u
u
u
u
u
u
u
u
u
u
u
u
u
u
u
u
u
u
u
u
u
u
u
u
u
u
u
u
u
u
u
u
u
u
u
u
u
u
u
u
u
u
u
u
u
u
u
u
u
u
u
u
u
u
u
u
X
X
X
a
"}
(63,1,1) = {"
X
X
X
X
X
X
X
X
X
X
X
X
X
X
X
X
X
X
X
X
X
X
X
X
X
X
X
X
X
X
X
X
X
X
X
X
X
X
X
X
X
X
X
X
X
X
X
X
X
X
X
X
X
X
X
X
X
X
X
X
X
X
X
X
X
X
a
"}
(64,1,1) = {"
X
X
X
X
X
X
X
X
X
X
X
X
X
X
X
X
X
X
X
X
X
X
X
X
X
X
X
X
X
X
X
X
X
X
X
X
X
X
X
X
X
X
X
X
X
X
X
X
X
X
X
X
X
X
X
X
X
X
X
X
X
X
X
X
X
X
a
"}
(65,1,1) = {"
X
X
X
X
X
X
X
X
X
X
X
X
X
X
X
X
X
X
X
X
X
X
X
X
X
X
X
X
X
X
X
X
X
X
X
X
X
X
X
X
X
X
X
X
X
X
X
X
X
X
X
X
X
X
X
X
X
X
X
X
X
X
X
X
X
X
a
"}
(66,1,1) = {"
X
X
X
X
X
X
X
X
X
X
X
X
X
X
X
X
X
X
X
X
X
X
X
X
X
X
X
X
X
X
X
X
X
X
X
X
X
X
X
X
X
X
X
X
X
X
X
X
X
X
X
X
X
X
X
X
X
X
X
X
X
X
X
X
X
X
a
"}
(67,1,1) = {"
X
X
X
X
X
X
X
X
X
X
X
X
X
X
X
X
X
X
X
X
X
X
X
X
X
X
X
X
X
X
X
X
X
X
X
X
X
X
X
X
X
X
X
X
X
X
X
X
X
X
X
X
X
X
X
X
X
X
X
X
X
X
X
X
X
X
a
"}
(68,1,1) = {"
X
X
X
X
X
X
X
X
X
X
X
X
X
X
X
X
X
X
X
X
X
X
X
X
X
X
X
X
X
X
X
X
X
X
X
X
X
X
X
X
X
X
X
X
X
X
X
X
X
X
X
X
X
X
X
X
X
X
X
X
X
X
X
X
X
X
a
"}
(69,1,1) = {"
X
X
X
X
X
X
X
X
X
X
X
X
X
X
X
X
X
X
X
X
X
X
X
X
X
X
X
X
X
X
X
X
X
X
X
X
X
X
X
X
X
X
X
X
X
X
X
X
X
X
X
X
X
X
X
X
X
X
X
X
X
X
X
X
X
X
a
"}
(70,1,1) = {"
X
X
X
X
X
X
X
X
X
X
X
X
X
X
X
X
X
X
X
X
X
X
X
X
X
X
X
X
X
X
X
X
X
X
X
X
X
X
X
X
X
X
X
X
X
X
X
X
X
X
X
X
X
X
X
X
X
X
X
X
X
X
X
X
X
X
a
"}
(71,1,1) = {"
X
X
X
X
X
X
X
X
X
X
X
X
X
X
X
X
X
X
X
X
X
X
X
X
X
X
X
X
X
X
X
X
X
X
X
X
X
X
X
X
X
X
X
X
X
X
X
X
X
X
X
X
X
X
X
X
X
X
X
X
X
X
X
X
X
X
a
"}
