//MAP CONVERTED BY dmm2tgm.py THIS HEADER COMMENT PREVENTS RECONVERSION, DO NOT REMOVE
"a" = (
/turf/open/space/basic,
/area/space)
"b" = (
/obj/effect/landmark/patrol_point/tgmc_13,
/turf/open/floor/plating/ground/mars/random/cave,
/area/bigredv2/caves/southeast)
"d" = (
/obj/effect/landmark/lv624/fog_blocker/xeno_spawn,
/turf/closed/mineral/smooth/bigred,
/area/bigredv2/caves/rock)
"e" = (
/obj/machinery/miner/damaged/platinum,
/turf/open/floor/plating/ground/mars/random/cave,
/area/bigredv2/caves/southeast)
"g" = (
/obj/effect/landmark/patrol_point/tgmc_11,
/turf/open/floor/plating/ground/mars/random/cave,
/area/bigredv2/caves/southeast)
"j" = (
/obj/effect/landmark/lv624/fog_blocker/xeno_spawn,
/turf/open/floor/plating/ground/mars/random/cave,
/area/bigredv2/caves/southeast)
"k" = (
/turf/closed/mineral/smooth/bigred/indestructible,
/area/bigredv2/caves/rock)
"l" = (
/obj/machinery/miner/damaged/platinum,
/turf/open/floor/plating/ground/mars/random/cave,
/area/bigredv2/caves/southeast/garbledradio)
"m" = (
/obj/effect/landmark/excavation_site_spawner,
/turf/open/floor/plating/ground/mars/random/cave,
/area/bigredv2/caves/southeast/garbledradio)
"o" = (
/obj/effect/landmark/weed_node,
/turf/open/floor/plating/ground/mars/random/cave,
/area/bigredv2/caves/southeast)
"p" = (
/obj/effect/landmark/xeno_resin_door,
/turf/open/floor/plating/ground/mars/random/cave,
/area/bigredv2/caves/southeast)
"u" = (
/obj/effect/landmark/patrol_point/tgmc_12,
/turf/open/floor/plating/ground/mars/random/cave,
/area/bigredv2/caves/southeast)
"v" = (
/turf/closed/mineral/smooth/bigred/indestructible,
/area/space)
"w" = (
/turf/open/floor/plating/ground/mars/random/cave,
/area/bigredv2/caves/southeast)
"y" = (
/turf/open/floor/plating/ground/mars/random/cave,
/area/bigredv2/caves/east)
"D" = (
/obj/effect/landmark/start/job/xenomorph,
/turf/open/floor/plating/ground/mars/random/cave,
/area/bigredv2/caves/southeast)
"E" = (
/obj/effect/ai_node,
/turf/open/floor/plating/ground/mars/random/cave,
/area/bigredv2/caves/southeast/garbledradio)
"F" = (
/obj/effect/ai_node,
/turf/open/floor/plating/ground/mars/random/cave,
/area/bigredv2/caves/southeast)
"G" = (
/obj/effect/ai_node,
/turf/open/floor/plating/ground/mars/random/cave/rock,
/area/bigredv2/caves/southeast/garbledradio)
"H" = (
/obj/effect/landmark/patrol_point/tgmc_14,
/turf/open/floor/plating/ground/mars/random/cave,
/area/bigredv2/caves/southeast)
"I" = (
/obj/docking_port/stationary/crashmode,
/turf/closed/mineral/smooth/bigred,
/area/bigredv2/caves/rock)
"J" = (
/obj/effect/landmark/weed_node,
/obj/effect/ai_node,
/turf/open/floor/plating/ground/mars/random/cave,
/area/bigredv2/caves/southeast/garbledradio)
"K" = (
/turf/open/floor/plating/ground/mars/random/cave,
/area/bigredv2/caves/southeast/garbledradio)
"O" = (
/obj/effect/landmark/excavation_site_spawner,
/turf/open/floor/plating/ground/mars/random/cave,
/area/bigredv2/caves/southeast)
"Q" = (
/obj/effect/landmark/start/job/xenomorph,
/obj/effect/landmark/weed_node,
/turf/open/floor/plating/ground/mars/random/cave,
/area/bigredv2/caves/southeast/garbledradio)
"R" = (
/obj/effect/landmark/xeno_silo_spawn,
/turf/open/floor/plating/ground/mars/random/cave,
/area/bigredv2/caves/southeast)
"S" = (
/obj/effect/landmark/weed_node,
/turf/open/floor/plating/ground/mars/random/cave,
/area/bigredv2/caves/southeast/garbledradio)
"T" = (
/obj/effect/landmark/xeno_resin_wall,
/turf/open/floor/plating/ground/mars/random/cave,
/area/bigredv2/caves/southeast)
"U" = (
/obj/effect/landmark/weed_node,
/turf/open/floor/plating/ground/mars/random/cave/rock,
/area/bigredv2/caves/southeast/garbledradio)
"V" = (
/turf/closed/mineral/smooth/bigred,
/area/bigredv2/caves/rock)
"W" = (
/obj/effect/landmark/xeno_resin_door,
/turf/open/floor/plating/ground/mars/random/cave/rock,
/area/bigredv2/caves/southeast)
"X" = (
/turf/open/floor/plating/ground/mars/random/cave/rock,
/area/bigredv2/caves/southeast/garbledradio)
"Y" = (
/obj/effect/landmark/weed_node,
/obj/effect/ai_node,
/turf/open/floor/plating/ground/mars/random/cave,
/area/bigredv2/caves/southeast)

(1,1,1) = {"
V
V
V
V
V
V
V
V
V
V
V
V
V
V
V
V
K
K
K
K
K
S
X
V
V
V
V
V
V
V
V
w
w
w
w
w
w
V
V
V
V
V
V
V
V
V
V
V
V
V
p
p
p
p
V
V
V
V
V
V
V
V
V
V
v
v
a
"}
(2,1,1) = {"
y
V
V
V
V
V
V
V
V
V
V
V
V
V
X
X
K
K
K
V
K
K
X
V
V
V
V
V
V
V
V
p
p
p
p
p
V
V
V
V
V
V
V
V
V
V
V
V
V
V
w
o
w
w
V
V
V
V
V
V
V
V
V
V
V
v
a
"}
(3,1,1) = {"
V
V
V
V
V
V
V
V
V
V
V
V
V
V
K
K
K
K
K
V
X
K
X
V
V
V
V
V
V
V
V
w
w
w
w
w
V
V
V
V
V
V
V
V
V
V
V
V
V
V
w
w
w
w
V
V
V
V
V
V
V
V
V
V
V
v
a
"}
(4,1,1) = {"
V
V
V
V
V
V
V
V
V
V
V
V
V
G
K
K
J
K
V
V
V
w
X
V
V
V
V
V
V
V
V
w
w
D
w
w
V
V
V
V
V
V
V
V
V
V
V
V
V
V
w
w
w
w
V
V
V
V
V
V
V
V
V
V
V
v
a
"}
(5,1,1) = {"
V
V
V
V
V
V
V
V
V
V
V
V
V
K
S
X
K
K
V
V
V
w
X
V
V
V
V
V
V
V
V
w
w
w
w
w
V
V
V
V
V
V
V
V
V
V
V
V
V
V
w
w
F
o
V
V
V
V
V
V
V
V
V
V
V
v
a
"}
(6,1,1) = {"
V
V
V
V
V
V
V
V
V
V
V
X
X
K
K
X
K
K
V
V
V
w
X
V
V
V
V
V
V
V
V
w
w
w
w
w
V
V
I
V
V
V
V
V
V
V
V
V
V
V
w
o
w
w
V
V
V
V
V
V
V
V
V
V
V
v
a
"}
(7,1,1) = {"
V
V
V
V
V
V
V
V
V
V
V
K
K
K
X
K
K
V
V
V
V
w
X
V
V
V
V
V
V
V
V
w
w
o
w
w
V
V
V
V
V
V
V
V
V
V
V
V
V
V
w
w
w
w
V
V
V
V
V
V
V
V
V
V
V
v
a
"}
(8,1,1) = {"
V
V
V
V
V
V
V
V
V
V
V
K
K
J
K
V
V
V
V
V
V
w
X
V
V
V
V
V
V
V
V
w
w
w
w
w
V
V
V
V
V
V
V
V
V
V
V
V
V
V
w
w
w
w
V
V
V
V
V
V
V
V
V
V
V
v
a
"}
(9,1,1) = {"
V
V
V
V
V
V
V
V
V
V
V
K
G
K
K
V
V
V
V
V
V
w
X
V
V
V
V
V
V
V
V
w
w
o
w
w
V
V
V
V
V
V
V
V
V
V
V
V
V
V
w
w
w
w
V
V
V
V
V
V
V
V
V
V
V
v
a
"}
(10,1,1) = {"
V
V
V
V
V
V
V
V
V
V
X
K
X
K
K
V
V
V
V
K
K
E
U
V
V
V
V
V
V
V
w
w
w
w
w
w
V
V
V
V
V
V
V
V
V
V
V
V
V
V
w
w
o
w
V
V
V
V
V
V
V
V
V
V
V
v
a
"}
(11,1,1) = {"
V
V
V
V
V
V
V
V
V
V
K
K
X
m
X
X
X
X
X
K
K
K
X
V
V
V
V
V
V
w
w
w
w
F
w
w
w
V
V
V
V
V
V
V
V
V
V
V
V
V
w
w
w
w
V
V
V
V
V
V
V
V
V
V
V
v
a
"}
(12,1,1) = {"
I
V
V
V
V
V
V
V
V
V
K
Q
K
X
K
K
K
K
X
K
S
K
V
V
V
V
V
w
F
w
w
w
F
w
w
w
w
V
V
V
V
V
V
V
V
V
V
V
V
V
w
o
w
V
V
V
V
V
V
V
V
V
V
V
V
v
a
"}
(13,1,1) = {"
V
V
V
V
V
V
V
V
V
V
K
K
K
K
K
S
E
K
S
K
K
K
V
V
V
V
V
w
w
w
w
w
o
w
w
w
w
V
V
V
V
V
V
V
V
V
V
V
V
w
w
w
w
V
V
V
V
V
V
V
V
V
V
V
V
v
a
"}
(14,1,1) = {"
X
K
V
V
V
V
V
V
V
X
K
K
K
K
K
K
K
K
K
K
K
X
V
V
V
V
V
w
o
w
w
w
w
w
w
w
w
w
w
V
V
V
V
V
V
V
V
V
V
w
w
w
F
V
V
V
V
V
V
V
V
V
V
V
V
v
a
"}
(15,1,1) = {"
X
V
V
V
V
V
V
V
V
K
E
K
E
S
K
K
E
K
K
X
V
V
V
V
V
w
w
w
w
w
w
w
w
w
w
w
o
w
w
w
w
V
V
V
V
V
V
V
w
w
w
F
w
V
V
V
V
V
V
V
V
V
V
V
V
v
a
"}
(16,1,1) = {"
X
V
V
V
V
V
V
X
X
K
X
K
K
K
K
K
K
K
K
K
K
V
V
V
V
w
w
w
w
w
O
w
w
o
w
w
w
w
w
w
w
w
w
w
w
V
V
V
w
w
w
w
w
V
V
V
V
V
V
V
V
V
V
V
V
v
a
"}
(17,1,1) = {"
K
V
V
V
V
V
V
K
K
K
X
K
K
K
V
V
V
W
p
p
p
V
V
V
V
w
w
w
o
w
w
w
w
w
w
w
w
o
w
w
w
w
w
w
w
w
w
w
w
o
w
w
V
V
V
V
V
V
V
V
V
V
V
V
V
v
a
"}
(18,1,1) = {"
K
V
V
V
V
V
V
X
K
X
K
K
K
V
V
V
V
V
K
K
E
K
w
o
o
w
w
w
w
w
o
w
w
w
w
w
w
w
w
w
w
o
w
o
w
w
w
w
w
w
w
w
V
V
V
V
V
V
V
V
V
V
V
V
V
v
a
"}
(19,1,1) = {"
K
V
V
V
V
V
K
K
K
X
K
V
V
V
V
V
V
V
V
V
K
w
w
w
w
w
w
w
F
w
w
w
w
F
w
w
w
w
w
w
w
w
F
w
w
w
w
e
w
F
w
F
V
V
V
V
V
V
V
V
V
V
V
V
V
k
a
"}
(20,1,1) = {"
K
V
V
K
K
K
E
K
K
K
E
V
V
V
V
V
V
V
V
V
w
w
w
o
w
w
w
w
w
w
o
w
w
w
w
w
w
w
w
w
o
w
w
w
w
w
o
w
w
w
w
w
V
V
V
V
V
V
V
V
V
V
V
V
V
k
a
"}
(21,1,1) = {"
K
K
K
K
K
K
K
K
X
K
V
V
V
V
V
V
V
V
V
V
F
w
w
w
F
w
o
w
F
w
w
w
w
w
w
V
V
w
w
w
w
w
w
w
w
w
w
w
w
w
w
V
V
V
V
V
V
V
V
V
V
V
V
V
V
k
a
"}
(22,1,1) = {"
K
K
K
K
X
X
K
K
K
K
V
V
V
V
V
V
V
V
V
V
V
w
w
w
w
w
w
w
w
w
e
w
w
w
V
V
V
V
V
w
w
w
w
w
o
w
w
w
w
w
w
V
V
V
V
V
V
V
V
V
V
V
V
V
V
k
a
"}
(23,1,1) = {"
l
E
K
X
K
K
E
K
K
V
V
V
V
V
V
V
V
V
V
V
V
V
V
V
V
V
V
V
w
w
w
w
w
V
V
V
V
V
V
V
w
w
w
w
w
w
w
w
w
w
w
V
V
V
V
V
V
V
V
V
V
V
V
V
V
k
a
"}
(24,1,1) = {"
K
X
U
K
K
K
K
X
V
V
V
V
V
V
V
V
V
V
V
V
V
V
V
V
V
V
V
V
V
V
V
V
V
V
V
V
V
V
V
V
w
o
w
w
w
w
O
w
o
w
w
w
V
V
V
V
V
V
V
V
V
V
V
V
V
k
a
"}
(25,1,1) = {"
X
K
K
X
V
V
V
V
V
V
V
V
V
V
V
V
V
V
V
V
V
V
V
V
V
V
V
V
V
V
V
V
V
V
V
V
V
V
V
V
w
w
w
w
w
w
w
w
w
w
w
w
V
V
V
V
V
V
V
V
V
V
V
V
V
k
a
"}
(26,1,1) = {"
K
K
K
X
V
V
V
V
V
V
V
V
V
V
V
V
V
V
V
V
V
V
V
V
V
V
V
V
V
V
V
V
V
V
V
V
V
V
V
V
w
w
w
w
w
o
w
w
w
w
o
w
V
V
V
V
V
V
V
V
V
V
V
V
V
k
a
"}
(27,1,1) = {"
V
V
V
V
V
V
V
V
V
V
V
V
V
V
V
V
V
V
V
V
V
V
V
V
V
V
V
V
V
V
V
V
V
V
V
V
V
V
V
w
w
w
o
w
w
w
w
w
w
w
w
w
V
V
V
V
V
V
V
V
V
V
V
V
V
k
a
"}
(28,1,1) = {"
V
V
V
V
V
V
V
V
V
V
V
V
V
V
V
V
V
V
V
V
V
V
V
V
V
V
V
V
V
V
V
V
V
V
V
V
V
V
w
o
w
w
w
w
w
w
w
w
w
V
V
V
V
V
V
V
V
V
V
V
V
V
V
V
V
k
a
"}
(29,1,1) = {"
V
V
V
V
V
V
V
V
V
V
V
V
V
V
V
V
V
V
V
V
V
V
V
V
V
V
V
V
V
V
V
V
V
V
V
V
V
w
w
w
w
w
w
o
w
w
w
w
V
V
V
V
V
V
V
V
V
V
V
V
V
V
V
V
V
k
a
"}
(30,1,1) = {"
V
V
V
V
V
V
V
V
V
V
V
V
V
V
V
V
V
V
V
V
V
V
V
V
V
V
V
V
V
V
V
V
V
V
V
V
b
w
w
w
w
w
w
w
w
w
w
w
V
V
V
V
V
V
V
V
V
V
V
V
V
V
V
V
V
k
a
"}
(31,1,1) = {"
V
V
V
V
V
V
V
V
V
V
V
V
V
V
V
V
V
V
V
V
V
V
V
V
V
V
V
V
V
V
V
V
V
V
V
V
w
w
w
w
w
w
w
w
w
w
o
w
V
V
V
V
V
V
V
V
V
V
V
V
V
V
V
V
V
k
a
"}
(32,1,1) = {"
w
w
V
V
V
V
V
V
V
V
V
V
V
V
V
V
V
V
V
V
V
V
V
V
V
V
V
V
V
V
V
V
V
w
w
w
w
w
o
w
j
j
j
j
j
j
j
j
d
d
d
d
V
V
V
V
V
V
V
V
V
V
V
V
V
k
a
"}
(33,1,1) = {"
w
w
o
w
F
w
w
V
V
V
V
V
V
V
V
V
V
V
V
V
V
V
V
V
V
V
V
V
V
V
V
V
w
w
w
w
w
w
w
w
j
w
o
w
w
w
w
w
u
V
V
d
V
V
V
V
V
V
V
V
V
V
V
V
V
k
a
"}
(34,1,1) = {"
w
w
w
w
w
w
w
w
w
V
V
V
V
V
V
V
V
V
V
V
V
V
V
V
V
V
V
V
V
V
V
w
w
w
o
w
w
o
w
w
j
w
w
w
w
w
w
o
w
V
V
d
V
V
V
V
V
V
V
V
V
V
V
V
V
k
a
"}
(35,1,1) = {"
w
o
w
w
w
w
w
w
w
w
w
V
V
V
V
V
V
V
V
V
V
V
V
V
V
V
V
V
V
w
w
w
w
w
w
w
w
w
w
w
j
w
w
o
T
T
T
p
p
T
V
d
V
V
V
V
V
V
V
V
V
V
V
V
V
k
a
"}
(36,1,1) = {"
w
w
w
w
w
w
w
w
w
w
w
w
w
w
V
V
V
V
V
V
V
V
V
V
V
V
V
w
w
w
w
w
w
w
w
w
w
w
w
w
j
w
w
w
p
w
w
w
w
w
V
d
V
V
V
V
V
V
V
V
V
V
V
V
V
k
a
"}
(37,1,1) = {"
w
w
w
w
F
o
w
F
w
w
w
o
w
w
w
w
w
w
V
V
V
V
V
V
V
w
w
w
w
w
w
o
w
w
w
w
w
w
w
w
j
w
w
w
p
o
w
w
o
w
w
d
V
V
V
V
V
V
V
V
V
V
V
V
V
k
a
"}
(38,1,1) = {"
V
V
w
w
w
w
w
w
w
w
w
w
w
w
w
w
w
w
w
w
V
V
V
w
o
w
w
w
w
w
w
w
w
w
w
w
w
w
w
w
j
o
w
w
p
w
w
w
w
w
o
d
V
V
V
V
V
V
V
V
V
V
V
v
v
v
a
"}
(39,1,1) = {"
V
V
w
w
w
w
w
F
w
w
w
w
w
w
F
w
w
w
w
o
w
V
w
w
w
w
w
w
o
w
w
w
w
e
w
w
w
o
w
w
j
w
w
w
T
w
w
w
R
w
w
d
V
V
V
V
V
V
V
V
V
V
V
v
v
v
a
"}
(40,1,1) = {"
V
V
w
w
w
w
w
w
w
w
w
w
w
w
w
w
w
w
w
w
w
w
w
w
w
w
w
w
w
w
w
w
w
w
w
w
w
w
w
w
j
w
w
T
T
w
o
w
w
w
w
d
V
V
V
V
V
V
V
V
V
V
V
v
v
v
a
"}
(41,1,1) = {"
w
w
w
w
w
w
w
w
w
w
o
w
w
w
w
w
o
w
w
w
w
w
w
w
w
w
w
w
w
w
o
w
w
w
w
w
w
w
w
w
j
w
V
T
w
w
w
w
w
o
w
d
V
V
V
V
V
V
V
V
V
V
V
v
v
v
a
"}
(42,1,1) = {"
w
w
w
w
w
w
w
w
w
w
w
w
w
w
w
w
w
w
w
w
w
w
w
O
w
w
w
w
w
w
w
w
w
w
w
w
o
w
w
w
d
V
V
V
w
o
F
w
Y
w
w
d
V
V
V
V
V
V
V
V
V
V
V
v
v
v
a
"}
(43,1,1) = {"
w
w
w
o
w
w
w
w
w
w
w
w
w
w
w
e
w
w
w
w
w
o
w
w
w
w
w
w
w
w
w
w
w
o
w
w
w
w
V
V
d
V
V
V
w
w
w
w
o
w
V
d
V
V
V
V
V
V
V
V
V
V
V
v
v
v
a
"}
(44,1,1) = {"
w
w
w
w
w
w
w
o
w
w
w
w
o
w
w
w
w
w
w
w
w
w
w
w
w
w
o
w
w
w
w
w
w
w
H
w
V
V
V
V
d
V
V
V
w
o
w
w
w
V
V
d
V
V
V
V
V
V
V
V
V
V
V
v
v
v
a
"}
(45,1,1) = {"
w
F
w
w
w
w
O
F
w
w
w
w
w
w
Y
w
w
w
w
w
w
w
w
w
w
w
w
w
w
w
w
w
w
w
V
V
V
V
V
V
d
V
V
V
V
g
w
w
V
V
V
d
V
V
V
V
V
V
V
V
V
V
V
v
v
v
a
"}
(46,1,1) = {"
w
w
w
w
w
w
w
w
w
w
w
w
w
w
w
w
w
w
w
o
w
w
w
w
w
w
w
w
w
w
o
w
w
w
V
V
V
V
V
V
d
V
V
V
V
V
V
V
V
V
V
d
V
V
V
V
V
V
V
V
V
V
V
v
v
v
a
"}
(47,1,1) = {"
w
w
o
w
w
o
w
o
w
w
w
w
w
w
w
w
w
w
o
w
w
w
w
w
w
w
w
w
w
w
w
w
w
w
V
V
V
V
V
V
d
V
V
V
V
V
V
V
V
V
V
d
V
V
V
V
V
V
V
V
V
V
V
v
v
v
a
"}
(48,1,1) = {"
w
w
w
w
w
w
w
w
w
w
w
w
w
w
w
w
w
w
w
w
w
w
w
w
w
w
w
w
w
w
w
w
w
V
V
V
V
V
V
V
d
d
d
d
d
d
d
d
d
d
d
d
V
V
V
V
V
V
V
V
V
V
V
v
v
v
a
"}
(49,1,1) = {"
w
F
w
w
w
w
w
w
V
V
V
V
V
V
V
w
w
w
w
w
w
w
w
w
o
w
w
w
w
w
w
w
w
V
V
V
V
V
V
V
V
V
V
V
V
V
V
V
V
V
V
V
V
V
V
V
V
V
V
V
V
V
V
v
v
v
a
"}
(50,1,1) = {"
w
w
w
V
V
V
V
V
V
V
V
V
V
V
V
V
V
w
w
w
o
w
w
w
w
w
w
w
o
w
w
V
V
V
V
V
V
V
V
V
V
V
V
V
V
V
V
V
V
V
V
V
V
V
V
V
V
V
V
V
V
V
V
v
v
v
a
"}
(51,1,1) = {"
w
w
w
V
V
V
V
V
V
V
V
V
V
V
V
V
V
V
V
w
w
w
w
w
w
w
w
w
w
w
V
V
V
V
V
V
V
V
V
V
V
V
V
V
V
V
V
V
V
V
V
V
V
V
V
V
V
V
V
V
V
V
V
v
v
v
a
"}
(52,1,1) = {"
V
V
V
V
V
V
V
V
V
V
V
V
V
V
V
V
V
V
V
V
V
V
V
V
V
V
V
V
V
V
V
V
V
V
V
V
V
V
V
V
V
V
V
V
V
V
V
V
V
V
V
V
V
V
V
V
V
V
V
V
V
V
V
v
v
v
a
"}
(53,1,1) = {"
V
V
V
V
V
V
V
V
V
V
V
V
V
V
V
V
V
V
V
V
V
V
V
V
V
V
V
V
V
V
V
V
V
V
V
V
V
V
V
V
V
V
V
V
V
V
V
V
V
V
V
V
V
V
V
V
V
V
V
V
V
V
V
v
v
v
a
"}
(54,1,1) = {"
V
V
V
V
V
V
V
V
V
V
V
V
V
V
V
V
V
V
V
V
V
V
V
V
V
V
V
V
V
V
V
V
V
V
V
V
V
V
V
V
V
V
V
V
V
V
V
V
V
V
V
V
V
V
V
V
V
V
V
V
V
V
V
v
v
v
a
"}
(55,1,1) = {"
V
V
V
V
V
V
V
V
V
V
V
V
V
V
V
V
V
V
V
V
V
V
V
V
V
V
V
V
V
V
V
V
V
V
V
V
V
V
V
V
V
V
V
V
V
V
V
V
V
V
V
V
V
V
V
V
V
V
V
V
V
V
V
v
v
v
a
"}
(56,1,1) = {"
V
V
V
V
V
V
V
V
V
V
V
V
V
V
V
V
V
V
V
V
V
V
V
V
V
V
V
V
V
V
V
V
V
V
V
V
V
V
V
V
V
V
V
V
V
V
V
V
V
V
V
V
V
V
V
V
V
V
V
V
V
V
V
v
v
v
a
"}
(57,1,1) = {"
V
V
V
V
V
V
V
V
V
V
V
V
V
V
V
V
V
V
V
V
V
V
V
V
V
V
V
V
V
V
V
V
V
V
V
V
V
V
V
V
V
V
V
V
V
V
V
V
V
V
V
V
V
V
V
V
V
V
V
V
V
V
V
v
v
v
a
"}
(58,1,1) = {"
V
V
V
V
V
V
V
V
V
V
V
V
V
V
V
V
V
V
V
V
V
V
V
V
V
V
V
V
V
V
V
V
V
V
V
V
V
V
V
V
V
V
V
V
V
V
V
V
V
V
V
V
V
V
V
V
V
V
V
V
V
V
V
v
v
v
a
"}
(59,1,1) = {"
V
V
V
V
V
V
V
V
V
V
V
V
V
V
V
V
V
V
V
V
V
V
V
V
V
V
V
V
V
V
V
V
V
V
V
V
V
V
V
V
V
V
V
V
V
V
V
V
V
V
V
V
V
V
V
V
V
V
V
V
V
V
V
v
v
v
a
"}
(60,1,1) = {"
V
V
V
V
V
V
V
V
V
V
V
V
V
V
V
V
V
V
V
V
V
V
V
V
V
V
V
V
V
V
V
V
V
V
V
V
V
V
V
V
V
V
V
V
V
V
V
V
V
V
V
V
V
V
V
V
V
V
V
V
V
V
V
v
v
v
a
"}
(61,1,1) = {"
V
V
V
V
V
V
V
V
V
V
V
V
V
V
V
V
V
V
V
V
V
V
V
V
V
V
V
V
V
V
V
V
V
V
V
V
V
V
V
V
V
V
V
V
V
V
V
V
V
V
V
V
V
V
V
V
V
V
V
V
V
V
V
v
v
v
a
"}
(62,1,1) = {"
V
V
V
V
V
V
V
V
V
V
V
V
V
V
V
V
V
V
V
V
V
V
V
V
V
V
V
V
V
V
V
V
V
V
V
V
V
V
V
V
V
V
V
V
V
V
V
V
V
V
V
V
V
V
V
V
V
V
V
V
V
V
V
v
v
v
a
"}
(63,1,1) = {"
v
v
v
v
v
v
v
v
v
v
v
v
v
v
v
v
v
v
v
v
v
v
v
v
v
v
v
v
v
v
v
v
v
v
v
v
v
v
v
v
v
v
v
v
v
v
v
v
v
v
v
v
v
v
v
v
v
v
v
v
v
v
v
v
v
v
a
"}
(64,1,1) = {"
v
v
v
v
v
v
v
v
v
v
v
v
v
v
v
v
v
v
v
v
v
v
v
v
v
v
v
v
v
v
v
v
v
v
v
v
v
v
v
v
v
v
v
v
v
v
v
v
v
v
v
v
v
v
v
v
v
v
v
v
v
v
v
v
v
v
a
"}
(65,1,1) = {"
v
v
v
v
v
v
v
v
v
v
v
v
v
v
v
v
v
v
v
v
v
v
v
v
v
v
v
v
v
v
v
v
v
v
v
v
v
v
v
v
v
v
v
v
v
v
v
v
v
v
v
v
v
v
v
v
v
v
v
v
v
v
v
v
v
v
a
"}
(66,1,1) = {"
v
v
v
v
v
v
v
v
v
v
v
v
v
v
v
v
v
v
v
v
v
v
v
v
v
v
v
v
v
v
v
v
v
v
v
v
v
v
v
v
v
v
v
v
v
v
v
v
v
v
v
v
v
v
v
v
v
v
v
v
v
v
v
v
v
v
a
"}
(67,1,1) = {"
v
v
v
v
v
v
v
v
v
v
v
v
v
v
v
v
v
v
v
v
v
v
v
v
v
v
v
v
v
v
v
v
v
v
v
v
v
v
v
v
v
v
v
v
v
v
v
v
v
v
v
v
v
v
v
v
v
v
v
v
v
v
v
v
v
v
a
"}
(68,1,1) = {"
v
v
v
v
v
v
v
v
v
v
v
v
v
v
v
v
v
v
v
v
v
v
v
v
v
v
v
v
v
v
v
v
v
v
v
v
v
v
v
v
v
v
v
v
v
v
v
v
v
v
v
v
v
v
v
v
v
v
v
v
v
v
v
v
v
v
a
"}
(69,1,1) = {"
v
v
v
v
v
v
v
v
v
v
v
v
v
v
v
v
v
v
v
v
v
v
v
v
v
v
v
v
v
v
v
v
v
v
v
v
v
v
v
v
v
v
v
v
v
v
v
v
v
v
v
v
v
v
v
v
v
v
v
v
v
v
v
v
v
v
a
"}
(70,1,1) = {"
v
v
v
v
v
v
v
v
v
v
v
v
v
v
v
v
v
v
v
v
v
v
v
v
v
v
v
v
v
v
v
v
v
v
v
v
v
v
v
v
v
v
v
v
v
v
v
v
v
v
v
v
v
v
v
v
v
v
v
v
v
v
v
v
v
v
a
"}
(71,1,1) = {"
v
v
v
v
v
v
v
v
v
v
v
v
v
v
v
v
v
v
v
v
v
v
v
v
v
v
v
v
v
v
v
v
v
v
v
v
v
v
v
v
v
v
v
v
v
v
v
v
v
v
v
v
v
v
v
v
v
v
v
v
v
v
v
v
v
v
a
"}
