//MAP CONVERTED BY dmm2tgm.py THIS HEADER COMMENT PREVENTS RECONVERSION, DO NOT REMOVE
"a" = (
/obj/effect/landmark/weed_node,
/turf/open/floor/plating/ground/mars/random/cave,
/area/bigredv2/caves/east)
"b" = (
/obj/effect/landmark/xeno_resin_door,
/turf/open/floor/plating/ground/mars/random/cave,
/area/bigredv2/caves/east)
"c" = (
/obj/effect/landmark/xeno_silo_spawn,
/turf/open/floor/plating/ground/mars/random/cave,
/area/bigredv2/caves/east)
"d" = (
/obj/docking_port/stationary/crashmode,
/turf/closed/mineral/smooth/bigred,
/area/bigredv2/caves/rock)
"e" = (
/obj/effect/landmark/xeno_resin_door,
/obj/effect/ai_node,
/turf/open/floor/plating/ground/mars/random/cave,
/area/bigredv2/caves/east)
"f" = (
/obj/machinery/miner/damaged/platinum,
/turf/open/floor/plating/ground/mars/random/cave,
/area/bigredv2/caves/east)
"h" = (
/obj/effect/landmark/lv624/fog_blocker,
/turf/closed/mineral/smooth/bigred,
/area/bigredv2/caves/rock)
"i" = (
/obj/effect/ai_node,
/turf/open/floor/plating/ground/mars/random/cave/rock,
/area/bigredv2/caves/east)
"j" = (
/turf/closed/mineral/smooth/bigred/indestructible,
/area/space)
"m" = (
/obj/effect/landmark/lv624/fog_blocker/xeno_spawn,
/obj/effect/landmark/xeno_resin_wall,
/turf/open/floor/plating/ground/mars/random/cave,
/area/bigredv2/caves/east)
"n" = (
/obj/structure/fence,
/obj/effect/landmark/lv624/fog_blocker,
/turf/open/floor/plating/ground/mars/random/cave,
/area/bigredv2/caves/east)
"o" = (
/turf/open/floor/plating/ground/mars/random/cave/rock,
/area/bigredv2/caves/east)
"q" = (
/obj/effect/ai_node,
/turf/open/floor/plating/ground/mars/random/sand,
/area/bigredv2/outside/se)
"s" = (
/obj/effect/landmark/lv624/fog_blocker/xeno_spawn,
/turf/closed/mineral/smooth/bigred,
/area/bigredv2/caves/rock)
"u" = (
/obj/effect/landmark/lv624/fog_blocker/xeno_spawn,
/turf/open/floor/plating/ground/mars/random/cave/rock,
/area/bigredv2/caves/east)
"v" = (
/obj/docking_port/stationary/crashmode,
/turf/open/floor/plating/ground/mars/random/cave,
/area/bigredv2/caves/east)
"w" = (
/obj/effect/landmark/lv624/fog_blocker/xeno_spawn,
/obj/effect/landmark/lv624/fog_blocker/xeno_spawn,
/turf/open/floor/plating/ground/mars/random/cave,
/area/bigredv2/caves/east)
"A" = (
/turf/open/floor/plating/ground/mars/random/sand,
/area/bigredv2/outside/se)
"D" = (
/obj/effect/landmark/excavation_site_spawner,
/turf/open/floor/plating/ground/mars/random/cave,
/area/bigredv2/caves/east)
"F" = (
/turf/closed/mineral/smooth/bigred,
/area/bigredv2/caves/rock)
"G" = (
/obj/effect/landmark/weed_node,
/turf/open/floor/plating/ground/mars/random/sand,
/area/bigredv2/outside/se)
"I" = (
/obj/effect/landmark/lv624/fog_blocker/xeno_spawn,
/turf/open/floor/plating/ground/mars/random/cave,
/area/bigredv2/caves/east)
"K" = (
/obj/effect/landmark/lv624/fog_blocker/xeno_spawn,
/obj/effect/landmark/lv624/fog_blocker/xeno_spawn,
/turf/closed/mineral/smooth/bigred,
/area/bigredv2/caves/rock)
"M" = (
/obj/effect/landmark/xeno_resin_door,
/turf/open/floor/plating/ground/mars/random/cave/rock,
/area/bigredv2/caves/east)
"N" = (
/turf/open/floor/plating/ground/mars/random/cave,
/area/bigredv2/caves/east)
"O" = (
/obj/effect/landmark/weed_node,
/turf/open/floor/plating/ground/mars/random/cave/rock,
/area/bigredv2/caves/east)
"Q" = (
/obj/effect/landmark/weed_node,
/obj/effect/ai_node,
/turf/open/floor/plating/ground/mars/random/cave,
/area/bigredv2/caves/east)
"U" = (
/obj/effect/ai_node,
/turf/open/floor/plating/ground/mars/random/cave,
/area/bigredv2/caves/east)
"Z" = (
/obj/effect/landmark/xeno_resin_wall,
/turf/open/floor/plating/ground/mars/random/cave,
/area/bigredv2/caves/east)

(1,1,1) = {"
A
A
A
A
A
A
A
A
A
A
A
F
F
F
n
N
a
N
N
a
N
N
N
N
N
a
N
N
F
F
F
F
F
F
F
F
F
N
a
N
N
a
"}
(2,1,1) = {"
A
A
G
A
A
A
G
A
A
A
A
F
F
F
h
N
N
N
N
N
N
N
N
N
N
N
N
N
F
F
F
F
F
F
F
F
F
F
N
N
U
N
"}
(3,1,1) = {"
A
A
A
A
A
A
A
A
A
A
A
F
F
F
h
N
N
N
N
N
N
F
F
F
F
F
N
N
N
F
F
F
F
F
F
F
F
F
N
N
N
N
"}
(4,1,1) = {"
A
F
F
F
F
A
A
A
G
A
A
G
F
F
h
N
N
N
a
N
N
F
F
F
F
F
o
N
N
N
N
a
N
N
N
F
o
o
N
N
N
N
"}
(5,1,1) = {"
A
F
F
F
F
F
F
A
A
A
A
A
A
F
h
F
N
w
I
I
s
s
s
s
s
s
I
u
w
N
N
N
N
N
a
o
N
N
a
N
N
a
"}
(6,1,1) = {"
A
A
F
F
F
F
F
F
A
A
A
A
A
F
h
F
F
I
N
F
F
F
F
F
F
N
N
N
u
O
U
N
N
N
N
N
N
N
N
N
U
o
"}
(7,1,1) = {"
A
A
A
A
A
A
A
A
A
A
A
A
A
F
h
F
F
m
Z
Z
N
F
N
F
F
N
U
N
I
U
N
N
a
N
N
N
N
a
N
f
N
o
"}
(8,1,1) = {"
A
G
A
A
G
A
A
A
G
A
A
G
A
F
h
F
F
s
N
N
N
Q
N
N
e
U
N
N
I
N
N
N
N
N
N
N
o
N
N
N
o
F
"}
(9,1,1) = {"
A
A
A
A
A
q
A
A
A
q
A
A
A
F
h
F
F
s
N
N
N
N
N
N
b
N
N
F
s
F
F
F
N
N
N
N
a
o
N
N
N
o
"}
(10,1,1) = {"
A
A
A
A
A
A
A
A
A
A
A
A
F
F
h
F
F
s
F
F
N
N
N
N
Z
F
F
F
s
F
F
F
F
F
F
F
N
N
N
a
a
o
"}
(11,1,1) = {"
A
A
F
A
A
A
A
A
A
A
A
F
F
F
h
F
F
s
F
N
N
N
N
N
Z
Z
F
F
s
F
F
F
F
F
F
F
N
N
N
N
N
o
"}
(12,1,1) = {"
A
F
F
A
G
A
A
A
G
F
F
F
F
F
h
F
F
s
N
o
N
N
O
a
N
N
F
F
s
F
F
F
F
F
F
F
N
N
N
a
N
o
"}
(13,1,1) = {"
F
F
F
A
A
A
A
A
A
F
F
F
F
F
h
F
F
s
N
a
N
N
N
N
N
N
F
F
s
F
F
F
F
F
F
F
o
N
a
N
o
F
"}
(14,1,1) = {"
F
F
A
A
A
A
A
A
A
F
F
F
F
F
h
F
F
s
N
N
N
U
c
N
N
a
N
F
s
F
F
F
F
F
F
F
N
N
a
N
U
o
"}
(15,1,1) = {"
F
A
A
A
A
A
F
F
F
F
F
F
F
F
h
F
F
s
N
N
N
N
N
N
a
N
F
F
s
F
F
F
F
F
F
F
F
o
N
N
N
o
"}
(16,1,1) = {"
G
A
A
A
G
q
F
F
F
F
F
F
F
F
h
F
F
s
F
F
F
N
N
N
N
F
F
F
s
F
F
F
F
F
F
F
F
F
b
b
b
b
"}
(17,1,1) = {"
A
A
A
A
A
A
F
F
F
F
F
F
F
F
h
F
F
s
F
F
F
F
F
F
F
F
F
F
s
F
F
F
F
F
F
F
F
F
N
N
N
N
"}
(18,1,1) = {"
F
F
F
F
F
F
F
F
F
F
F
F
F
F
h
F
F
K
s
s
s
s
s
s
s
s
s
s
K
F
F
F
F
F
F
F
N
N
N
N
N
N
"}
(19,1,1) = {"
h
h
h
h
h
h
h
h
h
h
h
h
h
h
h
F
F
F
F
F
F
F
F
F
F
F
F
F
F
F
F
F
F
F
F
N
N
N
N
a
N
N
"}
(20,1,1) = {"
F
F
F
F
F
F
F
F
F
F
F
F
F
F
F
F
F
F
F
F
F
F
F
F
F
d
F
F
F
F
F
F
F
F
N
N
N
N
N
N
N
N
"}
(21,1,1) = {"
F
F
F
F
F
F
F
F
F
F
F
F
F
F
F
F
F
F
F
F
F
F
F
F
F
F
F
F
F
F
F
F
N
N
N
a
N
N
N
o
N
N
"}
(22,1,1) = {"
F
o
o
o
o
o
F
F
F
F
F
F
F
F
F
F
F
F
F
F
F
F
o
o
o
o
o
F
F
F
N
N
N
U
N
N
N
N
N
N
U
N
"}
(23,1,1) = {"
F
U
N
a
N
N
i
F
F
F
F
F
F
F
F
F
F
F
i
o
o
o
a
N
U
N
N
o
O
N
N
N
U
a
N
N
o
F
F
N
a
N
"}
(24,1,1) = {"
F
o
N
N
N
N
o
F
F
F
F
F
F
F
F
F
F
F
N
N
N
N
N
N
N
a
N
N
N
N
o
N
N
o
N
N
o
F
F
N
N
N
"}
(25,1,1) = {"
F
F
F
o
N
N
o
N
N
N
N
F
F
F
F
F
F
o
N
a
N
N
N
N
N
N
N
N
N
N
N
N
o
N
N
o
F
F
F
N
N
N
"}
(26,1,1) = {"
F
F
F
F
F
N
o
N
N
N
N
F
F
F
F
o
o
N
N
N
a
N
N
a
N
N
N
N
N
N
a
N
N
N
o
F
F
F
F
N
U
N
"}
(27,1,1) = {"
o
o
o
o
o
N
o
a
N
N
N
N
b
N
N
N
N
N
N
N
N
N
N
N
N
N
a
N
N
N
N
N
N
N
N
o
F
o
o
N
D
N
"}
(28,1,1) = {"
N
N
N
N
N
N
U
o
o
o
o
o
M
o
a
N
i
N
U
N
N
N
N
N
N
f
N
N
N
N
a
N
N
N
N
N
o
N
N
N
N
N
"}
(29,1,1) = {"
N
N
N
a
N
N
N
N
N
N
a
N
b
N
N
N
o
N
N
o
N
N
N
D
N
N
N
N
N
N
N
N
N
N
a
N
N
N
N
a
N
N
"}
(30,1,1) = {"
N
N
N
N
N
N
N
N
N
N
N
N
b
N
N
N
i
N
N
N
a
N
N
N
U
o
N
a
N
N
a
N
N
U
N
N
N
N
N
N
i
F
"}
(31,1,1) = {"
a
N
N
N
N
N
N
N
N
N
N
o
F
F
N
N
o
N
N
N
N
N
N
N
N
U
N
N
N
N
N
N
N
N
N
N
N
N
N
N
o
F
"}
(32,1,1) = {"
o
N
N
N
N
N
N
F
F
F
F
F
F
F
F
N
o
N
N
N
N
N
N
N
N
N
N
N
N
N
N
N
N
N
N
N
a
N
N
o
N
F
"}
(33,1,1) = {"
N
N
N
a
f
N
N
F
F
F
F
F
F
F
F
N
o
a
N
N
U
N
N
a
N
N
N
N
F
F
F
F
F
F
N
N
N
N
o
N
N
N
"}
(34,1,1) = {"
o
N
N
o
N
N
N
F
F
F
F
F
F
F
o
N
N
N
N
N
N
F
F
F
F
F
F
F
F
F
F
F
F
F
a
N
N
N
o
N
N
N
"}
(35,1,1) = {"
F
o
N
N
N
N
N
N
F
F
F
F
F
o
N
N
N
N
N
N
F
F
F
F
F
F
F
F
F
F
F
F
F
F
F
F
F
F
F
b
b
b
"}
(36,1,1) = {"
F
F
F
N
N
o
N
N
N
F
F
F
o
N
N
N
N
N
N
F
F
F
F
F
F
F
F
F
F
F
F
F
F
F
F
F
F
F
F
F
U
N
"}
(37,1,1) = {"
F
F
F
N
N
O
U
N
v
o
N
N
N
N
N
N
i
F
F
F
F
F
F
F
F
F
F
F
F
F
F
F
F
F
F
F
F
F
F
F
N
N
"}
(38,1,1) = {"
F
F
F
N
N
D
N
N
N
N
N
N
N
a
N
o
o
F
F
F
F
F
F
F
F
F
F
F
F
F
F
F
F
F
F
F
F
F
F
F
F
N
"}
(39,1,1) = {"
F
F
F
F
N
N
N
N
N
N
N
N
N
a
N
F
F
F
F
F
F
F
F
F
F
F
F
F
F
F
F
F
F
F
F
F
F
F
F
F
F
F
"}
(40,1,1) = {"
F
F
F
F
N
N
N
N
N
a
N
N
N
N
N
F
F
F
F
F
F
F
F
F
F
F
F
F
F
F
F
F
F
F
F
F
F
F
F
F
F
F
"}
(41,1,1) = {"
F
F
F
N
N
N
N
N
N
N
N
N
N
N
F
F
F
F
F
F
F
F
F
F
F
F
F
F
F
F
F
F
F
F
F
F
F
F
F
F
F
F
"}
(42,1,1) = {"
F
F
F
N
N
N
a
N
N
F
F
F
F
F
F
F
F
F
F
F
F
F
F
F
F
F
F
F
F
F
F
F
F
F
F
F
F
F
F
F
F
F
"}
(43,1,1) = {"
F
F
N
N
N
N
N
N
N
F
F
F
F
F
F
F
F
F
F
s
s
s
s
s
s
s
s
s
s
s
s
F
F
F
F
F
F
F
F
F
F
F
"}
(44,1,1) = {"
F
F
b
b
b
b
b
b
F
F
F
F
F
F
F
F
F
F
F
s
F
F
F
F
F
F
F
F
F
F
s
F
F
F
F
F
F
F
F
F
F
F
"}
(45,1,1) = {"
F
F
N
N
N
N
N
N
F
F
F
F
F
F
F
F
F
F
F
s
F
F
F
N
a
N
N
a
F
F
s
F
F
F
F
F
F
F
F
F
F
F
"}
(46,1,1) = {"
N
N
N
N
N
a
N
N
F
F
F
F
F
F
F
F
F
F
F
s
F
F
N
N
N
N
c
N
N
F
s
F
F
F
N
N
N
N
N
N
N
N
"}
(47,1,1) = {"
N
N
U
N
N
N
U
F
F
F
F
F
F
F
F
F
F
F
F
s
F
F
N
N
N
N
N
N
a
N
s
F
F
F
N
N
N
N
N
N
N
N
"}
(48,1,1) = {"
N
N
a
N
N
N
N
F
F
F
F
F
F
F
F
F
F
F
F
s
F
F
N
a
N
N
N
N
N
N
s
F
F
N
N
N
N
N
N
U
N
N
"}
(49,1,1) = {"
N
N
U
N
a
N
F
F
F
F
F
F
F
F
F
F
F
F
F
s
F
Z
Z
Z
b
b
b
b
Z
Z
s
F
F
N
N
N
a
N
N
N
a
N
"}
(50,1,1) = {"
N
N
N
N
N
N
F
F
F
F
F
F
F
F
F
F
F
F
F
s
I
I
I
I
I
I
I
I
I
I
I
N
N
N
N
N
N
N
N
N
N
N
"}
(51,1,1) = {"
N
N
N
N
N
N
F
F
F
F
F
F
F
F
F
F
F
F
F
F
N
N
N
N
N
N
N
N
N
N
N
N
N
N
N
N
N
N
N
N
N
N
"}
(52,1,1) = {"
N
O
N
N
N
a
F
F
F
N
N
N
N
N
N
N
N
N
N
N
N
N
N
N
N
N
N
N
N
N
U
a
N
N
N
N
D
N
a
U
N
N
"}
(53,1,1) = {"
N
N
N
N
N
N
F
F
F
N
N
N
N
N
N
a
N
a
N
N
N
N
N
o
a
N
N
N
N
N
N
N
N
N
o
N
N
N
N
N
N
N
"}
(54,1,1) = {"
N
N
N
N
N
N
N
N
N
N
N
N
N
N
N
N
N
N
N
D
a
N
N
N
N
N
N
f
N
N
N
N
N
N
N
N
N
N
N
N
N
N
"}
(55,1,1) = {"
a
N
U
N
N
a
N
N
N
N
N
a
U
N
N
a
N
N
N
N
U
N
N
N
N
a
N
N
N
N
U
N
N
N
N
N
N
N
N
N
N
N
"}
(56,1,1) = {"
N
N
N
N
N
N
N
N
N
N
N
o
N
N
N
N
N
N
N
N
N
N
N
N
N
N
N
N
N
N
N
a
N
N
F
F
F
F
F
F
F
F
"}
(57,1,1) = {"
N
N
N
F
N
N
N
N
N
N
N
N
N
N
N
N
N
O
N
N
N
N
N
N
N
N
N
N
N
N
N
N
N
N
F
F
F
F
F
F
F
F
"}
(58,1,1) = {"
N
N
N
F
F
F
F
F
F
N
a
N
N
N
N
N
N
N
N
N
N
N
N
N
N
N
F
F
F
F
F
F
F
F
F
F
F
F
F
F
F
F
"}
(59,1,1) = {"
N
N
F
F
F
F
F
F
F
N
N
N
N
N
N
N
a
N
N
N
N
N
N
N
N
N
F
F
F
F
F
F
F
F
F
F
F
F
F
F
F
F
"}
(60,1,1) = {"
F
F
F
F
F
F
F
F
F
F
F
F
F
N
N
N
N
N
F
F
F
F
F
F
F
F
F
F
F
F
F
F
F
F
F
F
F
F
F
F
F
F
"}
(61,1,1) = {"
F
F
F
F
F
F
F
F
F
F
F
F
F
F
F
F
F
F
F
F
F
F
F
F
F
F
F
F
F
F
F
F
F
F
F
F
F
F
F
F
F
F
"}
(62,1,1) = {"
s
s
F
F
F
F
F
F
F
F
F
F
F
F
F
F
F
F
F
F
F
F
F
F
F
F
F
F
F
F
F
F
F
F
F
F
F
F
F
F
F
F
"}
(63,1,1) = {"
F
s
s
F
F
F
F
F
F
F
F
F
F
F
F
F
F
F
F
F
F
F
F
F
F
F
F
F
F
F
F
F
F
F
F
F
F
F
F
F
F
F
"}
(64,1,1) = {"
F
F
s
F
F
F
F
F
F
F
F
F
F
F
F
F
F
F
F
F
F
F
F
F
F
F
F
F
F
F
F
F
F
F
F
F
F
F
F
F
F
F
"}
(65,1,1) = {"
F
F
s
F
F
F
F
F
F
F
F
F
F
F
F
F
F
F
F
F
F
F
F
F
F
F
F
F
F
F
F
F
F
F
F
F
F
F
F
F
F
F
"}
(66,1,1) = {"
N
F
j
j
j
j
j
j
j
j
j
j
j
j
j
j
j
j
j
j
j
j
j
j
j
j
j
j
j
j
j
j
j
j
j
j
j
j
j
j
j
j
"}
