//MAP CONVERTED BY dmm2tgm.py THIS HEADER COMMENT PREVENTS RECONVERSION, DO NOT REMOVE
"aa" = (
/obj/effect/landmark/weed_node,
/turf/open/floor/plating/ground/mars/random/cave,
/area/bigredv2/caves/east)
"ab" = (
/atom/movable/effect/ai_node,
/turf/open/floor/plating/ground/mars/random/cave,
/area/bigredv2/caves/east)
"ac" = (
/obj/effect/landmark/xeno_resin_door,
/turf/open/floor/plating/ground/mars/random/cave,
/area/bigredv2/caves/east)
"ad" = (
/obj/effect/landmark/weed_node,
/turf/open/floor/plating/ground/mars/random/sand,
/area/bigredv2/outside/se)
"ae" = (
/turf/closed/mineral/smooth/bigred/indestructible,
/area/space)
"af" = (
/turf/closed/wall/indestructible/mineral,
/area/space)
"ag" = (
/obj/machinery/miner/damaged/platinum,
/turf/open/floor/plating/ground/mars/random/cave,
/area/bigredv2/caves/east)
"ah" = (
/turf/closed/mineral/bigred,
/area/bigredv2/caves/rock)
"ai" = (
/obj/structure/fence,
/obj/effect/landmark/lv624/fog_blocker,
/turf/open/floor/plating/ground/mars/random/cave,
/area/bigredv2/caves/east)
"aj" = (
/atom/movable/effect/landmark/lv624/fog_blocker,
/turf/closed/mineral/smooth/bigred,
/area/bigredv2/caves/rock)
"ak" = (
/obj/structure/fence,
/atom/movable/effect/landmark/lv624/fog_blocker,
/turf/open/floor/plating/ground/mars/random/cave,
/area/bigredv2/caves/east)
"al" = (
/atom/movable/effect/landmark/lv624/fog_blocker/xeno_spawn,
/atom/movable/effect/landmark/xeno_resin_wall,
/turf/open/floor/plating/ground/mars/random/cave,
/area/bigredv2/caves/east)
"am" = (
/obj/docking_port/stationary/crashmode,
/turf/open/floor/plating/ground/mars/random/cave,
/area/bigredv2/caves/east)
"an" = (
/obj/effect/landmark/lv624/fog_blocker/xeno_spawn,
/obj/effect/landmark/lv624/fog_blocker/xeno_spawn,
/turf/open/floor/plating/ground/mars/random/cave,
/area/bigredv2/caves/east)
"ao" = (
/turf/open/floor/plating/ground/mars/random/sand,
/area/bigredv2/outside/se)
"ap" = (
/obj/effect/landmark/xeno_resin_door,
/turf/open/floor/plating/ground/mars/random/cave/rock,
/area/bigredv2/caves/east)
"aq" = (
/atom/movable/effect/landmark/lv624/fog_blocker/xeno_spawn,
/atom/movable/effect/landmark/lv624/fog_blocker/xeno_spawn,
/turf/closed/mineral/smooth/bigred,
/area/bigredv2/caves/rock)
"ar" = (
/atom/movable/effect/landmark/xeno_resin_wall,
/turf/open/floor/plating/ground/mars/random/cave,
/area/bigredv2/caves/east)
"as" = (
/atom/movable/effect/landmark/xeno_silo_spawn,
/turf/open/floor/plating/ground/mars/random/cave,
/area/bigredv2/caves/east)
"at" = (
/atom/movable/effect/landmark/lv624/fog_blocker/xeno_spawn,
/turf/closed/mineral/smooth/bigred,
/area/bigredv2/caves/rock)
"au" = (
/obj/effect/ai_node,
/turf/open/floor/plating/ground/mars/random/cave/rock,
/area/bigredv2/caves/east)
"av" = (
/obj/effect/landmark/lv624/fog_blocker/xeno_spawn,
/turf/open/floor/plating/ground/mars/random/cave/rock,
/area/bigredv2/caves/east)
"aw" = (
/atom/movable/effect/landmark/excavation_site_spawner,
/turf/open/floor/plating/ground/mars/random/cave,
/area/bigredv2/caves/east)
"ax" = (
/obj/effect/landmark/lv624/fog_blocker/xeno_spawn,
/obj/effect/landmark/lv624/fog_blocker/xeno_spawn,
/turf/closed/mineral/bigred,
/area/bigredv2/caves/rock)
"ay" = (
/turf/open/floor/plating/ground/mars/random/cave/rock,
/area/bigredv2/caves/east)
"az" = (
/atom/movable/effect/landmark/lv624/fog_blocker/xeno_spawn,
/turf/open/floor/plating/ground/mars/random/cave/rock,
/area/bigredv2/caves/east)
"aA" = (
/atom/movable/effect/landmark/weed_node,
/atom/movable/effect/ai_node,
/turf/open/floor/plating/ground/mars/random/cave,
/area/bigredv2/caves/east)
"aB" = (
/obj/effect/landmark/lv624/fog_blocker/xeno_spawn,
/turf/closed/mineral/bigred,
/area/bigredv2/caves/rock)
"aC" = (
/atom/movable/effect/landmark/xeno_resin_door,
/turf/open/floor/plating/ground/mars/random/cave,
/area/bigredv2/caves/east)
"aD" = (
/obj/effect/landmark/xeno_resin_wall,
/turf/open/floor/plating/ground/mars/random/cave,
/area/bigredv2/caves/east)
"aE" = (
/obj/effect/landmark/lv624/fog_blocker/xeno_spawn,
/turf/open/floor/plating/ground/mars/random/cave,
/area/bigredv2/caves/east)
"aF" = (
/obj/docking_port/stationary/crashmode,
/turf/closed/mineral/smooth/bigred,
/area/bigredv2/caves/rock)
"aG" = (
/obj/effect/ai_node,
/turf/open/floor/plating/ground/mars/random/cave,
/area/bigredv2/caves/east)
"aH" = (
/atom/movable/effect/landmark/weed_node,
/turf/open/floor/plating/ground/mars/random/cave,
/area/bigredv2/caves/east)
"aI" = (
/atom/movable/effect/landmark/lv624/fog_blocker/xeno_spawn,
/turf/open/floor/plating/ground/mars/random/cave,
/area/bigredv2/caves/east)
"aJ" = (
/obj/effect/landmark/lv624/fog_blocker/xeno_spawn,
/obj/effect/ai_node,
/turf/open/floor/plating/ground/mars/random/cave,
/area/bigredv2/caves/east)
"aK" = (
/atom/movable/effect/landmark/lv624/fog_blocker/xeno_spawn,
/atom/movable/effect/ai_node,
/turf/open/floor/plating/ground/mars/random/cave,
/area/bigredv2/caves/east)
"aL" = (
/atom/movable/effect/landmark/xeno_resin_door,
/atom/movable/effect/ai_node,
/turf/open/floor/plating/ground/mars/random/cave,
/area/bigredv2/caves/east)
"aM" = (
/obj/effect/landmark/xeno_silo_spawn,
/turf/open/floor/plating/ground/mars/random/cave,
/area/bigredv2/caves/east)
"aN" = (
/turf/closed/mineral/smooth/bigred,
/area/bigredv2/caves/rock)
"aO" = (
/obj/effect/landmark/weed_node,
/turf/open/floor/plating/ground/mars/random/cave/rock,
/area/bigredv2/caves/east)
"aP" = (
/atom/movable/effect/landmark/weed_node,
/turf/open/floor/plating/ground/mars/random/cave/rock,
/area/bigredv2/caves/east)
"aQ" = (
/obj/effect/ai_node,
/turf/open/floor/plating/ground/mars/random/sand,
/area/bigredv2/outside/se)
"aR" = (
/obj/effect/landmark/excavation_site_spawner,
/turf/open/floor/plating/ground/mars/random/cave,
/area/bigredv2/caves/east)
"aS" = (
/obj/docking_port/stationary/crashmode,
/turf/closed/mineral/bigred,
/area/bigredv2/caves/rock)
"aT" = (
/turf/open/floor/plating/ground/mars/random/cave,
/area/bigredv2/caves/east)
"aU" = (
/obj/effect/landmark/xeno_resin_door,
/obj/effect/ai_node,
/turf/open/floor/plating/ground/mars/random/cave,
/area/bigredv2/caves/east)
"aV" = (
/obj/effect/landmark/weed_node,
/obj/effect/ai_node,
/turf/open/floor/plating/ground/mars/random/cave,
/area/bigredv2/caves/east)
"aW" = (
/obj/effect/landmark/lv624/fog_blocker,
/turf/closed/mineral/bigred,
/area/bigredv2/caves/rock)
"aX" = (
/obj/effect/landmark/lv624/fog_blocker/xeno_spawn,
/obj/effect/landmark/xeno_resin_wall,
/turf/open/floor/plating/ground/mars/random/cave,
/area/bigredv2/caves/east)
"aY" = (
/atom/movable/effect/landmark/lv624/fog_blocker/xeno_spawn,
/atom/movable/effect/landmark/lv624/fog_blocker/xeno_spawn,
/turf/open/floor/plating/ground/mars/random/cave,
/area/bigredv2/caves/east)
"aZ" = (
/atom/movable/effect/ai_node,
/turf/open/floor/plating/ground/mars/random/cave/rock,
/area/bigredv2/caves/east)
"hE" = (
/atom/movable/effect/ai_node,
/turf/open/floor/plating/ground/mars/random/sand,
/area/bigredv2/outside/se)
"vG" = (
/atom/movable/effect/landmark/xeno_resin_door,
/turf/open/floor/plating/ground/mars/random/cave/rock,
/area/bigredv2/caves/east)
"zv" = (
/atom/movable/effect/landmark/weed_node,
/turf/open/floor/plating/ground/mars/random/sand,
/area/bigredv2/outside/se)

(1,1,1) = {"
ao
ao
ao
ao
ao
ao
ao
ao
ao
ao
ao
aN
aN
aN
ak
aT
aH
aT
aT
aH
aT
aT
aT
aT
aT
aH
aT
aT
aN
aN
aN
aN
aN
aN
aN
aN
aN
aT
aH
aT
aT
aH
"}
(2,1,1) = {"
ao
ao
zv
ao
ao
ao
zv
ao
ao
ao
ao
aN
aN
aN
aj
aT
aT
aT
aT
aT
aT
aT
aT
aT
aT
aT
aT
aT
aN
aN
aN
aN
aN
aN
aN
aN
aN
aN
aT
aT
ab
aT
"}
(3,1,1) = {"
ao
ao
ao
ao
ao
ao
ao
ao
ao
ao
ao
aN
aN
aN
aj
aT
aT
aT
aT
aT
aT
aN
aN
aN
aN
aN
aT
aT
aT
aN
aN
aN
aN
aN
aN
aN
aN
aN
aT
aT
aT
aT
"}
(4,1,1) = {"
ao
aN
aN
aN
aN
ao
ao
ao
zv
ao
ao
zv
aN
aN
aj
aT
aT
aT
aH
aT
aT
aN
aN
aN
aN
aN
ay
aT
aT
aT
aT
aH
aT
aT
aT
aN
ay
ay
aT
aT
aT
aT
"}
(5,1,1) = {"
ao
aN
aN
aN
aN
aN
aN
ao
ao
ao
ao
ao
ao
aN
aj
aN
aT
aY
aI
aI
at
at
at
at
at
at
aI
az
aY
aT
aT
aT
aT
aT
aH
ay
aT
aT
aH
aT
aT
aH
"}
(6,1,1) = {"
ao
ao
aN
aN
aN
aN
aN
aN
ao
ao
ao
ao
ao
aN
aj
aN
aN
aI
aT
aN
aN
aN
aN
aN
aN
aT
aT
aT
az
aP
ab
aT
aT
aT
aT
aT
aT
aT
aT
aT
ab
ay
"}
(7,1,1) = {"
ao
ao
ao
ao
ao
ao
ao
ao
ao
ao
ao
ao
ao
aN
aj
aN
aN
al
ar
ar
aT
aN
aT
aN
aN
aT
ab
aT
aI
ab
aT
aT
aH
aT
aT
aT
aT
aH
aT
ag
aT
ay
"}
(8,1,1) = {"
ao
zv
ao
ao
zv
ao
ao
ao
zv
ao
ao
zv
ao
aN
aj
aN
aN
at
aT
aT
aT
aA
aT
aT
aL
ab
aT
aT
aI
aT
aT
aT
aT
aT
aT
aT
ay
aT
aT
aT
ay
aN
"}
(9,1,1) = {"
ao
ao
ao
ao
ao
hE
ao
ao
ao
hE
ao
ao
ao
aN
aj
aN
aN
at
aT
aT
aT
aT
aT
aT
aC
aT
aT
aN
at
aN
aN
aN
aT
aT
aT
aT
aH
ay
aT
aT
aT
ay
"}
(10,1,1) = {"
ao
ao
ao
ao
ao
ao
ao
ao
ao
ao
ao
ao
aN
aN
aj
aN
aN
at
aN
aN
aT
aT
aT
aT
ar
aN
aN
aN
at
aN
aN
aN
aN
aN
aN
aN
aT
aT
aT
aH
aH
ay
"}
(11,1,1) = {"
ao
ao
aN
ao
ao
ao
ao
ao
ao
ao
ao
aN
aN
aN
aj
aN
aN
at
aN
aT
aT
aT
aT
aT
ar
ar
aN
aN
at
aN
aN
aN
aN
aN
aN
aN
aT
aT
aT
aT
aT
ay
"}
(12,1,1) = {"
ao
aN
aN
ao
zv
ao
ao
ao
zv
aN
aN
aN
aN
aN
aj
aN
aN
at
aT
ay
aT
aT
aP
aH
aT
aT
aN
aN
at
aN
aN
aN
aN
aN
aN
aN
aT
aT
aT
aH
aT
ay
"}
(13,1,1) = {"
aN
aN
aN
ao
ao
ao
ao
ao
ao
aN
aN
aN
aN
aN
aj
aN
aN
at
aT
aH
aT
aT
aT
aT
aT
aT
aN
aN
at
aN
aN
aN
aN
aN
aN
aN
ay
aT
aH
aT
ay
aN
"}
(14,1,1) = {"
aN
aN
ao
ao
ao
ao
ao
ao
ao
aN
aN
aN
aN
aN
aj
aN
aN
at
aT
aT
aT
ab
as
aT
aT
aH
aT
aN
at
aN
aN
aN
aN
aN
aN
aN
aT
aT
aH
aT
ab
ay
"}
(15,1,1) = {"
aN
ao
ao
ao
ao
ao
aN
aN
aN
aN
aN
aN
aN
aN
aj
aN
aN
at
aT
aT
aT
aT
aT
aT
aH
aT
aN
aN
at
aN
aN
aN
aN
aN
aN
aN
aN
ay
aT
aT
aT
ay
"}
(16,1,1) = {"
zv
ao
ao
ao
zv
hE
aN
aN
aN
aN
aN
aN
aN
aN
aj
aN
aN
at
aN
aN
aN
aT
aT
aT
aT
aN
aN
aN
at
aN
aN
aN
aN
aN
aN
aN
aN
aN
aC
aC
aC
aC
"}
(17,1,1) = {"
ao
ao
ao
ao
ao
ao
aN
aN
aN
aN
aN
aN
aN
aN
aj
aN
aN
at
aN
aN
aN
aN
aN
aN
aN
aN
aN
aN
at
aN
aN
aN
aN
aN
aN
aN
aN
aN
aT
aT
aT
aT
"}
(18,1,1) = {"
aN
aN
aN
aN
aN
aN
aN
aN
aN
aN
aN
aN
aN
aN
aj
aN
aN
aq
at
at
at
at
at
at
at
at
at
at
aq
aN
aN
aN
aN
aN
aN
aN
aT
aT
aT
aT
aT
aT
"}
(19,1,1) = {"
aj
aj
aj
aj
aj
aj
aj
aj
aj
aj
aj
aj
aj
aj
aj
aN
aN
aN
aN
aN
aN
aN
aN
aN
aN
aN
aN
aN
aN
aN
aN
aN
aN
aN
aN
aT
aT
aT
aT
aH
aT
aT
"}
(20,1,1) = {"
aN
aN
aN
aN
aN
aN
aN
aN
aN
aN
aN
aN
aN
aN
aN
aN
aN
aN
aN
aN
aN
aN
aN
aN
aN
aF
aN
aN
aN
aN
aN
aN
aN
aN
aT
aT
aT
aT
aT
aT
aT
aT
"}
(21,1,1) = {"
aN
aN
aN
aN
aN
aN
aN
aN
aN
aN
aN
aN
aN
aN
aN
aN
aN
aN
aN
aN
aN
aN
aN
aN
aN
aN
aN
aN
aN
aN
aN
aN
aT
aT
aT
aH
aT
aT
aT
ay
aT
aT
"}
(22,1,1) = {"
aN
ay
ay
ay
ay
ay
aN
aN
aN
aN
aN
aN
aN
aN
aN
aN
aN
aN
aN
aN
aN
aN
ay
ay
ay
ay
ay
aN
aN
aN
aT
aT
aT
ab
aT
aT
aT
aT
aT
aT
ab
aT
"}
(23,1,1) = {"
aN
ab
aT
aH
aT
aT
aZ
aN
aN
aN
aN
aN
aN
aN
aN
aN
aN
aN
aZ
ay
ay
ay
aT
aT
ab
aT
aT
ay
aP
aT
aT
aT
ab
aH
aT
aT
ay
aN
aN
aT
aH
aT
"}
(24,1,1) = {"
aN
ay
aT
aT
aT
aT
ay
aN
aN
aN
aN
aN
aN
aN
aN
aN
aN
aN
aT
aT
aT
aT
aT
aT
aT
aH
aT
aT
aT
aT
ay
aT
aT
ay
aT
aT
ay
aN
aN
aT
aT
aT
"}
(25,1,1) = {"
aN
aN
aN
ay
aT
aT
ay
aT
aT
aT
aT
aN
aN
aN
aN
aN
aN
ay
aT
aT
aT
aT
aT
aT
aT
aT
aT
aT
aT
aT
aT
aT
ay
aT
aT
ay
aN
aN
aN
aT
aT
aT
"}
(26,1,1) = {"
aN
aN
aN
aN
aN
aT
ay
aT
aT
aT
aT
aN
aN
aN
aN
ay
ay
aT
aT
aT
aH
aT
aT
aH
aT
aT
aT
aT
aT
aT
aH
aT
aT
aT
ay
aN
aN
aN
aN
aT
ab
aT
"}
(27,1,1) = {"
ay
ay
ay
ay
ay
aT
ay
aH
aT
aT
aT
aT
aC
aT
aT
aT
aT
aT
aT
aT
aT
aT
aT
aT
aT
aT
aH
aT
aT
aT
aT
aT
aT
aT
aT
ay
aN
ay
ay
aT
aT
aT
"}
(28,1,1) = {"
aT
aT
aT
aT
aT
aT
ab
ay
ay
ay
ay
ay
vG
ay
aT
aT
aZ
aT
ab
aT
aT
aT
aT
aT
aT
ag
aT
aT
aT
aT
aH
aT
aT
aT
aT
aT
ay
aT
aT
aT
aT
aT
"}
(29,1,1) = {"
aT
aT
aT
aH
aT
aT
aT
aT
aT
aT
aH
aT
aC
aT
aT
aT
ay
aT
aT
ay
aT
aT
aT
aT
aT
aT
aT
aT
aT
aT
aT
aT
aT
aT
aH
aT
aT
aT
aT
aH
aT
aT
"}
(30,1,1) = {"
aT
aT
aT
aT
aT
aT
aT
aT
aT
aT
aT
aT
aC
aT
aT
aT
aZ
aT
aT
aT
aT
aT
aT
aT
ab
ay
aT
aT
aT
aT
aH
aT
aT
ab
aT
aT
aT
aT
aT
aT
aZ
aN
"}
(31,1,1) = {"
aH
aT
aT
aT
aT
aT
aT
aT
aT
aT
aT
ay
aN
aN
aT
aT
ay
aI
aI
aI
aI
aI
aI
aI
aI
aK
aI
aI
aI
aT
aT
aT
aT
aT
aT
aT
aT
aT
aT
aT
ay
aN
"}
(32,1,1) = {"
ay
aT
aT
aT
aT
aT
aT
aN
aN
aN
aN
aN
aN
aN
aN
aT
ay
aI
ar
ar
ar
ar
ar
ar
ar
aC
aC
ar
al
aT
aT
aT
aT
aT
aT
aT
aH
aT
aT
ay
aT
aN
"}
(33,1,1) = {"
aT
aT
aT
aH
ag
aT
aT
aN
aN
aN
aN
aN
aN
aN
aN
aT
ay
aI
ar
aT
ab
aT
aT
aT
aT
aT
aT
aT
at
aN
aN
aN
aN
aN
aT
aT
aT
aT
ay
aT
aT
aT
"}
(34,1,1) = {"
ay
aT
aT
ay
aT
aT
aT
aN
aN
aN
aN
aN
aN
aN
ay
aT
aT
aI
ar
aT
aT
aT
aT
aT
aT
aT
aT
aN
at
aN
aN
aN
aN
aN
aH
aT
aT
aT
ay
aT
aT
aT
"}
(35,1,1) = {"
aN
ay
aT
aT
aT
aT
aT
aT
aN
aN
aN
aN
aN
ay
aT
aT
aT
aI
ar
aT
aT
aT
as
aT
aH
aT
aT
ay
at
aN
aN
aN
aN
aN
aN
aN
aN
aN
aN
aC
aC
aC
"}
(36,1,1) = {"
aN
aN
aN
aT
aT
ay
aT
aT
aT
aN
aN
aN
ay
aT
aT
aT
aT
aI
ar
aT
aT
aT
aT
aT
aT
aT
aT
ay
at
aN
aN
aN
aN
aN
aN
aN
aN
aN
aN
aN
ab
aT
"}
(37,1,1) = {"
aN
aN
aN
aT
aT
aP
ab
aT
am
ay
aT
aT
aT
aT
aT
aT
aZ
at
aN
aT
aT
aH
aT
aT
aT
aH
aT
ay
at
aN
aN
aN
aN
aN
aN
aN
aN
aN
aN
aN
aT
aT
"}
(38,1,1) = {"
aN
aN
aN
aT
aT
aT
aT
aT
aT
aT
aT
aT
aT
aT
aT
ay
ay
at
aN
aT
ab
aT
aT
aT
aH
ab
ay
aN
at
aN
aN
aN
aN
aN
aN
aN
aN
aN
aN
aN
aN
aT
"}
(39,1,1) = {"
aN
aN
aN
aN
aT
aT
aT
aT
aT
aT
aT
aT
aT
aH
aT
aN
aN
at
aN
aN
ay
aT
aT
aT
aT
ay
aN
aN
at
aN
aN
aN
aN
aN
aN
aN
aN
aN
aN
aN
aN
aN
"}
(40,1,1) = {"
aN
aN
aN
aN
aT
aT
aT
aT
aT
aT
aT
aT
aT
aT
aT
aN
aN
at
at
at
aN
aN
aN
aN
aN
aN
aN
at
at
aN
aN
aN
aN
aN
aN
aN
aN
aN
aN
aN
aN
aN
"}
(41,1,1) = {"
aN
aN
aN
aT
aT
aT
aT
aT
aT
aT
aT
aT
aT
aT
aN
aN
aN
aN
aN
aN
at
at
at
at
at
at
at
aN
aN
aN
aN
aN
aN
aN
aN
aN
aN
aN
aN
aN
aN
aN
"}
(42,1,1) = {"
aN
aN
aN
aT
aT
aT
aH
aT
aT
aN
aN
aN
aN
aN
aN
aN
aN
aN
aN
aN
aN
aN
aN
aN
aN
aN
aN
aN
aN
aN
aN
aN
aN
aN
aN
aN
aN
aN
aN
aN
aN
aN
"}
(43,1,1) = {"
aN
aN
aT
aT
aT
aT
aT
aT
aT
aN
aN
aN
aN
aN
aN
aN
aN
aN
aN
aN
aN
aN
aN
aN
aN
aN
aN
aN
aN
aN
aN
aN
aN
aN
aN
aN
aN
aN
aN
aN
aN
aN
"}
(44,1,1) = {"
aN
aN
aC
aC
aC
aC
aC
aC
aN
aN
aN
aN
aN
aN
aN
aN
aN
aN
aN
aN
aN
aN
aN
aN
aN
aN
aN
aN
aN
aN
aN
aN
aN
aN
aN
aN
aN
aN
aN
aN
aN
aN
"}
(45,1,1) = {"
aN
aN
aT
aT
aT
aT
aT
aT
aN
aN
aN
aN
aN
aN
aN
aN
aN
aN
aN
aN
aN
aN
aN
aN
aN
aN
aN
aN
aN
aN
aN
aN
aN
aN
aN
aN
aN
aN
aN
aN
aN
aN
"}
(46,1,1) = {"
aT
aT
aT
aT
aT
aH
aT
aT
aN
aN
aN
aN
aN
aN
aN
aN
aN
aN
aN
aN
aN
aN
aN
aN
aN
aN
aN
aN
aN
aN
aN
aN
aN
aN
aT
aT
aT
aT
aT
aT
aT
aT
"}
(47,1,1) = {"
aT
aT
ab
aT
aT
aT
ab
aN
aN
aN
aN
aN
aN
aN
aN
aN
aN
aN
aN
aN
aN
aN
aN
aN
aN
aN
aN
aN
aN
aN
aN
aN
aN
aN
aT
aT
aT
aT
aT
aT
aT
aT
"}
(48,1,1) = {"
aT
aT
aH
aT
aT
aT
aT
aN
aN
aN
aN
aN
aN
aN
aN
aN
aN
aN
aN
aN
aN
aN
aN
aN
aN
aN
aN
aN
aN
aN
aN
aN
aN
aT
aT
aT
aT
aT
aT
ab
aT
aT
"}
(49,1,1) = {"
aT
aT
ab
aT
aH
aT
aN
aN
aN
aN
aN
aN
aN
aN
aN
aN
aN
aN
aN
aN
aN
aN
aN
aN
aN
aN
aN
aN
aN
aN
aN
aN
aN
aT
aT
aT
aH
aT
aT
aT
aH
aT
"}
(50,1,1) = {"
aT
aT
aT
aT
aT
aT
aN
aN
aN
aN
aN
aN
aN
aN
aN
aN
aN
aN
aN
aN
aT
aT
aT
aT
aT
aT
aT
aT
aT
aT
aT
aT
aT
aT
aT
aT
aT
aT
aT
aT
aT
aT
"}
(51,1,1) = {"
aT
aT
aT
aT
aT
aT
aN
aN
aN
aN
aN
aN
aN
aN
aN
aN
aN
aN
aN
aN
aT
aT
aT
aT
aT
aT
aT
aT
aT
aT
aT
aT
aT
aT
aT
aT
aT
aT
aT
aT
aT
aT
"}
(52,1,1) = {"
aT
aP
aT
aT
aT
aH
aN
aN
aN
aT
aT
aT
aT
aT
aT
aT
aT
aT
aT
aT
aT
aT
aT
aT
aT
aT
aT
aT
aT
aT
ab
aH
aT
aT
aT
aT
aw
aT
aH
ab
aT
aT
"}
(53,1,1) = {"
aT
aT
aT
aT
aT
aT
aN
aN
aN
aT
aT
aT
aT
aT
aT
aH
aT
aH
aT
aT
aT
aT
aT
ay
aH
aT
aT
aT
aT
aT
aT
aT
aT
aT
ay
aT
aT
aT
aT
aT
aT
aT
"}
(54,1,1) = {"
aT
aT
aT
aT
aT
aT
aT
aT
aT
aT
aT
aT
aT
aT
aT
aT
aT
aT
aT
aw
aH
aT
aT
aT
aT
aT
aT
ag
aT
aT
aT
aT
aT
aT
aT
aT
aT
aT
aT
aT
aT
aT
"}
(55,1,1) = {"
aH
aT
ab
aT
aT
aH
aT
aT
aT
aT
aT
aH
ab
aT
aT
aH
aT
aT
aT
aT
ab
aT
aT
aT
aT
aH
aT
aT
aT
aT
ab
aT
aT
aT
aT
aT
aT
aT
aT
aT
aT
aT
"}
(56,1,1) = {"
aT
aT
aT
aT
aT
aT
aT
aT
aT
aT
aT
ay
aT
aT
aT
aT
aT
aT
aT
aT
aT
aT
aT
aT
aT
aT
aT
aT
aT
aT
aT
aH
aT
aT
aN
aN
aN
aN
aN
aN
aN
aN
"}
(57,1,1) = {"
aT
aT
aT
aN
aT
aT
aT
aT
aT
aT
aT
aT
aT
aT
aT
aT
aT
aP
aT
aT
aT
aT
aT
aT
aT
aT
aT
aT
aT
aT
aT
aT
aT
aT
aN
aN
aN
aN
aN
aN
aN
aN
"}
(58,1,1) = {"
aT
aT
aT
aN
aN
aN
aN
aN
aN
aT
aT
aT
aT
aT
aT
aT
aT
aT
aT
aT
aT
aT
aT
aT
aT
aT
aN
aN
aN
aN
aN
aN
aN
aN
aN
aN
aN
aN
aN
aN
aN
aN
"}
(59,1,1) = {"
aT
aT
aN
aN
aN
aN
aN
aN
aN
aT
aT
aT
aT
aT
aT
aT
aT
aT
aT
aT
aT
aT
aT
aT
aT
aT
aN
aN
aN
aN
aN
aN
aN
aN
aN
aN
aN
aN
aN
aN
aN
aN
"}
(60,1,1) = {"
aN
aN
aN
aN
aN
aN
aN
aN
aN
aN
aN
aN
aN
aT
aT
aT
aT
aT
aN
aN
aN
aN
aN
aN
aN
aN
aN
aN
aN
aN
aN
aN
aN
aN
aN
aN
aN
aN
aN
aN
aN
aN
"}
(61,1,1) = {"
aN
aN
aN
aN
aN
aN
aN
aN
aN
aN
aN
aN
aN
aN
aN
aN
aN
aN
aN
aN
aN
aN
aN
aN
aN
aN
aN
aN
aN
aN
aN
aN
aN
aN
aN
aN
aN
aN
aN
aN
aN
aN
"}
(62,1,1) = {"
at
at
aN
aN
aN
aN
aN
aN
aN
aN
aN
aN
aN
aN
aN
aN
aN
aN
aN
aN
aN
aN
aN
aN
aN
aN
aN
aN
aN
aN
aN
aN
aN
aN
aN
aN
aN
aN
aN
aN
aN
aN
"}
(63,1,1) = {"
aN
at
at
aN
aN
aN
aN
aN
aN
aN
aN
aN
aN
aN
aN
aN
aN
aN
aN
aN
aN
aN
aN
aN
aN
aN
aN
aN
aN
aN
aN
aN
aN
aN
aN
aN
aN
aN
aN
aN
aN
aN
"}
(64,1,1) = {"
aN
aN
at
aN
aN
aN
aN
aN
aN
aN
aN
aN
aN
aN
aN
aN
aN
aN
aN
aN
aN
aN
aN
aN
aN
aN
aN
aN
aN
aN
aN
aN
aN
aN
aN
aN
aN
aN
aN
aN
aN
aN
"}
(65,1,1) = {"
aN
aN
at
aN
aN
aN
aN
aN
aN
aN
aN
aN
aN
aN
aN
aN
aN
aN
aN
aN
aN
aN
aN
aN
aN
aN
aN
aN
aN
aN
aN
aN
aN
aN
aN
aN
aN
aN
aN
aN
aN
aN
"}
(66,1,1) = {"
aT
aN
ae
ae
ae
ae
ae
ae
ae
ae
ae
ae
ae
ae
ae
ae
ae
ae
ae
ae
ae
ae
ae
ae
ae
ae
ae
ae
ae
ae
ae
ae
ae
ae
ae
ae
ae
ae
ae
ae
ae
ae
"}
