//MAP CONVERTED BY dmm2tgm.py THIS HEADER COMMENT PREVENTS RECONVERSION, DO NOT REMOVE
"a" = (
/turf/closed/mineral/bigred,
/area/bigredv2/caves/rock)
"b" = (
/obj/machinery/chem_master,
/turf/open/floor/tile/whiteyellow{
	dir = 5
	},
/area/bigredv2/caves/lambda_lab)
"c" = (
/atom/movable/effect/ai_node,
/turf/open/floor/plating/ground/mars/random/cave,
/area/bigredv2/caves/northeast)
"e" = (
/atom/movable/effect/landmark/weed_node,
/turf/open/floor/plating/ground/mars/random/cave/rock,
/area/bigredv2/caves/northeast)
"f" = (
/atom/movable/effect/landmark/weed_node,
/turf/open/floor/plating/ground/mars/random/cave,
/area/bigredv2/caves/northeast)
"g" = (
/atom/movable/effect/landmark/xeno_resin_wall,
/turf/open/floor/plating/ground/mars/random/cave,
/area/bigredv2/caves/northeast)
"h" = (
/turf/closed/wall/r_wall,
/area/bigredv2/caves/rock)
"j" = (
/turf/open/floor/plating/ground/mars/random/cave,
/area/bigredv2/caves/northeast)
"n" = (
/obj/structure/closet/crate/freezer/rations,
/turf/open/floor/plating,
/area/bigredv2/caves/lambda_lab)
"r" = (
/turf/open/floor/plating,
/area/bigredv2/caves/lambda_lab)
"A" = (
/obj/machinery/chem_dispenser,
/turf/open/floor/tile/whiteyellow{
	dir = 1
	},
/area/bigredv2/caves/lambda_lab)
"E" = (
/atom/movable/effect/landmark/lv624/fog_blocker,
/turf/open/floor/plating/ground/mars/random/cave,
/area/bigredv2/caves/northeast)
"H" = (
/obj/machinery/door/poddoor/two_tile_hor,
/turf/open/floor/plating/ground/mars/random/cave,
/area/bigredv2/caves/northeast)
"I" = (
/atom/movable/effect/landmark/lv624/fog_blocker,
/turf/closed/mineral/bigred,
/area/bigredv2/caves/rock)
"J" = (
/obj/structure/closet/crate/internals,
/turf/open/floor/plating,
/area/bigredv2/caves/lambda_lab)
"K" = (
/obj/machinery/chem_dispenser,
/turf/open/floor/tile/whiteyellow{
	dir = 9
	},
/area/bigredv2/caves/lambda_lab)
"L" = (
/atom/movable/effect/ai_node,
/atom/movable/effect/landmark/excavation_site_spawner,
/turf/open/floor/plating/ground/mars/random/cave,
/area/bigredv2/caves/northeast)
"M" = (
/turf/closed/wall/indestructible/mineral,
/area/space)
"O" = (
/obj/machinery/miner/damaged/platinum,
/turf/open/floor/plating/ground/mars/random/cave,
/area/bigredv2/caves/northeast)
"R" = (
/atom/movable/effect/landmark/weed_node,
/atom/movable/effect/ai_node,
/turf/open/floor/plating/ground/mars/random/cave,
/area/bigredv2/caves/northeast)
"T" = (
/turf/open/floor/plating/ground/mars/random/cave/rock,
/area/bigredv2/caves/northeast)
"X" = (
/turf/closed/wall/r_wall,
/area/bigredv2/caves/lambda_lab)
"Y" = (
/turf/open/space/basic,
/area/space)

(1,1,1) = {"
Y
Y
Y
Y
Y
Y
Y
Y
Y
M
M
M
M
M
M
a
a
a
a
a
a
a
a
a
a
j
j
j
j
T
a
a
"}
(2,1,1) = {"
Y
Y
Y
Y
Y
Y
Y
Y
Y
M
a
a
a
a
a
a
a
a
a
a
a
a
a
T
T
f
j
j
j
T
a
a
"}
(3,1,1) = {"
Y
Y
Y
Y
Y
Y
Y
Y
Y
M
a
a
a
a
a
a
a
a
a
a
a
a
j
j
j
j
j
j
j
T
a
a
"}
(4,1,1) = {"
Y
Y
Y
Y
Y
Y
Y
Y
Y
M
a
a
a
a
a
a
a
a
a
a
a
j
j
j
j
j
j
j
j
j
T
a
"}
(5,1,1) = {"
Y
Y
Y
Y
Y
Y
Y
Y
Y
M
a
a
a
a
a
a
a
a
a
a
j
j
c
j
c
j
j
f
j
c
T
a
"}
(6,1,1) = {"
Y
Y
Y
Y
Y
Y
Y
Y
Y
M
a
a
a
a
a
a
a
c
j
H
j
c
j
e
j
j
j
j
j
j
T
a
"}
(7,1,1) = {"
Y
Y
Y
Y
Y
Y
Y
Y
Y
M
a
a
a
a
a
a
j
j
j
j
j
j
j
a
a
T
j
j
j
j
T
a
"}
(8,1,1) = {"
Y
Y
Y
Y
Y
Y
Y
Y
Y
M
a
a
a
a
a
a
j
j
j
a
j
j
a
a
a
a
j
j
j
j
f
T
"}
(9,1,1) = {"
Y
Y
Y
Y
Y
Y
Y
Y
Y
M
a
a
a
a
a
a
j
c
j
a
a
a
a
a
a
a
e
j
j
j
j
j
"}
(10,1,1) = {"
Y
Y
Y
Y
Y
Y
Y
Y
Y
M
a
a
a
a
a
j
c
j
j
a
a
a
a
a
a
a
a
T
j
c
j
j
"}
(11,1,1) = {"
Y
Y
Y
Y
Y
Y
Y
Y
Y
M
a
a
a
a
j
j
j
j
j
a
a
a
a
a
a
a
a
a
a
j
c
j
"}
(12,1,1) = {"
Y
Y
Y
Y
Y
Y
Y
Y
Y
M
a
a
a
a
j
j
j
j
j
a
a
a
a
a
a
a
a
a
a
T
j
c
"}
(13,1,1) = {"
Y
Y
Y
Y
Y
Y
Y
Y
Y
M
a
a
a
j
j
j
j
j
a
a
a
a
a
a
a
a
a
a
a
a
a
a
"}
(14,1,1) = {"
Y
Y
Y
Y
Y
Y
Y
Y
Y
M
a
a
c
j
j
j
c
a
a
a
a
a
a
a
a
a
a
a
a
a
a
a
"}
(15,1,1) = {"
Y
Y
Y
Y
Y
Y
Y
Y
Y
M
a
a
j
j
j
a
a
a
a
a
a
a
a
a
a
a
a
h
h
h
h
h
"}
(16,1,1) = {"
Y
Y
Y
Y
Y
Y
Y
Y
Y
M
a
a
j
j
j
a
a
a
a
a
a
a
a
a
a
a
a
h
a
g
g
g
"}
(17,1,1) = {"
Y
Y
Y
Y
Y
Y
Y
Y
Y
M
a
j
j
j
a
a
a
a
a
a
a
a
a
a
a
a
a
h
a
j
j
j
"}
(18,1,1) = {"
Y
Y
Y
Y
Y
Y
Y
Y
Y
M
a
j
c
j
a
a
a
a
a
a
a
a
a
a
a
a
a
h
a
j
j
c
"}
(19,1,1) = {"
Y
Y
Y
Y
Y
Y
Y
Y
Y
M
a
c
j
j
j
a
a
a
a
a
a
a
a
a
a
a
a
a
a
j
j
j
"}
(20,1,1) = {"
Y
Y
Y
Y
Y
Y
Y
Y
Y
M
a
a
j
j
j
j
j
a
a
a
a
a
a
a
a
a
a
a
a
j
j
j
"}
(21,1,1) = {"
Y
Y
Y
Y
Y
Y
Y
Y
Y
M
a
a
j
j
j
j
j
j
j
a
a
a
a
a
a
a
a
a
a
a
j
j
"}
(22,1,1) = {"
Y
Y
Y
Y
Y
Y
Y
Y
Y
M
a
a
c
j
j
j
c
j
j
a
a
a
a
a
a
a
a
a
a
a
j
j
"}
(23,1,1) = {"
Y
Y
Y
Y
Y
Y
Y
Y
Y
M
a
a
a
j
j
j
j
j
j
a
a
a
a
a
a
a
a
a
a
a
j
c
"}
(24,1,1) = {"
Y
Y
Y
Y
Y
Y
Y
Y
Y
M
a
a
a
a
j
j
j
j
j
j
a
a
a
a
a
a
a
a
a
a
f
j
"}
(25,1,1) = {"
Y
Y
Y
Y
Y
Y
Y
Y
Y
M
a
a
a
a
j
j
j
a
j
j
a
a
a
a
a
a
a
a
a
a
a
j
"}
(26,1,1) = {"
Y
Y
Y
Y
Y
Y
Y
Y
Y
M
a
a
a
a
j
j
j
a
j
j
j
a
a
a
a
j
a
a
a
a
a
a
"}
(27,1,1) = {"
Y
Y
Y
Y
Y
Y
Y
Y
Y
M
a
a
a
a
a
j
j
j
j
j
j
j
j
j
j
j
j
a
a
a
a
a
"}
(28,1,1) = {"
Y
Y
Y
Y
Y
Y
Y
Y
Y
M
a
a
a
a
a
j
c
j
j
j
j
j
c
j
j
j
R
a
a
a
a
I
"}
(29,1,1) = {"
Y
Y
Y
Y
Y
Y
Y
Y
Y
M
a
a
a
a
a
a
j
j
j
j
j
j
j
j
j
j
j
a
a
a
I
a
"}
(30,1,1) = {"
Y
Y
Y
Y
Y
Y
Y
Y
Y
M
a
a
a
a
a
a
a
a
a
j
j
j
j
j
j
j
j
a
a
I
a
a
"}
(31,1,1) = {"
Y
Y
Y
Y
Y
Y
Y
Y
Y
M
a
a
a
a
a
a
a
a
a
a
a
a
a
j
j
j
j
a
a
I
a
X
"}
(32,1,1) = {"
Y
Y
Y
Y
Y
Y
Y
Y
Y
M
a
a
a
a
a
a
a
a
a
a
a
a
a
j
j
j
j
a
a
I
a
X
"}
(33,1,1) = {"
Y
Y
Y
Y
Y
Y
Y
Y
Y
M
a
a
a
a
a
a
a
a
a
a
a
a
a
c
j
j
R
a
a
I
a
X
"}
(34,1,1) = {"
Y
Y
Y
Y
Y
Y
Y
Y
Y
M
a
a
a
a
a
a
a
a
a
a
a
a
a
j
j
j
j
a
a
I
a
X
"}
(35,1,1) = {"
Y
Y
Y
Y
Y
Y
Y
Y
Y
M
a
a
a
a
a
a
a
a
a
a
a
a
a
j
j
j
j
a
a
I
a
X
"}
(36,1,1) = {"
Y
Y
Y
Y
Y
Y
Y
Y
Y
M
a
a
a
a
a
a
a
a
a
a
a
a
a
j
j
f
j
j
a
I
a
a
"}
(37,1,1) = {"
Y
Y
Y
Y
Y
Y
Y
Y
Y
M
a
a
a
a
a
a
a
a
a
a
a
a
a
j
j
j
j
j
a
I
a
a
"}
(38,1,1) = {"
Y
Y
Y
Y
Y
Y
Y
Y
Y
M
a
a
a
a
a
a
a
a
a
a
a
a
a
j
j
j
j
j
a
I
a
a
"}
(39,1,1) = {"
Y
Y
Y
Y
Y
Y
Y
Y
Y
M
a
a
a
a
a
a
a
a
a
a
a
a
a
j
j
j
j
j
a
I
X
X
"}
(40,1,1) = {"
Y
Y
Y
Y
Y
Y
Y
Y
Y
M
M
M
M
M
M
M
M
M
M
M
a
a
a
j
j
j
f
j
a
I
X
r
"}
(41,1,1) = {"
Y
Y
Y
Y
Y
Y
Y
Y
Y
Y
Y
Y
Y
Y
Y
Y
Y
Y
Y
M
a
a
a
j
j
j
f
j
a
I
X
J
"}
(42,1,1) = {"
Y
Y
Y
Y
Y
Y
Y
Y
Y
Y
Y
Y
Y
Y
Y
Y
Y
Y
Y
M
a
a
a
j
j
j
j
j
a
I
X
n
"}
(43,1,1) = {"
Y
Y
Y
Y
Y
Y
Y
Y
Y
Y
Y
Y
Y
Y
Y
Y
Y
Y
Y
M
a
a
a
c
f
j
c
j
a
I
X
X
"}
(44,1,1) = {"
Y
Y
Y
Y
Y
Y
Y
Y
Y
Y
Y
Y
Y
Y
Y
Y
Y
Y
Y
M
a
a
a
j
j
j
j
j
j
I
X
K
"}
(45,1,1) = {"
Y
Y
Y
Y
Y
Y
Y
Y
Y
Y
Y
Y
Y
Y
Y
Y
Y
Y
Y
M
a
a
a
j
j
j
j
j
j
E
X
A
"}
(46,1,1) = {"
Y
Y
Y
Y
Y
Y
Y
Y
Y
Y
Y
Y
Y
Y
Y
Y
Y
Y
Y
M
a
a
a
j
j
j
j
j
j
E
X
A
"}
(47,1,1) = {"
Y
Y
Y
Y
Y
Y
Y
Y
Y
Y
Y
Y
Y
Y
Y
Y
Y
Y
Y
M
a
a
a
j
j
j
j
j
a
I
X
b
"}
(48,1,1) = {"
Y
Y
Y
Y
Y
Y
Y
Y
Y
Y
Y
Y
Y
Y
Y
Y
Y
Y
Y
M
a
a
a
a
j
j
j
f
a
I
X
X
"}
(49,1,1) = {"
Y
Y
Y
Y
Y
Y
Y
Y
Y
Y
Y
Y
Y
Y
Y
Y
Y
Y
Y
M
a
a
a
a
j
j
j
j
a
a
I
X
"}
(50,1,1) = {"
Y
Y
Y
Y
Y
Y
Y
Y
Y
Y
Y
Y
Y
Y
Y
Y
Y
Y
Y
M
a
a
a
a
j
j
j
j
j
j
a
I
"}
(51,1,1) = {"
Y
Y
Y
Y
Y
Y
Y
Y
Y
Y
Y
Y
Y
Y
Y
Y
Y
Y
Y
M
a
a
a
a
a
j
j
L
j
j
j
T
"}
(52,1,1) = {"
Y
Y
Y
Y
Y
Y
Y
Y
Y
Y
Y
Y
Y
Y
Y
Y
Y
Y
Y
M
a
a
a
a
a
j
c
j
j
j
c
j
"}
(53,1,1) = {"
Y
Y
Y
Y
Y
Y
Y
Y
Y
Y
Y
Y
Y
Y
Y
Y
Y
Y
Y
M
a
a
a
a
a
a
j
j
f
j
j
j
"}
(54,1,1) = {"
Y
Y
Y
Y
Y
Y
Y
Y
Y
Y
Y
Y
Y
Y
Y
Y
Y
Y
Y
M
a
a
a
a
a
a
j
j
j
j
j
j
"}
(55,1,1) = {"
Y
Y
Y
Y
Y
Y
Y
Y
Y
Y
Y
Y
Y
Y
Y
Y
Y
Y
Y
M
a
a
a
a
a
a
a
j
O
j
j
j
"}
(56,1,1) = {"
Y
Y
Y
Y
Y
Y
Y
Y
Y
Y
Y
Y
Y
Y
Y
Y
Y
Y
Y
M
a
a
a
a
a
a
a
j
j
j
f
j
"}
(57,1,1) = {"
Y
Y
Y
Y
Y
Y
Y
Y
Y
Y
Y
Y
Y
Y
Y
Y
Y
Y
Y
M
a
a
a
a
a
a
a
j
j
j
j
j
"}
(58,1,1) = {"
Y
Y
Y
Y
Y
Y
Y
Y
Y
Y
Y
Y
Y
Y
Y
Y
Y
Y
Y
M
a
a
a
a
a
a
a
j
j
j
c
j
"}
(59,1,1) = {"
Y
Y
Y
Y
Y
Y
Y
Y
Y
Y
Y
Y
Y
Y
Y
Y
Y
Y
Y
M
a
a
a
a
a
a
a
j
j
j
j
j
"}
(60,1,1) = {"
Y
Y
Y
Y
Y
Y
Y
Y
Y
Y
Y
Y
Y
Y
Y
Y
Y
Y
Y
M
a
a
a
a
a
a
a
a
j
j
c
j
"}
(61,1,1) = {"
Y
Y
Y
Y
Y
Y
Y
Y
Y
Y
Y
Y
Y
Y
Y
Y
Y
Y
Y
M
a
a
a
a
a
a
a
a
a
j
f
j
"}
(62,1,1) = {"
Y
Y
Y
Y
Y
Y
Y
Y
Y
Y
Y
Y
Y
Y
Y
Y
Y
Y
Y
M
a
a
a
a
a
a
a
a
a
j
j
j
"}
(63,1,1) = {"
Y
Y
Y
Y
Y
Y
Y
Y
Y
Y
Y
Y
Y
Y
Y
Y
Y
Y
Y
M
a
a
a
a
a
a
a
a
a
j
j
j
"}
(64,1,1) = {"
Y
Y
Y
Y
Y
Y
Y
Y
Y
Y
Y
Y
Y
Y
Y
Y
Y
Y
Y
M
a
a
a
a
a
a
a
a
a
j
j
j
"}
(65,1,1) = {"
Y
Y
Y
Y
Y
Y
Y
Y
Y
Y
Y
Y
Y
Y
Y
Y
Y
Y
Y
M
a
a
a
a
a
a
a
a
a
j
f
j
"}
