//MAP CONVERTED BY dmm2tgm.py THIS HEADER COMMENT PREVENTS RECONVERSION, DO NOT REMOVE
"ab" = (
/obj/effect/landmark/weed_node,
/obj/effect/ai_node,
/turf/open/floor/plating/ground/mars/random/cave,
/area/bigredv2/caves/southwest)
"ac" = (
/obj/effect/landmark/excavation_site_spawner,
/turf/open/floor/plating/ground/mars/random/cave,
/area/bigredv2/caves/southwest)
"ad" = (
/obj/effect/landmark/lv624/fog_blocker,
/turf/open/floor/plating/ground/mars/random/cave,
/area/bigredv2/caves/southwest)
"ae" = (
/obj/effect/landmark/patrol_point/som/som_11,
/turf/open/floor/plating/ground/mars/random/cave/rock,
/area/bigredv2/caves/southwest)
"af" = (
/obj/effect/landmark/patrol_point/som/som_12,
/turf/open/floor/plating/ground/mars/random/cave,
/area/bigredv2/caves/southwest)
"ag" = (
/obj/effect/landmark/patrol_point/som/som_14,
/turf/open/floor/plating/ground/mars/random/cave,
/area/bigredv2/caves/southwest)
"ah" = (
/obj/effect/ai_node,
/turf/open/floor/plating/ground/mars/random/cave/rock,
/area/bigredv2/caves/southwest)
"ai" = (
/obj/effect/landmark/weed_node,
/obj/effect/landmark/weed_node,
/turf/open/floor/plating/ground/mars/random/cave,
/area/bigredv2/caves/southwest)
"aj" = (
/obj/effect/landmark/weed_node,
/turf/open/floor/plating/ground/mars/random/cave/rock,
/area/bigredv2/caves/southwest)
"ak" = (
/obj/effect/landmark/xeno_silo_spawn,
/turf/open/floor/plating/ground/mars/random/cave,
/area/bigredv2/caves/southwest)
"am" = (
/obj/effect/ai_node,
/turf/open/floor/plating/ground/mars/random/cave,
/area/bigredv2/caves/southwest)
"an" = (
/obj/effect/landmark/excavation_site_spawner,
/obj/effect/landmark/lv624/fog_blocker/xeno_spawn,
/turf/open/floor/plating/ground/mars/random/cave,
/area/bigredv2/caves/southwest)
"aq" = (
/obj/effect/landmark/lv624/fog_blocker,
/turf/closed/mineral/smooth/bigred,
/area/bigredv2/caves/rock)
"ar" = (
/obj/effect/landmark/xeno_resin_wall,
/turf/open/floor/plating/ground/mars/random/cave,
/area/bigredv2/caves/southwest)
"as" = (
/obj/effect/landmark/excavation_site_spawner,
/obj/effect/ai_node,
/turf/open/floor/plating/ground/mars/random/cave,
/area/bigredv2/caves/southwest)
"au" = (
/turf/closed/mineral/smooth/bigred/indestructible,
/area/space)
"aw" = (
/obj/effect/landmark/lv624/fog_blocker/xeno_spawn,
/turf/open/floor/plating/ground/mars/random/cave/rock,
/area/bigredv2/caves/southwest)
"az" = (
/obj/effect/landmark/lv624/fog_blocker/xeno_spawn,
/turf/open/floor/plating/ground/mars/random/cave,
/area/bigredv2/caves/southwest)
"aB" = (
/turf/open/floor/plating/ground/mars/random/cave,
/area/bigredv2/caves/southwest)
"aF" = (
/obj/effect/landmark/weed_node,
/obj/effect/landmark/xeno_resin_wall,
/turf/open/floor/plating/ground/mars/random/cave,
/area/bigredv2/caves/southwest)
"aG" = (
/obj/effect/landmark/patrol_point/som/som_13,
/turf/open/floor/plating/ground/mars/random/cave/rock,
/area/bigredv2/caves/southwest)
"aH" = (
/turf/closed/mineral/smooth/bigred,
/area/bigredv2/caves/rock)
"aI" = (
/obj/effect/landmark/xeno_resin_door,
/turf/open/floor/plating/ground/mars/random/cave,
/area/bigredv2/caves/southwest)
"aJ" = (
/obj/effect/landmark/weed_node,
/obj/effect/landmark/lv624/fog_blocker/xeno_spawn,
/turf/open/floor/plating/ground/mars/random/cave,
/area/bigredv2/caves/southwest)
"aQ" = (
/obj/effect/landmark/weed_node,
/turf/open/floor/plating/ground/mars/random/cave,
/area/bigredv2/caves/southwest)
"aR" = (
/turf/open/floor/plating/ground/mars/random/cave/rock,
/area/bigredv2/caves/southwest)
"aT" = (
/obj/effect/landmark/lv624/fog_blocker/xeno_spawn,
/turf/closed/mineral/smooth/bigred,
/area/bigredv2/caves/rock)
"hG" = (
/obj/effect/landmark/xeno_tunnel_spawn,
/turf/open/floor/plating/ground/mars/random/cave/rock,
/area/bigredv2/caves/southwest)

(1,1,1) = {"
au
au
au
au
au
au
au
au
au
au
au
au
au
au
au
au
au
au
au
au
au
au
au
au
au
au
au
au
au
au
au
au
au
au
au
au
au
au
au
au
au
au
au
"}
(2,1,1) = {"
aH
aH
aH
aH
aH
aH
aH
aH
aH
aH
aH
aH
aH
aH
aH
aH
aH
aH
aH
aT
aH
aH
aH
aH
aH
aH
aH
aH
aH
aH
aH
aH
aH
aH
aH
au
au
au
au
au
au
au
au
"}
(3,1,1) = {"
aH
aH
aH
aH
aH
aH
aH
aH
aH
aH
aH
aH
aH
aH
aH
aH
aH
aH
aH
aT
aH
aH
aH
aH
aH
aH
aH
aH
aH
aH
aH
aH
aH
aH
aH
au
au
au
au
au
au
au
au
"}
(4,1,1) = {"
aH
aH
aH
aH
aH
aH
aH
aH
aH
aH
aH
aH
aH
aH
aH
aH
aH
aH
aH
aT
aH
aH
aH
aH
aH
aH
aH
aH
aH
aH
aH
aH
aH
aH
aH
au
au
au
au
au
au
au
au
"}
(5,1,1) = {"
aH
aH
aH
aH
aH
aH
aH
aH
aH
aH
aH
aH
aH
aH
aH
aH
aH
aH
aH
aT
aH
aH
aH
aH
aH
aH
aH
aH
aH
aH
aH
aH
aH
aH
aH
au
au
au
au
au
au
au
au
"}
(6,1,1) = {"
aH
aH
aH
aH
aH
aH
aH
aH
aH
aH
aH
aH
aH
aH
aH
aH
aH
aH
aH
aT
aH
aH
aB
aR
aR
hG
aR
ae
aH
aH
aH
aH
aH
aH
aH
au
au
au
au
au
au
au
au
"}
(7,1,1) = {"
aH
aH
aH
aH
aB
aB
aB
aB
aB
aH
aH
aH
aH
aH
aH
aj
ag
aB
aB
az
aB
ar
aB
aB
aB
aB
aB
aB
aR
aH
aH
aH
aH
aH
aH
au
au
au
au
au
au
au
au
"}
(8,1,1) = {"
aH
aH
aB
aB
aB
aQ
aB
aB
aB
aB
aB
aH
aH
aH
aR
aB
aB
aB
aB
aJ
aB
ar
aB
aB
aQ
aB
aQ
aB
aR
aH
aH
aH
aH
aH
aH
au
au
au
au
au
au
au
au
"}
(9,1,1) = {"
aH
aB
aB
aB
aB
aB
aB
aB
aB
aB
aB
aB
aB
aB
aB
aB
aB
aB
aB
az
aB
ar
aB
aB
aB
ak
aB
aB
aj
aH
aH
aH
aH
aH
aH
au
au
au
au
au
au
au
au
"}
(10,1,1) = {"
aB
aB
am
aB
aQ
aQ
aB
aB
aQ
aB
aQ
am
aB
aB
aB
am
aB
aB
aB
az
aB
ar
aB
aB
aQ
am
aB
aQ
aB
aR
aH
aH
aH
aH
aH
au
au
au
au
au
au
au
au
"}
(11,1,1) = {"
aQ
aB
aB
aB
aB
aB
aQ
aB
aB
aB
aB
aB
aB
aB
aB
aB
aB
aB
aQ
az
aB
aF
aB
aB
aB
aB
aB
aB
aB
aR
aH
aH
aH
aH
aH
au
au
au
au
au
au
au
au
"}
(12,1,1) = {"
aB
aB
aB
aB
aB
aB
aB
aB
aH
aH
aH
aB
aB
aB
aB
aB
aB
aB
aB
az
aB
ar
aB
aB
aB
aB
aB
aB
aB
aB
aB
aB
aH
aH
aH
au
au
au
au
au
au
au
au
"}
(13,1,1) = {"
aB
aB
aH
aH
aH
aH
aH
aH
aH
aH
aH
aB
aB
aB
aB
aQ
aB
aB
aB
az
aB
ar
ar
ar
ar
aI
aI
ar
ar
aF
ar
ar
aH
aH
aH
au
au
au
au
au
au
au
au
"}
(14,1,1) = {"
aB
aH
aH
aH
aH
aH
aH
aH
aH
aH
aH
aB
aB
aB
aB
aB
aB
aB
aB
az
aB
aB
aB
aB
aB
aB
aB
aR
aB
aB
aB
aH
aH
aH
aH
au
au
au
au
au
au
au
au
"}
(15,1,1) = {"
aH
aH
aH
aH
aH
aH
aH
aH
aH
aH
aH
aR
aB
aB
aB
aB
aB
aB
aB
aJ
aB
aB
aB
aB
aB
aB
aB
aB
aB
aB
aQ
aH
aH
aH
aH
au
au
au
au
au
au
au
au
"}
(16,1,1) = {"
aH
aH
aH
aH
aH
aH
aH
aH
aH
aH
aH
aH
aB
aB
aB
am
aQ
aB
aB
az
am
aB
aB
aB
aB
am
aB
aB
aQ
aB
aB
aH
aH
aH
aH
au
au
au
au
au
au
au
au
"}
(17,1,1) = {"
aH
aH
aH
aH
aH
aH
aH
aH
aH
aH
aH
aH
aB
aB
aB
aB
aB
aB
aB
an
az
az
az
az
az
az
az
aw
az
az
az
aT
aT
aT
aT
au
au
au
au
au
au
au
au
"}
(18,1,1) = {"
aH
aH
aH
aH
aH
aH
aH
aH
aH
aH
aH
aH
aB
aB
aQ
aB
aB
aB
aB
aB
aQ
aB
aB
ai
aB
aB
aB
aB
aB
af
aH
aH
aH
aH
aH
au
au
au
au
au
au
au
au
"}
(19,1,1) = {"
aH
aH
aH
aH
aH
aH
aH
aH
aH
aH
aH
aH
aB
aB
aB
aB
aB
aB
aB
aB
aB
aQ
aB
aR
aQ
aB
aB
aB
aH
aH
aH
aH
aH
aH
aH
au
au
au
au
au
au
au
au
"}
(20,1,1) = {"
aH
aH
aH
aH
aH
aH
aH
aH
aH
aH
aB
aR
aB
aB
aB
aB
aB
aB
aB
aB
aB
aB
aB
aR
aB
aB
aB
aH
aH
aH
aH
aH
aH
aH
aH
au
au
au
au
au
au
au
au
"}
(21,1,1) = {"
aH
aH
aH
aH
aH
aH
aH
aH
aH
aB
aB
aR
aB
aB
aB
aQ
aB
aB
aB
aQ
aB
aB
aR
aB
aB
aQ
aB
aH
aH
aH
aH
aH
aH
aH
aH
au
au
au
au
au
au
au
au
"}
(22,1,1) = {"
aH
aH
aH
aH
aH
aH
aH
aH
aH
aB
aB
aB
am
aB
aB
am
aR
aH
aR
aB
aB
aB
aG
aH
aH
aB
aB
aH
aH
aH
aH
aH
aH
aH
aH
au
au
au
au
au
au
au
au
"}
(23,1,1) = {"
aH
aH
aH
aH
aH
aH
aH
aH
aB
aB
aB
aB
aB
aB
aB
aR
aH
aH
aH
aH
aH
aH
aH
aH
aH
aB
aB
aB
aH
aH
aH
aH
aH
aH
aH
au
au
au
au
au
au
au
au
"}
(24,1,1) = {"
aH
aH
aH
aH
aH
aQ
aB
aB
aR
aB
aB
aR
aB
aQ
aB
aR
aH
aH
aH
aH
aH
aH
aH
aH
aB
aB
aB
aB
aH
aH
aH
aH
aH
aH
aH
au
au
au
au
au
au
au
au
"}
(25,1,1) = {"
aH
aH
aH
aH
aH
aB
aB
aQ
aB
aB
aj
aB
aB
aB
aB
aH
aH
aH
aH
aH
aH
aH
aH
aH
aB
ab
aB
aB
aH
aH
aH
aH
aH
aH
aH
au
au
au
au
au
au
au
au
"}
(26,1,1) = {"
aH
aH
aH
aH
am
aB
aB
aB
aB
aB
aB
aQ
aR
aB
aB
aH
aH
aH
aH
aH
aH
aH
aH
aH
aH
aB
am
aB
aH
aH
aH
aH
aH
aH
aH
au
au
au
au
au
au
au
au
"}
(27,1,1) = {"
aH
aH
aH
aB
aQ
am
aB
aB
aB
aB
aB
aB
am
aB
aB
aH
aH
aH
aH
aH
aH
aH
aH
aH
aH
aB
aB
aQ
aB
aH
aH
aH
aH
aH
aH
au
au
au
au
au
au
au
au
"}
(28,1,1) = {"
aH
aH
aB
aB
aB
aB
aB
aB
aB
aB
aB
aB
aQ
aB
aR
aH
aH
aH
aH
aH
aH
aH
aH
aH
aH
aH
aB
aB
aB
aH
aH
aH
aH
aH
aH
au
au
au
au
au
au
au
au
"}
(29,1,1) = {"
aH
aH
aB
aB
aB
aB
aB
aQ
aB
aB
aB
aB
aB
aQ
aB
aH
aH
aH
aH
aH
aH
aH
aH
aH
aH
aH
aB
aQ
aB
aH
aH
aH
aH
aH
aH
au
au
au
au
au
au
au
au
"}
(30,1,1) = {"
aH
aH
aB
aQ
aB
aB
aB
aB
aQ
aR
aH
aR
am
aB
aB
aB
aH
aH
aH
aH
aH
aH
aH
aH
aH
aH
aB
aQ
aB
aB
aH
aH
aH
aH
aH
au
au
au
au
au
au
au
au
"}
(31,1,1) = {"
aH
aB
aB
aB
aB
aB
aB
aB
aB
aR
aH
aH
aR
am
aQ
aB
aB
aH
aH
aH
aH
aH
aH
aH
aH
aH
ah
aB
aB
aB
aH
aH
aH
aH
aH
au
au
au
au
au
au
au
au
"}
(32,1,1) = {"
aH
aB
am
aB
aB
am
aH
aB
aB
aR
aH
aH
aH
aB
am
aB
aB
am
aB
aH
aH
aH
aH
aH
aH
aH
aR
ah
aQ
aB
aH
aH
aH
aH
aH
au
au
au
au
au
au
au
au
"}
(33,1,1) = {"
aH
aB
aB
aB
aH
aH
aH
aR
aR
aH
aH
aH
aH
aB
aB
aB
aQ
aB
aQ
aB
aR
aH
aH
aH
aH
aH
aH
aR
am
aB
aB
aH
aH
aH
aH
au
au
au
au
au
au
au
au
"}
(34,1,1) = {"
aH
aB
aB
aB
aH
aH
aH
aH
aH
aH
aH
aH
aH
aH
aB
aB
aB
aB
aB
aB
aB
aR
aH
aH
aH
aH
aH
aH
aB
aB
aB
aB
aH
aH
aH
au
au
au
au
au
au
au
au
"}
(35,1,1) = {"
aH
aB
aB
aH
aH
aH
aH
aH
aH
aH
aH
aH
aH
aB
aB
aB
aB
aB
aB
aB
aR
aH
aH
aH
aH
aH
aH
aH
aB
aB
aB
aH
aH
aH
aH
au
au
au
au
au
au
au
au
"}
(36,1,1) = {"
aH
aB
aB
aH
aH
aH
aH
aH
aH
aH
aH
aH
aH
aR
aB
aB
aB
aB
aQ
aB
aR
aH
aH
aH
aH
aH
aH
aH
aB
aQ
aB
aH
aH
aH
aH
au
au
au
au
au
au
au
au
"}
(37,1,1) = {"
aB
aB
aB
aH
aH
aH
aH
aH
aH
aH
aH
aH
aH
aH
aH
aH
aB
as
aB
aB
aB
ah
aH
aH
aH
aH
aH
aH
aB
ac
aB
aH
aH
aH
aH
au
au
au
au
au
au
au
au
"}
(38,1,1) = {"
aB
aB
aB
aH
aH
aH
aH
aH
aH
aH
aH
aH
aH
aH
aH
aH
aB
aB
aB
aB
aB
aR
aH
aH
aH
aH
aR
aj
aB
aQ
aB
aH
aH
aH
aH
au
au
au
au
au
au
au
au
"}
(39,1,1) = {"
aB
aB
aB
aH
aH
aH
aH
aH
aH
aH
aH
aH
aH
aH
aH
aH
aR
aB
aB
aB
aB
aR
aH
aH
aH
aH
aR
aR
aB
aB
aH
aH
aH
aH
aH
au
au
au
au
au
au
au
au
"}
(40,1,1) = {"
aB
aQ
aB
aH
aH
aH
aH
aH
aH
aH
aH
aH
aH
aH
aH
aH
aH
aH
aH
aQ
aQ
aB
aR
aR
aH
aH
aH
aH
aB
aB
aH
aH
aH
aH
aH
au
au
au
au
au
au
au
au
"}
(41,1,1) = {"
ad
ad
ad
aq
aq
aq
aq
aq
aq
aq
aq
aq
aq
aq
aH
aH
aH
aH
aH
aB
aB
aB
aB
aR
aH
aH
aH
aH
aB
aQ
aH
aH
aH
aH
aH
au
au
au
au
au
au
au
au
"}
