//MAP CONVERTED BY dmm2tgm.py THIS HEADER COMMENT PREVENTS RECONVERSION, DO NOT REMOVE
"b" = (
/turf/open/floor/plating/ground/mars/random/cave,
/area/bigredv2/caves/east)
"e" = (
/atom/movable/effect/landmark/lv624/fog_blocker/xeno_spawn,
/turf/open/floor/plating/ground/mars/random/cave,
/area/bigredv2/caves/southeast)
"g" = (
/atom/movable/effect/landmark/weed_node,
/atom/movable/effect/ai_node,
/turf/open/floor/plating/ground/mars/random/cave,
/area/bigredv2/caves/southeast)
"h" = (
/obj/machinery/miner/damaged/platinum,
/turf/open/floor/plating/ground/mars/random/cave,
/area/bigredv2/caves/southeast)
"i" = (
/atom/movable/effect/landmark/xeno_silo_spawn,
/turf/open/floor/plating/ground/mars/random/cave,
/area/bigredv2/caves/southeast)
"j" = (
/atom/movable/effect/landmark/start/job/xenomorph,
/turf/open/floor/plating/ground/mars/random/cave,
/area/bigredv2/caves/southeast)
"k" = (
/turf/closed/mineral/smooth/bigred/indestructible,
/area/space)
"l" = (
/atom/movable/effect/landmark/weed_node,
/turf/open/floor/plating/ground/mars/random/cave,
/area/bigredv2/caves/southeast)
"n" = (
/atom/movable/effect/landmark/xeno_resin_wall,
/turf/open/floor/plating/ground/mars/random/cave,
/area/bigredv2/caves/southeast)
"p" = (
/obj/docking_port/stationary/crashmode,
/turf/closed/mineral/smooth/bigred,
/area/bigredv2/caves/rock)
"r" = (
/turf/closed/mineral/smooth/bigred,
/area/bigredv2/caves/rock)
"s" = (
/turf/open/space/basic,
/area/space)
"t" = (
/atom/movable/effect/landmark/weed_node,
/turf/open/floor/plating/ground/mars/random/cave/rock,
/area/bigredv2/caves/southeast)
"v" = (
/turf/open/floor/plating/ground/mars/random/cave/rock,
/area/bigredv2/caves/southeast)
"w" = (
/atom/movable/effect/ai_node,
/turf/open/floor/plating/ground/mars/random/cave/rock,
/area/bigredv2/caves/southeast)
"y" = (
/atom/movable/effect/landmark/patrol_point{
	id = "TGMC_12";
	name = "TGMC exit point 12"
	},
/turf/open/floor/plating/ground/mars/random/cave,
/area/bigredv2/caves/southeast)
"z" = (
/atom/movable/effect/landmark/start/job/xenomorph,
/atom/movable/effect/landmark/weed_node,
/turf/open/floor/plating/ground/mars/random/cave,
/area/bigredv2/caves/southeast)
"A" = (
/atom/movable/effect/ai_node,
/turf/open/floor/plating/ground/mars/random/cave,
/area/bigredv2/caves/southeast)
"C" = (
/atom/movable/effect/landmark/patrol_point{
	id = "TGMC_13";
	name = "TGMC exit point 13"
	},
/turf/open/floor/plating/ground/mars/random/cave,
/area/bigredv2/caves/southeast)
"D" = (
/atom/movable/effect/landmark/xeno_resin_door,
/turf/open/floor/plating/ground/mars/random/cave/rock,
/area/bigredv2/caves/southeast)
"H" = (
/atom/movable/effect/landmark/weed_node,
/atom/movable/effect/landmark/lv624/fog_blocker/xeno_spawn,
/turf/open/floor/plating/ground/mars/random/cave,
/area/bigredv2/caves/southeast)
"I" = (
/turf/open/floor/plating/ground/mars/random/cave,
/area/bigredv2/caves/southeast)
"L" = (
/atom/movable/effect/landmark/patrol_point{
	id = "TGMC_11";
	name = "TGMC exit point 11"
	},
/turf/open/floor/plating/ground/mars/random/cave,
/area/bigredv2/caves/southeast)
"R" = (
/atom/movable/effect/landmark/lv624/fog_blocker/xeno_spawn,
/atom/movable/effect/landmark/xeno_resin_wall,
/turf/open/floor/plating/ground/mars/random/cave,
/area/bigredv2/caves/southeast)
"T" = (
/atom/movable/effect/landmark/patrol_point{
	id = "TGMC_14";
	name = "TGMC exit point 14"
	},
/turf/open/floor/plating/ground/mars/random/cave,
/area/bigredv2/caves/southeast)
"U" = (
/atom/movable/effect/landmark/lv624/fog_blocker/xeno_spawn,
/turf/closed/mineral/smooth/bigred,
/area/bigredv2/caves/rock)
"V" = (
/atom/movable/effect/landmark/xeno_resin_door,
/turf/open/floor/plating/ground/mars/random/cave,
/area/bigredv2/caves/southeast)
"W" = (
/atom/movable/effect/landmark/lv624/fog_blocker/xeno_spawn,
/atom/movable/effect/landmark/xeno_resin_door,
/turf/open/floor/plating/ground/mars/random/cave,
/area/bigredv2/caves/southeast)

(1,1,1) = {"
r
r
r
r
r
r
r
r
r
r
r
r
r
r
r
r
I
I
I
I
I
l
v
r
r
r
r
r
r
r
r
I
I
I
I
I
I
r
r
r
r
r
r
r
r
r
r
r
r
r
V
V
V
V
r
r
r
r
r
r
r
r
r
r
k
k
s
"}
(2,1,1) = {"
b
r
r
r
r
r
r
r
r
r
r
r
r
r
v
v
I
I
I
r
I
I
v
r
r
r
r
r
r
r
r
V
V
V
V
V
r
r
r
r
r
r
r
r
r
r
r
r
r
r
I
l
I
I
r
r
r
r
r
r
r
r
r
r
r
k
s
"}
(3,1,1) = {"
r
r
r
r
r
r
r
r
r
r
r
r
r
r
I
I
I
I
I
r
v
I
v
r
r
r
r
r
r
r
r
I
I
I
I
I
r
r
r
r
r
r
r
r
r
r
r
r
r
r
I
I
I
I
r
r
r
r
r
r
r
r
r
r
r
k
s
"}
(4,1,1) = {"
r
r
r
r
r
r
r
r
r
r
r
r
r
w
I
I
g
I
r
r
r
I
v
r
r
r
r
r
r
r
r
I
I
j
I
I
r
r
r
r
r
r
r
r
r
r
r
r
r
r
I
I
I
I
r
r
r
r
r
r
r
r
r
r
r
k
s
"}
(5,1,1) = {"
r
r
r
r
r
r
r
r
r
r
r
r
r
I
l
v
I
I
r
r
r
I
v
r
r
r
r
r
r
r
r
I
I
I
I
I
r
r
r
r
r
r
r
r
r
r
r
r
r
r
I
I
A
l
r
r
r
r
r
r
r
r
r
r
r
k
s
"}
(6,1,1) = {"
r
r
r
r
r
r
r
r
r
r
r
v
v
I
I
v
I
I
r
r
r
I
v
r
r
r
r
r
r
r
r
I
I
I
I
I
r
r
p
r
r
r
r
r
r
r
r
r
r
r
I
l
I
I
r
r
r
r
r
r
r
r
r
r
r
k
s
"}
(7,1,1) = {"
r
r
r
r
r
r
r
r
r
r
r
I
I
I
v
I
I
r
r
r
r
I
v
r
r
r
r
r
r
r
r
I
I
l
I
I
r
r
r
r
r
r
r
r
r
r
r
r
r
r
I
I
I
I
r
r
r
r
r
r
r
r
r
r
r
k
s
"}
(8,1,1) = {"
r
r
r
r
r
r
r
r
r
r
r
I
I
g
I
r
r
r
r
r
r
I
v
r
r
r
r
r
r
r
r
I
I
I
I
I
r
r
r
r
r
r
r
r
r
r
r
r
r
r
I
I
I
I
r
r
r
r
r
r
r
r
r
r
r
k
s
"}
(9,1,1) = {"
r
r
r
r
r
r
r
r
r
r
r
I
w
I
I
r
r
r
r
r
r
I
v
r
r
r
r
r
r
r
r
I
I
l
I
I
r
r
r
r
r
r
r
r
r
r
r
r
r
r
I
I
I
I
r
r
r
r
r
r
r
r
r
r
r
k
s
"}
(10,1,1) = {"
r
r
r
r
r
r
r
r
r
r
v
I
v
I
I
r
r
r
r
I
I
A
t
r
r
r
r
r
r
r
I
I
I
I
I
I
r
r
r
r
r
r
r
r
r
r
r
r
r
r
I
I
l
I
r
r
r
r
r
r
r
r
r
r
r
k
s
"}
(11,1,1) = {"
r
r
r
r
r
r
r
r
r
r
I
I
v
I
v
v
v
v
v
I
I
I
v
r
r
r
r
r
r
I
I
I
I
A
I
I
I
r
r
r
r
r
r
r
r
r
r
r
r
r
I
I
I
I
r
r
r
r
r
r
r
r
r
r
r
k
s
"}
(12,1,1) = {"
p
r
r
r
r
r
r
r
r
r
I
z
I
v
I
I
I
I
v
I
l
I
r
r
r
r
r
I
A
I
I
I
A
I
I
I
I
r
r
r
r
r
r
r
r
r
r
r
r
r
I
l
I
r
r
r
r
r
r
r
r
r
r
r
r
k
s
"}
(13,1,1) = {"
r
r
r
r
r
r
r
r
r
r
I
I
I
I
I
l
A
I
l
I
I
I
r
r
r
r
r
I
I
I
I
I
l
I
I
I
I
r
r
r
r
r
r
r
r
r
r
r
r
I
I
I
I
r
r
r
r
r
r
r
r
r
r
r
r
k
s
"}
(14,1,1) = {"
v
I
r
r
r
r
r
r
r
v
I
I
I
I
I
I
I
I
I
I
I
v
r
r
r
r
r
I
l
I
I
I
I
I
I
I
I
I
I
r
r
r
r
r
r
r
r
r
r
I
I
I
A
r
r
r
r
r
r
r
r
r
r
r
r
k
s
"}
(15,1,1) = {"
v
r
r
r
r
r
r
r
r
I
A
I
A
l
I
I
A
I
I
v
r
r
r
r
r
I
I
I
I
I
I
I
I
I
I
I
l
I
I
I
I
r
r
r
r
r
r
r
I
I
I
A
I
r
r
r
r
r
r
r
r
r
r
r
r
k
s
"}
(16,1,1) = {"
v
r
r
r
r
r
r
v
v
I
v
I
I
I
I
I
I
I
I
I
I
r
r
r
r
I
I
I
I
I
I
I
I
I
I
I
I
I
I
I
I
I
I
I
I
r
r
r
I
I
I
I
I
r
r
r
r
r
r
r
r
r
r
r
r
k
s
"}
(17,1,1) = {"
I
r
r
r
r
r
r
I
I
I
v
I
I
I
r
r
r
D
V
V
V
r
r
r
r
I
I
I
I
I
I
I
I
I
I
I
I
I
I
I
I
I
I
I
I
I
I
I
I
l
I
I
r
r
r
r
r
r
r
r
r
r
r
r
r
k
s
"}
(18,1,1) = {"
I
r
r
r
r
r
r
v
I
v
I
I
I
r
r
r
r
r
I
I
A
I
I
l
l
I
I
I
I
I
l
I
I
I
I
I
I
I
I
I
I
l
I
l
I
I
I
I
I
I
I
I
r
r
r
r
r
r
r
r
r
r
r
r
r
k
k
"}
(19,1,1) = {"
I
r
r
r
r
r
I
I
I
v
I
r
r
r
r
r
r
r
r
r
I
I
I
I
I
I
I
I
A
I
I
I
I
A
I
I
I
I
I
I
I
I
A
I
I
I
I
h
I
A
I
A
r
r
r
r
r
r
r
r
r
r
r
r
r
r
k
"}
(20,1,1) = {"
I
r
r
I
I
I
A
I
I
I
A
r
r
r
r
r
r
r
r
r
I
I
I
l
I
I
I
I
I
I
l
I
I
I
I
I
I
I
I
I
I
I
I
I
I
I
l
I
I
I
I
I
r
r
r
r
r
r
r
r
r
r
r
r
r
r
k
"}
(21,1,1) = {"
I
I
I
I
I
I
I
I
v
I
r
r
r
r
r
r
r
r
r
r
A
I
I
I
A
I
l
I
A
I
I
I
I
I
I
I
I
I
I
I
I
I
I
I
I
I
I
I
I
I
I
r
r
r
r
r
r
r
r
r
r
r
r
r
r
r
k
"}
(22,1,1) = {"
I
I
I
I
v
v
I
I
I
I
r
r
r
r
r
r
r
r
r
r
r
I
I
I
I
I
I
I
I
I
h
I
I
l
I
I
I
r
r
r
r
I
I
I
I
I
I
I
I
I
r
r
r
r
r
r
r
r
r
r
r
r
r
r
r
r
k
"}
(23,1,1) = {"
h
A
I
v
I
I
A
I
I
r
r
r
r
r
r
r
r
r
r
r
r
r
I
I
I
I
I
I
I
I
I
I
I
I
I
I
r
r
r
r
r
r
r
r
r
r
r
r
r
r
r
r
r
r
r
r
r
r
r
r
r
r
r
r
r
r
k
"}
(24,1,1) = {"
I
v
t
I
I
I
I
v
r
r
r
r
r
r
r
r
r
r
r
r
r
r
r
I
I
I
I
I
I
I
I
I
I
I
I
I
r
r
r
r
r
r
r
r
r
r
r
r
r
r
r
r
r
r
r
r
r
r
r
r
r
r
r
r
r
r
k
"}
(25,1,1) = {"
v
I
I
v
r
r
r
r
r
r
r
r
r
r
r
r
r
r
r
r
r
r
r
r
A
I
I
I
l
A
I
I
I
I
I
I
r
r
r
r
r
r
r
r
r
r
r
r
r
r
r
r
r
r
r
r
r
r
r
r
r
r
r
r
r
r
k
"}
(26,1,1) = {"
I
I
I
v
r
r
r
r
r
r
r
r
r
r
r
r
r
r
r
r
r
r
r
r
r
I
I
I
A
I
I
l
I
A
I
r
r
r
r
r
r
r
r
r
r
r
r
r
r
r
r
r
r
r
r
r
r
r
r
r
r
r
r
r
r
r
k
"}
(27,1,1) = {"
r
r
r
r
r
r
r
r
r
r
r
r
r
r
r
r
r
r
r
r
r
r
r
r
r
I
I
I
I
I
I
I
I
I
I
r
r
r
r
r
r
r
r
r
r
r
r
r
r
r
r
r
r
r
r
r
r
r
r
r
r
r
r
r
r
r
k
"}
(28,1,1) = {"
r
r
r
r
r
r
r
r
r
r
r
r
r
r
r
r
r
r
r
r
r
r
r
r
r
I
I
I
I
I
I
I
I
I
r
r
r
r
r
r
r
r
r
r
r
r
r
r
r
r
r
r
r
r
r
r
r
r
r
r
r
r
r
r
r
r
k
"}
(29,1,1) = {"
r
r
r
r
r
r
r
r
r
r
r
r
r
r
r
r
r
r
r
r
r
r
r
r
r
I
I
I
I
I
I
I
I
r
r
r
r
r
r
r
r
r
r
r
r
r
r
r
r
r
r
r
r
r
r
r
r
r
r
r
r
r
r
r
r
r
k
"}
(30,1,1) = {"
r
r
r
r
r
r
r
r
r
r
r
r
r
r
r
r
r
r
r
r
r
r
r
r
r
I
I
I
A
I
I
I
r
r
r
r
r
r
r
r
r
r
r
r
r
r
r
r
r
r
r
r
r
r
r
r
r
r
r
r
r
r
r
r
r
r
k
"}
(31,1,1) = {"
r
r
r
r
r
r
r
r
r
r
r
r
r
r
r
r
r
r
r
r
r
r
r
r
r
I
I
g
I
I
I
r
r
r
r
r
r
r
r
r
r
r
r
r
r
r
r
r
r
r
r
r
r
r
r
r
r
r
r
r
r
r
r
r
r
r
k
"}
(32,1,1) = {"
I
I
r
r
r
r
r
r
r
r
r
r
r
r
r
r
r
r
r
r
r
r
r
r
r
I
I
I
l
I
r
r
r
r
r
r
r
r
r
r
r
r
r
r
r
r
r
r
r
r
r
r
r
r
r
r
r
r
r
r
r
r
r
r
r
r
k
"}
(33,1,1) = {"
I
I
l
I
A
r
r
r
r
r
r
r
r
r
r
r
r
r
r
r
r
r
r
r
r
C
I
I
I
I
r
r
r
r
r
r
r
r
r
r
r
r
r
r
r
r
r
r
r
r
r
r
r
r
r
r
r
r
r
r
r
r
r
r
r
r
k
"}
(34,1,1) = {"
I
I
I
I
I
I
I
r
r
r
r
r
r
r
r
r
r
r
r
r
r
r
r
r
r
I
I
I
I
I
r
r
r
r
r
r
r
r
r
r
r
r
r
r
r
r
r
r
r
r
r
r
r
r
r
r
r
r
r
r
r
r
r
r
r
r
k
"}
(35,1,1) = {"
I
I
I
I
I
I
I
r
r
r
r
r
r
r
r
r
r
r
r
r
r
r
r
r
r
I
I
I
l
I
r
r
r
r
r
r
r
r
r
r
r
r
r
r
r
r
r
r
r
r
r
r
r
r
r
r
r
r
r
r
r
r
r
r
r
r
k
"}
(36,1,1) = {"
I
I
I
I
I
I
I
I
r
I
r
r
r
r
r
r
r
r
r
r
r
r
r
r
I
I
I
I
I
I
r
r
r
r
r
r
r
r
r
r
r
r
r
r
r
r
r
r
r
r
r
r
r
r
r
r
r
r
r
r
r
r
r
r
r
r
k
"}
(37,1,1) = {"
I
I
I
I
A
l
I
A
I
I
I
I
r
r
r
r
r
r
r
r
r
r
U
U
e
e
H
e
e
e
r
r
r
r
r
r
r
r
r
r
r
r
r
r
r
r
r
r
r
r
r
r
r
r
r
r
r
r
r
r
r
r
r
r
r
r
k
"}
(38,1,1) = {"
r
r
I
I
I
I
I
I
I
I
I
I
I
I
r
r
r
r
r
r
r
r
U
r
n
n
V
V
n
U
r
r
r
r
r
r
r
r
r
r
r
r
r
r
r
r
r
r
r
r
r
r
r
r
r
r
r
r
r
r
r
r
r
k
k
k
k
"}
(39,1,1) = {"
r
r
I
I
I
I
I
A
I
I
I
I
I
I
A
I
I
T
r
r
r
r
U
r
I
I
I
I
I
U
r
r
r
r
r
r
r
r
r
r
r
r
r
r
r
r
r
r
r
r
r
r
r
r
r
r
r
r
r
r
r
r
r
k
s
s
s
"}
(40,1,1) = {"
r
r
I
I
I
I
I
I
I
I
I
I
I
I
I
I
I
I
I
r
r
r
U
n
I
I
I
I
I
U
r
r
r
r
r
r
r
r
r
r
r
r
r
r
r
r
r
r
r
r
r
r
r
r
r
r
r
r
r
r
r
r
r
k
s
s
s
"}
(41,1,1) = {"
I
I
I
I
I
I
I
I
I
I
l
I
I
I
I
I
l
I
I
I
r
r
U
n
I
I
I
I
I
U
r
r
r
r
r
r
r
r
r
r
r
r
r
r
r
r
r
r
r
r
r
r
r
r
r
r
r
r
r
r
r
r
r
k
s
s
s
"}
(42,1,1) = {"
I
I
I
I
I
I
I
I
I
I
I
I
I
I
I
I
I
I
I
I
I
I
U
n
I
I
I
I
I
U
r
r
r
r
r
r
r
r
r
r
r
r
r
r
r
r
r
r
r
r
r
r
r
r
r
r
r
r
r
r
r
r
r
k
s
s
s
"}
(43,1,1) = {"
I
I
I
l
I
I
I
I
I
I
I
I
I
I
I
h
I
I
I
I
I
I
R
n
I
l
I
I
I
U
r
r
r
r
r
r
r
r
r
r
r
r
r
r
r
r
r
r
r
r
r
r
r
r
r
r
r
r
r
r
r
r
r
k
s
s
s
"}
(44,1,1) = {"
I
I
I
I
I
I
I
l
I
I
I
I
l
I
I
I
I
I
I
I
I
I
R
I
I
I
I
I
l
U
r
r
r
r
r
r
r
r
r
r
r
r
r
r
r
r
r
r
r
r
r
r
r
r
r
r
r
r
r
r
r
r
r
k
s
s
s
"}
(45,1,1) = {"
I
A
I
I
I
I
I
A
I
I
I
I
I
I
g
I
I
I
I
I
I
I
W
I
l
A
I
g
L
U
r
r
r
r
r
r
r
r
r
r
r
r
r
r
r
r
r
r
r
r
r
r
r
r
r
r
r
r
r
r
r
r
r
k
s
s
s
"}
(46,1,1) = {"
I
I
I
I
I
I
I
I
I
r
I
I
I
I
I
I
I
I
I
l
I
I
W
I
I
i
I
l
I
U
r
r
r
r
r
r
r
r
r
r
r
r
r
r
r
r
r
r
r
r
r
r
r
r
r
r
r
r
r
r
r
r
r
k
s
s
s
"}
(47,1,1) = {"
I
I
l
I
I
I
I
I
I
r
r
r
I
I
I
I
I
I
l
I
I
I
R
I
l
I
I
I
r
U
r
r
r
r
r
r
r
r
r
r
r
r
r
r
r
r
r
r
r
r
r
r
r
r
r
r
r
r
r
r
r
r
r
k
s
s
s
"}
(48,1,1) = {"
I
I
I
I
I
I
I
r
r
r
r
r
r
r
r
I
I
I
I
I
I
I
R
I
I
I
I
r
r
U
r
r
r
r
r
r
r
r
r
r
r
r
r
r
r
r
r
r
r
r
r
r
r
r
r
r
r
r
r
r
r
r
r
k
s
s
s
"}
(49,1,1) = {"
I
A
I
I
I
I
r
r
r
r
r
r
r
r
r
r
r
I
I
I
I
I
R
I
I
r
r
r
r
U
r
r
r
r
r
r
r
r
r
r
r
r
r
r
r
r
r
r
r
r
r
r
r
r
r
r
r
r
r
r
r
r
r
k
s
s
s
"}
(50,1,1) = {"
I
I
I
r
r
r
r
r
r
r
r
r
r
r
r
r
r
r
r
y
I
I
R
r
r
r
r
r
r
U
r
r
r
r
r
r
r
r
r
r
r
r
r
r
r
r
r
r
r
r
r
r
r
r
r
r
r
r
r
r
r
r
r
k
s
s
s
"}
(51,1,1) = {"
I
I
I
r
r
r
r
r
r
r
r
r
r
r
r
r
r
r
r
r
r
r
U
U
U
U
U
U
U
U
r
r
r
r
r
r
r
r
r
r
r
r
r
r
r
r
r
r
r
r
r
r
r
r
r
r
r
r
r
r
r
r
r
k
s
s
s
"}
(52,1,1) = {"
r
r
r
r
r
r
r
r
r
r
r
r
r
r
r
r
r
r
r
r
r
r
r
r
r
r
r
r
r
r
r
r
r
r
r
r
r
r
r
r
r
r
r
r
r
r
r
r
r
r
r
r
r
r
r
r
r
r
r
r
r
r
r
k
s
s
s
"}
(53,1,1) = {"
r
r
r
r
r
r
r
r
r
r
r
r
r
r
r
r
r
r
r
r
r
r
r
r
r
r
r
r
r
r
r
r
r
r
r
r
r
r
r
r
r
r
r
r
r
r
r
r
r
r
r
r
r
r
r
r
r
r
r
r
r
r
r
k
s
s
s
"}
(54,1,1) = {"
r
r
r
r
r
r
r
r
r
r
r
r
r
r
r
r
r
r
r
r
r
r
r
r
r
r
r
r
r
r
r
r
r
r
r
r
r
r
r
r
r
r
r
r
r
r
r
r
r
r
r
r
r
r
r
r
r
r
r
r
r
r
r
k
s
s
s
"}
(55,1,1) = {"
r
r
r
r
r
r
r
r
r
r
r
r
r
r
r
r
r
r
r
r
r
r
r
r
r
r
r
r
r
r
r
r
r
r
r
r
r
r
r
r
r
r
r
r
r
r
r
r
r
r
r
r
r
r
r
r
r
r
r
r
r
r
r
k
s
s
s
"}
(56,1,1) = {"
r
r
r
r
r
r
r
r
r
r
r
r
r
r
r
r
r
r
r
r
r
r
r
r
r
r
r
r
r
r
r
r
r
r
r
r
r
r
r
r
r
r
r
r
r
r
r
r
r
r
r
r
r
r
r
r
r
r
r
r
r
r
r
k
s
s
s
"}
(57,1,1) = {"
r
r
r
r
r
r
r
r
r
r
r
r
r
r
r
r
r
r
r
r
r
r
r
r
r
r
r
r
r
r
r
r
r
r
r
r
r
r
r
r
r
r
r
r
r
r
r
r
r
r
r
r
r
r
r
r
r
r
r
r
r
r
r
k
s
s
s
"}
(58,1,1) = {"
r
r
r
r
r
r
r
r
r
r
r
r
r
r
r
r
r
r
r
r
r
r
r
r
r
r
r
r
r
r
r
r
r
r
r
r
r
r
r
r
r
r
r
r
r
r
r
r
r
r
r
r
r
r
r
r
r
r
r
r
r
r
r
k
s
s
s
"}
(59,1,1) = {"
r
r
r
r
r
r
r
r
r
r
r
r
r
r
r
r
r
r
r
r
r
r
r
r
r
r
r
r
r
r
r
r
r
r
r
r
r
r
r
r
r
r
r
r
r
r
r
r
r
r
r
r
r
r
r
r
r
r
r
r
r
r
r
k
s
s
s
"}
(60,1,1) = {"
r
r
r
r
r
r
r
r
r
r
r
r
r
r
r
r
r
r
r
r
r
r
r
r
r
r
r
r
r
r
r
r
r
r
r
r
r
r
r
r
r
r
r
r
r
r
r
r
r
r
r
r
r
r
r
r
r
r
r
r
r
r
r
k
s
s
s
"}
(61,1,1) = {"
r
r
r
r
r
r
r
r
r
r
r
r
r
r
r
r
r
r
r
r
r
r
r
r
r
r
r
r
r
r
r
r
r
r
r
r
r
r
r
r
r
r
r
r
r
r
r
r
r
r
r
r
r
r
r
r
r
r
r
r
r
r
r
k
s
s
s
"}
(62,1,1) = {"
r
r
r
r
r
r
r
r
r
r
r
r
r
r
r
r
r
r
r
r
r
r
r
r
r
r
r
r
r
r
r
r
r
r
r
r
r
r
r
r
r
r
r
r
r
r
r
r
r
r
r
r
r
r
r
r
r
r
r
r
r
r
r
k
s
s
s
"}
(63,1,1) = {"
k
k
k
k
k
k
k
k
k
k
k
k
k
k
k
k
k
k
k
k
k
k
k
k
k
k
k
k
k
k
k
k
k
k
k
k
k
k
k
k
k
k
k
k
r
r
r
r
r
r
r
r
r
r
r
r
r
r
r
r
r
r
r
k
s
s
s
"}
(64,1,1) = {"
s
s
s
s
s
s
s
s
s
s
s
s
s
s
s
s
s
s
s
s
s
s
s
s
s
s
s
s
s
s
s
s
s
s
s
s
s
s
s
s
s
s
s
k
r
r
r
r
r
r
r
r
r
r
r
r
r
r
r
r
r
r
r
k
s
s
s
"}
(65,1,1) = {"
s
s
s
s
s
s
s
s
s
s
s
s
s
s
s
s
s
s
s
s
s
s
s
s
s
s
s
s
s
s
s
s
s
s
s
s
s
s
s
s
s
s
s
k
r
r
r
r
r
r
r
r
r
r
r
r
r
r
r
r
r
r
r
k
s
s
s
"}
(66,1,1) = {"
s
s
s
s
s
s
s
s
s
s
s
s
s
s
s
s
s
s
s
s
s
s
s
s
s
s
s
s
s
s
s
s
s
s
s
s
s
s
s
s
s
s
s
k
r
r
r
r
r
r
r
r
r
r
r
r
r
r
r
r
r
r
r
k
s
s
s
"}
(67,1,1) = {"
s
s
s
s
s
s
s
s
s
s
s
s
s
s
s
s
s
s
s
s
s
s
s
s
s
s
s
s
s
s
s
s
s
s
s
s
s
s
s
s
s
s
s
k
r
r
r
r
r
r
r
r
r
r
r
r
r
r
r
r
r
r
r
k
s
s
s
"}
(68,1,1) = {"
s
s
s
s
s
s
s
s
s
s
s
s
s
s
s
s
s
s
s
s
s
s
s
s
s
s
s
s
s
s
s
s
s
s
s
s
s
s
s
s
s
s
s
k
r
r
r
r
r
r
r
r
r
r
r
r
r
r
r
r
r
r
r
k
s
s
s
"}
(69,1,1) = {"
s
s
s
s
s
s
s
s
s
s
s
s
s
s
s
s
s
s
s
s
s
s
s
s
s
s
s
s
s
s
s
s
s
s
s
s
s
s
s
s
s
s
s
k
r
r
r
r
r
r
r
r
r
r
r
r
r
r
r
r
r
r
r
k
s
s
s
"}
(70,1,1) = {"
s
s
s
s
s
s
s
s
s
s
s
s
s
s
s
s
s
s
s
s
s
s
s
s
s
s
s
s
s
s
s
s
s
s
s
s
s
s
s
s
s
s
s
k
k
k
k
k
k
r
r
r
r
r
r
r
r
r
r
r
r
r
r
k
s
s
s
"}
(71,1,1) = {"
s
s
s
s
s
s
s
s
s
s
s
s
s
s
s
s
s
s
s
s
s
s
s
s
s
s
s
s
s
s
s
s
s
s
s
s
s
s
s
s
s
s
s
s
s
s
s
s
k
k
k
k
k
k
k
k
k
k
k
k
k
k
k
k
s
s
s
"}
