//MAP CONVERTED BY dmm2tgm.py THIS HEADER COMMENT PREVENTS RECONVERSION, DO NOT REMOVE
"b" = (
/obj/machinery/chem_master,
/turf/open/floor/tile/whiteyellow{
	dir = 5
	},
/area/bigredv2/caves/lambda_lab)
"d" = (
/atom/movable/effect/landmark/xeno_resin_wall,
/turf/open/floor/plating/ground/mars/random/cave,
/area/bigredv2/caves/northeast)
"h" = (
/turf/closed/wall/r_wall,
/area/bigredv2/caves/rock)
"j" = (
/turf/open/floor/plating/ground/mars/random/cave,
/area/bigredv2/caves/northeast)
"l" = (
/atom/movable/effect/landmark/weed_node,
/turf/open/floor/plating/ground/mars/random/cave/rock,
/area/bigredv2/caves/northeast)
"n" = (
/obj/structure/closet/crate/freezer/rations,
/turf/open/floor/plating,
/area/bigredv2/caves/lambda_lab)
"o" = (
/atom/movable/effect/landmark/lv624/fog_blocker,
/turf/open/floor/plating/ground/mars/random/cave,
/area/bigredv2/caves/northeast)
"q" = (
/atom/movable/effect/ai_node,
/atom/movable/effect/landmark/excavation_site_spawner,
/turf/open/floor/plating/ground/mars/random/cave,
/area/bigredv2/caves/northeast)
"r" = (
/turf/open/floor/plating,
/area/bigredv2/caves/lambda_lab)
"u" = (
/atom/movable/effect/ai_node,
/turf/open/floor/plating/ground/mars/random/cave,
/area/bigredv2/caves/northeast)
"z" = (
/atom/movable/effect/landmark/lv624/fog_blocker,
/turf/closed/mineral/smooth/bigred,
/area/bigredv2/caves/rock)
"A" = (
/obj/machinery/chem_dispenser,
/turf/open/floor/tile/whiteyellow{
	dir = 1
	},
/area/bigredv2/caves/lambda_lab)
"B" = (
/atom/movable/effect/landmark/weed_node,
/turf/open/floor/plating/ground/mars/random/cave,
/area/bigredv2/caves/northeast)
"C" = (
/turf/closed/mineral/smooth/bigred/indestructible,
/area/space)
"H" = (
/obj/machinery/door/poddoor/two_tile_hor,
/turf/open/floor/plating/ground/mars/random/cave,
/area/bigredv2/caves/northeast)
"J" = (
/obj/structure/closet/crate/internals,
/turf/open/floor/plating,
/area/bigredv2/caves/lambda_lab)
"K" = (
/obj/machinery/chem_dispenser,
/turf/open/floor/tile/whiteyellow{
	dir = 9
	},
/area/bigredv2/caves/lambda_lab)
"N" = (
/turf/closed/mineral/smooth/bigred,
/area/bigredv2/caves/rock)
"O" = (
/obj/machinery/miner/damaged/platinum,
/turf/open/floor/plating/ground/mars/random/cave,
/area/bigredv2/caves/northeast)
"S" = (
/atom/movable/effect/landmark/weed_node,
/atom/movable/effect/ai_node,
/turf/open/floor/plating/ground/mars/random/cave,
/area/bigredv2/caves/northeast)
"T" = (
/turf/open/floor/plating/ground/mars/random/cave/rock,
/area/bigredv2/caves/northeast)
"X" = (
/turf/closed/wall/r_wall,
/area/bigredv2/caves/lambda_lab)
"Y" = (
/turf/open/space/basic,
/area/space)

(1,1,1) = {"
Y
Y
Y
Y
Y
Y
Y
Y
Y
C
C
C
C
C
C
N
N
N
N
N
N
N
N
N
N
j
j
j
j
T
N
N
"}
(2,1,1) = {"
Y
Y
Y
Y
Y
Y
Y
Y
Y
C
N
N
N
N
N
N
N
N
N
N
N
N
N
T
T
B
j
j
j
T
N
N
"}
(3,1,1) = {"
Y
Y
Y
Y
Y
Y
Y
Y
Y
C
N
N
N
N
N
N
N
N
N
N
N
N
j
j
j
j
j
j
j
T
N
N
"}
(4,1,1) = {"
Y
Y
Y
Y
Y
Y
Y
Y
Y
C
N
N
N
N
N
N
N
N
N
N
N
j
j
j
j
j
j
j
j
j
T
N
"}
(5,1,1) = {"
Y
Y
Y
Y
Y
Y
Y
Y
Y
C
N
N
N
N
N
N
N
N
N
N
j
j
u
j
u
j
j
B
j
u
T
N
"}
(6,1,1) = {"
Y
Y
Y
Y
Y
Y
Y
Y
Y
C
N
N
N
N
N
N
N
u
j
H
j
u
j
l
j
j
j
j
j
j
T
N
"}
(7,1,1) = {"
Y
Y
Y
Y
Y
Y
Y
Y
Y
C
N
N
N
N
N
N
j
j
j
j
j
j
j
N
N
T
j
j
j
j
T
N
"}
(8,1,1) = {"
Y
Y
Y
Y
Y
Y
Y
Y
Y
C
N
N
N
N
N
N
j
j
j
N
j
j
N
N
N
N
j
j
j
j
B
T
"}
(9,1,1) = {"
Y
Y
Y
Y
Y
Y
Y
Y
Y
C
N
N
N
N
N
N
j
u
j
N
N
N
N
N
N
N
l
j
j
j
j
j
"}
(10,1,1) = {"
Y
Y
Y
Y
Y
Y
Y
Y
Y
C
N
N
N
N
N
j
u
j
j
N
N
N
N
N
N
N
N
T
j
u
j
j
"}
(11,1,1) = {"
Y
Y
Y
Y
Y
Y
Y
Y
Y
C
N
N
N
N
j
j
j
j
j
N
N
N
N
N
N
N
N
N
N
j
u
j
"}
(12,1,1) = {"
Y
Y
Y
Y
Y
Y
Y
Y
Y
C
N
N
N
N
j
j
j
j
j
N
N
N
N
N
N
N
N
N
N
T
j
u
"}
(13,1,1) = {"
Y
Y
Y
Y
Y
Y
Y
Y
Y
C
N
N
N
j
j
j
j
j
N
N
N
N
N
N
N
N
N
N
N
N
N
N
"}
(14,1,1) = {"
Y
Y
Y
Y
Y
Y
Y
Y
Y
C
N
N
u
j
j
j
u
N
N
N
N
N
N
N
N
N
N
N
N
N
N
N
"}
(15,1,1) = {"
Y
Y
Y
Y
Y
Y
Y
Y
Y
C
N
N
j
j
j
N
N
N
N
N
N
N
N
N
N
N
N
h
h
h
h
h
"}
(16,1,1) = {"
Y
Y
Y
Y
Y
Y
Y
Y
Y
C
N
N
j
j
j
N
N
N
N
N
N
N
N
N
N
N
N
h
N
d
d
d
"}
(17,1,1) = {"
Y
Y
Y
Y
Y
Y
Y
Y
Y
C
N
j
j
j
N
N
N
N
N
N
N
N
N
N
N
N
N
h
N
j
j
j
"}
(18,1,1) = {"
Y
Y
Y
Y
Y
Y
Y
Y
Y
C
N
j
u
j
N
N
N
N
N
N
N
N
N
N
N
N
N
h
N
j
j
u
"}
(19,1,1) = {"
Y
Y
Y
Y
Y
Y
Y
Y
Y
C
N
u
j
j
j
N
N
N
N
N
N
N
N
N
N
N
N
N
N
j
j
j
"}
(20,1,1) = {"
Y
Y
Y
Y
Y
Y
Y
Y
Y
C
N
N
j
j
j
j
j
N
N
N
N
N
N
N
N
N
N
N
N
j
j
j
"}
(21,1,1) = {"
Y
Y
Y
Y
Y
Y
Y
Y
Y
C
N
N
j
j
j
j
j
j
j
N
N
N
N
N
N
N
N
N
N
N
j
j
"}
(22,1,1) = {"
Y
Y
Y
Y
Y
Y
Y
Y
Y
C
N
N
u
j
j
j
u
j
j
N
N
N
N
N
N
N
N
N
N
N
j
j
"}
(23,1,1) = {"
Y
Y
Y
Y
Y
Y
Y
Y
Y
C
N
N
N
j
j
j
j
j
j
N
N
N
N
N
N
N
N
N
N
N
j
u
"}
(24,1,1) = {"
Y
Y
Y
Y
Y
Y
Y
Y
Y
C
N
N
N
N
j
j
j
j
j
j
N
N
N
N
N
N
N
N
N
N
B
j
"}
(25,1,1) = {"
Y
Y
Y
Y
Y
Y
Y
Y
Y
C
N
N
N
N
j
j
j
N
j
j
N
N
N
N
N
N
N
N
N
N
N
j
"}
(26,1,1) = {"
Y
Y
Y
Y
Y
Y
Y
Y
Y
C
N
N
N
N
j
j
j
N
j
j
j
N
N
N
N
j
N
N
N
N
N
N
"}
(27,1,1) = {"
Y
Y
Y
Y
Y
Y
Y
Y
Y
C
N
N
N
N
N
j
j
j
j
j
j
j
j
j
j
j
j
N
N
N
N
N
"}
(28,1,1) = {"
Y
Y
Y
Y
Y
Y
Y
Y
Y
C
N
N
N
N
N
j
u
j
j
j
j
j
u
j
j
j
S
N
N
N
N
z
"}
(29,1,1) = {"
Y
Y
Y
Y
Y
Y
Y
Y
Y
C
N
N
N
N
N
N
j
j
j
j
j
j
j
j
j
j
j
N
N
N
z
N
"}
(30,1,1) = {"
Y
Y
Y
Y
Y
Y
Y
Y
Y
C
N
N
N
N
N
N
N
N
N
j
j
j
j
j
j
j
j
N
N
z
N
N
"}
(31,1,1) = {"
Y
Y
Y
Y
Y
Y
Y
Y
Y
C
N
N
N
N
N
N
N
N
N
N
N
N
N
j
j
j
j
N
N
z
N
X
"}
(32,1,1) = {"
Y
Y
Y
Y
Y
Y
Y
Y
Y
C
N
N
N
N
N
N
N
N
N
N
N
N
N
j
j
j
j
N
N
z
N
X
"}
(33,1,1) = {"
Y
Y
Y
Y
Y
Y
Y
Y
Y
C
N
N
N
N
N
N
N
N
N
N
N
N
N
u
j
j
S
N
N
z
N
X
"}
(34,1,1) = {"
Y
Y
Y
Y
Y
Y
Y
Y
Y
C
N
N
N
N
N
N
N
N
N
N
N
N
N
j
j
j
j
N
N
z
N
X
"}
(35,1,1) = {"
Y
Y
Y
Y
Y
Y
Y
Y
Y
C
N
N
N
N
N
N
N
N
N
N
N
N
N
j
j
j
j
N
N
z
N
X
"}
(36,1,1) = {"
Y
Y
Y
Y
Y
Y
Y
Y
Y
C
N
N
N
N
N
N
N
N
N
N
N
N
N
j
j
B
j
j
N
z
N
N
"}
(37,1,1) = {"
Y
Y
Y
Y
Y
Y
Y
Y
Y
C
N
N
N
N
N
N
N
N
N
N
N
N
N
j
j
j
j
j
N
z
N
N
"}
(38,1,1) = {"
Y
Y
Y
Y
Y
Y
Y
Y
Y
C
N
N
N
N
N
N
N
N
N
N
N
N
N
j
j
j
j
j
N
z
N
N
"}
(39,1,1) = {"
Y
Y
Y
Y
Y
Y
Y
Y
Y
C
N
N
N
N
N
N
N
N
N
N
N
N
N
j
j
j
j
j
N
z
X
X
"}
(40,1,1) = {"
Y
Y
Y
Y
Y
Y
Y
Y
Y
C
C
C
C
C
C
C
C
C
C
C
N
N
N
j
j
j
B
j
N
z
X
r
"}
(41,1,1) = {"
Y
Y
Y
Y
Y
Y
Y
Y
Y
Y
Y
Y
Y
Y
Y
Y
Y
Y
Y
C
N
N
N
j
j
j
B
j
N
z
X
J
"}
(42,1,1) = {"
Y
Y
Y
Y
Y
Y
Y
Y
Y
Y
Y
Y
Y
Y
Y
Y
Y
Y
Y
C
N
N
N
j
j
j
j
j
N
z
X
n
"}
(43,1,1) = {"
Y
Y
Y
Y
Y
Y
Y
Y
Y
Y
Y
Y
Y
Y
Y
Y
Y
Y
Y
C
N
N
N
u
B
j
u
j
N
z
X
X
"}
(44,1,1) = {"
Y
Y
Y
Y
Y
Y
Y
Y
Y
Y
Y
Y
Y
Y
Y
Y
Y
Y
Y
C
N
N
N
j
j
j
j
j
j
z
X
K
"}
(45,1,1) = {"
Y
Y
Y
Y
Y
Y
Y
Y
Y
Y
Y
Y
Y
Y
Y
Y
Y
Y
Y
C
N
N
N
j
j
j
j
j
j
o
X
A
"}
(46,1,1) = {"
Y
Y
Y
Y
Y
Y
Y
Y
Y
Y
Y
Y
Y
Y
Y
Y
Y
Y
Y
C
N
N
N
j
j
j
j
j
j
o
X
A
"}
(47,1,1) = {"
Y
Y
Y
Y
Y
Y
Y
Y
Y
Y
Y
Y
Y
Y
Y
Y
Y
Y
Y
C
N
N
N
j
j
j
j
j
N
z
X
b
"}
(48,1,1) = {"
Y
Y
Y
Y
Y
Y
Y
Y
Y
Y
Y
Y
Y
Y
Y
Y
Y
Y
Y
C
N
N
N
N
j
j
j
B
N
z
X
X
"}
(49,1,1) = {"
Y
Y
Y
Y
Y
Y
Y
Y
Y
Y
Y
Y
Y
Y
Y
Y
Y
Y
Y
C
N
N
N
N
j
j
j
j
N
N
z
X
"}
(50,1,1) = {"
Y
Y
Y
Y
Y
Y
Y
Y
Y
Y
Y
Y
Y
Y
Y
Y
Y
Y
Y
C
N
N
N
N
j
j
j
j
j
j
N
z
"}
(51,1,1) = {"
Y
Y
Y
Y
Y
Y
Y
Y
Y
Y
Y
Y
Y
Y
Y
Y
Y
Y
Y
C
N
N
N
N
N
j
j
q
j
j
j
T
"}
(52,1,1) = {"
Y
Y
Y
Y
Y
Y
Y
Y
Y
Y
Y
Y
Y
Y
Y
Y
Y
Y
Y
C
N
N
N
N
N
j
u
j
j
j
u
j
"}
(53,1,1) = {"
Y
Y
Y
Y
Y
Y
Y
Y
Y
Y
Y
Y
Y
Y
Y
Y
Y
Y
Y
C
N
N
N
N
N
N
j
j
B
j
j
j
"}
(54,1,1) = {"
Y
Y
Y
Y
Y
Y
Y
Y
Y
Y
Y
Y
Y
Y
Y
Y
Y
Y
Y
C
N
N
N
N
N
N
j
j
j
j
j
j
"}
(55,1,1) = {"
Y
Y
Y
Y
Y
Y
Y
Y
Y
Y
Y
Y
Y
Y
Y
Y
Y
Y
Y
C
N
N
N
N
N
N
N
j
O
j
j
j
"}
(56,1,1) = {"
Y
Y
Y
Y
Y
Y
Y
Y
Y
Y
Y
Y
Y
Y
Y
Y
Y
Y
Y
C
N
N
N
N
N
N
N
j
j
j
B
j
"}
(57,1,1) = {"
Y
Y
Y
Y
Y
Y
Y
Y
Y
Y
Y
Y
Y
Y
Y
Y
Y
Y
Y
C
N
N
N
N
N
N
N
j
j
j
j
j
"}
(58,1,1) = {"
Y
Y
Y
Y
Y
Y
Y
Y
Y
Y
Y
Y
Y
Y
Y
Y
Y
Y
Y
C
N
N
N
N
N
N
N
j
j
j
u
j
"}
(59,1,1) = {"
Y
Y
Y
Y
Y
Y
Y
Y
Y
Y
Y
Y
Y
Y
Y
Y
Y
Y
Y
C
N
N
N
N
N
N
N
j
j
j
j
j
"}
(60,1,1) = {"
Y
Y
Y
Y
Y
Y
Y
Y
Y
Y
Y
Y
Y
Y
Y
Y
Y
Y
Y
C
N
N
N
N
N
N
N
N
j
j
u
j
"}
(61,1,1) = {"
Y
Y
Y
Y
Y
Y
Y
Y
Y
Y
Y
Y
Y
Y
Y
Y
Y
Y
Y
C
N
N
N
N
N
N
N
N
N
j
B
j
"}
(62,1,1) = {"
Y
Y
Y
Y
Y
Y
Y
Y
Y
Y
Y
Y
Y
Y
Y
Y
Y
Y
Y
C
N
N
N
N
N
N
N
N
N
j
j
j
"}
(63,1,1) = {"
Y
Y
Y
Y
Y
Y
Y
Y
Y
Y
Y
Y
Y
Y
Y
Y
Y
Y
Y
C
N
N
N
N
N
N
N
N
N
j
j
j
"}
(64,1,1) = {"
Y
Y
Y
Y
Y
Y
Y
Y
Y
Y
Y
Y
Y
Y
Y
Y
Y
Y
Y
C
N
N
N
N
N
N
N
N
N
j
j
j
"}
(65,1,1) = {"
Y
Y
Y
Y
Y
Y
Y
Y
Y
Y
Y
Y
Y
Y
Y
Y
Y
Y
Y
C
N
N
N
N
N
N
N
N
N
j
B
j
"}
