//MAP CONVERTED BY dmm2tgm.py THIS HEADER COMMENT PREVENTS RECONVERSION, DO NOT REMOVE
"ai" = (
/atom/movable/effect/landmark/weed_node,
/turf/open/floor/plating/ground/mars/random/sand,
/area/bigredv2/outside/se)
"aO" = (
/turf/open/floor/marking/asteroidwarning{
	dir = 1
	},
/area/bigredv2/outside/se)
"by" = (
/turf/open/floor{
	dir = 1;
	icon_state = "bot"
	},
/area/bigredv2/outside/s)
"bz" = (
/turf/open/floor/plating/ground/mars/random/sand,
/area/bigredv2/outside/se)
"ce" = (
/obj/machinery/portable_atmospherics/scrubber/huge,
/atom/movable/effect/decal/warning_stripes,
/obj/structure/cable,
/turf/open/floor/plating,
/area/bigredv2/outside/filtration_plant)
"ct" = (
/atom/movable/effect/landmark/weed_node,
/turf/open/floor,
/area/bigredv2/outside/s)
"cx" = (
/obj/machinery/computer3/server/rack,
/atom/movable/effect/decal/warning_stripes/box/threeside,
/turf/open/floor,
/area/bigredv2/outside/filtration_plant)
"cT" = (
/atom/movable/effect/ai_node,
/turf/open/floor/plating/ground/mars/random/cave,
/area/bigredv2/outside/se)
"dn" = (
/obj/machinery/light{
	dir = 1
	},
/atom/movable/effect/ai_node,
/turf/open/floor,
/area/bigredv2/outside/filtration_plant)
"dP" = (
/obj/machinery/atmospherics/pipe/simple/green/hidden{
	dir = 4
	},
/atom/movable/effect/ai_node,
/obj/structure/cable,
/turf/open/floor,
/area/bigredv2/outside/filtration_plant)
"dR" = (
/atom/movable/effect/decal/cleanable/dirt,
/obj/structure/rack,
/atom/movable/effect/spawner/random/tool,
/obj/structure/cable,
/turf/open/floor,
/area/bigredv2/outside/filtration_plant)
"em" = (
/turf/closed/wall,
/area/bigredv2/outside/filtration_plant)
"eE" = (
/obj/machinery/light,
/turf/open/floor,
/area/bigredv2/outside/filtration_plant)
"eH" = (
/turf/open/floor{
	dir = 1;
	icon_state = "asteroidfloor"
	},
/area/bigredv2/outside/s)
"eQ" = (
/obj/machinery/door/airlock/mainship/engineering{
	dir = 1;
	name = "\improper Filtration Facility";
	req_one_access = null
	},
/obj/machinery/atmospherics/pipe/simple/green/hidden,
/obj/structure/cable,
/turf/open/floor,
/area/bigredv2/outside/filtration_plant)
"eR" = (
/atom/movable/effect/decal/cleanable/dirt,
/obj/structure/reagent_dispensers/fueltank,
/turf/open/floor{
	dir = 1;
	icon_state = "bot"
	},
/area/bigredv2/outside/s)
"eT" = (
/atom/movable/effect/decal/cleanable/dirt,
/turf/open/floor,
/area/bigredv2/outside/filtration_plant)
"fg" = (
/atom/movable/effect/decal/cleanable/dirt,
/obj/machinery/atmospherics/pipe/simple/green/hidden,
/atom/movable/effect/ai_node,
/atom/movable/effect/landmark/weed_node,
/turf/open/floor,
/area/bigredv2/outside/filtration_plant)
"fx" = (
/obj/item/tool/pickaxe,
/turf/open/floor,
/area/bigredv2/outside/s)
"fH" = (
/atom/movable/effect/ai_node,
/turf/open/floor,
/area/bigredv2/outside/filtration_plant)
"fI" = (
/obj/structure/dispenser/oxygen,
/atom/movable/effect/landmark/lv624/fog_blocker,
/turf/open/floor/plating/ground/mars/random/cave,
/area/bigredv2/outside/se)
"gg" = (
/obj/machinery/light,
/atom/movable/effect/landmark/weed_node,
/turf/open/floor,
/area/bigredv2/outside/filtration_plant)
"gj" = (
/obj/structure/reagent_dispensers/watertank,
/turf/open/floor,
/area/bigredv2/outside/filtration_plant)
"gl" = (
/obj/machinery/light{
	dir = 1
	},
/turf/open/floor,
/area/bigredv2/outside/s)
"gw" = (
/atom/movable/effect/ai_node,
/obj/structure/cable,
/turf/open/floor,
/area/bigredv2/outside/filtration_plant)
"hR" = (
/atom/movable/effect/decal/cleanable/dirt,
/turf/open/floor{
	dir = 4;
	icon_state = "asteroidwarning"
	},
/area/bigredv2/outside/s)
"iQ" = (
/obj/machinery/atmospherics/pipe/simple/green/hidden{
	dir = 4
	},
/obj/item/frame/table,
/obj/structure/cable,
/turf/open/floor,
/area/bigredv2/outside/filtration_plant)
"iW" = (
/atom/movable/effect/landmark/weed_node,
/turf/open/floor{
	dir = 4;
	icon_state = "asteroidwarning"
	},
/area/bigredv2/outside/s)
"jl" = (
/obj/structure/window/framed/colony,
/turf/open/floor/plating,
/area/bigredv2/outside/filtration_plant)
"jX" = (
/atom/movable/effect/landmark/weed_node,
/turf/open/floor,
/area/bigredv2/outside/filtration_plant)
"kf" = (
/atom/movable/effect/decal/cleanable/dirt,
/turf/open/floor,
/area/bigredv2/outside/s)
"kj" = (
/obj/machinery/computer/nuke_disk_generator/red,
/turf/open/floor,
/area/bigredv2/outside/filtration_plant)
"kB" = (
/obj/machinery/atmospherics/pipe/simple/green/hidden{
	dir = 9
	},
/atom/movable/effect/decal/cleanable/dirt,
/atom/movable/effect/ai_node,
/obj/structure/cable,
/turf/open/floor,
/area/bigredv2/outside/filtration_plant)
"kH" = (
/obj/structure/table,
/atom/movable/effect/spawner/random/toolbox,
/turf/open/floor,
/area/bigredv2/outside/filtration_plant)
"kI" = (
/atom/movable/effect/landmark/lv624/fog_blocker,
/turf/closed/mineral/smooth/bigred,
/area/bigredv2/caves/rock)
"kO" = (
/obj/machinery/door/airlock/mainship/engineering{
	dir = 1;
	name = "\improper Filtration Facility";
	req_one_access = null
	},
/turf/open/floor,
/area/bigredv2/outside/filtration_plant)
"kY" = (
/obj/machinery/portable_atmospherics/scrubber/huge,
/atom/movable/effect/decal/warning_stripes,
/turf/open/floor/plating,
/area/bigredv2/outside/filtration_plant)
"lo" = (
/obj/machinery/door/airlock/mainship/engineering{
	name = "\improper Filtration Facility";
	req_one_access = null
	},
/obj/machinery/atmospherics/pipe/simple/green/hidden{
	dir = 4
	},
/turf/open/floor,
/area/bigredv2/outside/filtration_plant)
"lt" = (
/obj/structure/table,
/atom/movable/effect/spawner/random/toolbox,
/obj/machinery/light{
	dir = 1
	},
/turf/open/floor,
/area/bigredv2/outside/filtration_plant)
"lK" = (
/obj/item/tank/air,
/turf/open/floor/plating/ground/mars/random/cave,
/area/bigredv2/outside/se)
"mH" = (
/turf/open/floor,
/area/bigredv2/outside/s)
"ne" = (
/obj/structure/rack,
/atom/movable/effect/spawner/random/tool,
/obj/machinery/light,
/obj/structure/cable,
/turf/open/floor,
/area/bigredv2/outside/filtration_plant)
"ni" = (
/atom/movable/effect/landmark/lv624/fog_blocker,
/turf/closed/wall/r_wall/unmeltable,
/area/bigredv2/outside/s)
"no" = (
/obj/structure/sign/safety/vent,
/turf/closed/wall/r_wall,
/area/bigredv2/outside/filtration_plant)
"nt" = (
/atom/movable/effect/decal/cleanable/dirt,
/obj/item/radio/headset,
/turf/open/floor,
/area/bigredv2/outside/filtration_plant)
"nG" = (
/turf/open/floor{
	dir = 8;
	icon_state = "asteroidwarning"
	},
/area/bigredv2/outside/s)
"nO" = (
/obj/structure/cable,
/turf/closed/wall/r_wall,
/area/bigredv2/outside/filtration_plant)
"nS" = (
/turf/closed/mineral/smooth/bigred,
/area/bigredv2/outside/filtration_plant)
"ok" = (
/obj/structure/closet/firecloset/full,
/turf/open/floor,
/area/bigredv2/outside/filtration_plant)
"oz" = (
/atom/movable/effect/landmark/lv624/fog_blocker,
/atom/movable/effect/landmark/weed_node,
/turf/open/floor{
	dir = 1;
	icon_state = "asteroidfloor"
	},
/area/bigredv2/outside/s)
"pg" = (
/turf/open/floor/plating/ground/mars/random/cave,
/area/bigredv2/outside/se)
"pu" = (
/obj/item/tank/air,
/atom/movable/effect/decal/cleanable/dirt,
/atom/movable/effect/landmark/weed_node,
/turf/open/floor,
/area/bigredv2/outside/filtration_plant)
"pX" = (
/obj/machinery/computer/general_air_control,
/turf/open/floor,
/area/bigredv2/outside/filtration_plant)
"pY" = (
/obj/item/weapon/twohanded/fireaxe,
/turf/open/floor,
/area/bigredv2/outside/filtration_plant)
"qc" = (
/atom/movable/effect/landmark/weed_node,
/turf/open/floor{
	dir = 1;
	icon_state = "asteroidfloor"
	},
/area/bigredv2/outside/s)
"qp" = (
/obj/machinery/power/geothermal,
/obj/structure/cable,
/turf/open/floor/plating,
/area/bigredv2/outside/filtration_plant)
"qx" = (
/atom/movable/effect/decal/cleanable/dirt,
/obj/machinery/door/poddoor/shutters/mainship{
	dir = 1;
	id = "FiltrationShutters";
	name = "\improper Airlock Shutters"
	},
/turf/open/floor,
/area/bigredv2/outside/filtration_plant)
"qK" = (
/atom/movable/effect/landmark/lv624/fog_blocker,
/turf/open/floor{
	dir = 8;
	icon_state = "asteroidwarning"
	},
/area/bigredv2/outside/s)
"rm" = (
/obj/machinery/atmospherics/pipe/manifold/green/hidden,
/atom/movable/effect/decal/cleanable/dirt,
/obj/structure/cable,
/turf/open/floor,
/area/bigredv2/outside/filtration_plant)
"rF" = (
/atom/movable/effect/decal/cleanable/dirt,
/obj/machinery/atmospherics/pipe/manifold/green/hidden{
	dir = 4
	},
/obj/structure/cable,
/turf/open/floor,
/area/bigredv2/outside/filtration_plant)
"rT" = (
/atom/movable/effect/decal/cleanable/dirt,
/obj/machinery/atmospherics/pipe/simple/green/hidden{
	dir = 4
	},
/atom/movable/effect/ai_node,
/turf/open/floor,
/area/bigredv2/outside/filtration_plant)
"rU" = (
/obj/structure/closet/wardrobe/atmospherics_yellow,
/turf/open/floor,
/area/bigredv2/outside/filtration_plant)
"sk" = (
/obj/structure/dispenser/oxygen,
/turf/open/floor{
	dir = 1;
	icon_state = "bot"
	},
/area/bigredv2/outside/filtration_plant)
"ss" = (
/atom/movable/effect/decal/cleanable/dirt,
/obj/structure/table,
/turf/open/floor,
/area/bigredv2/outside/filtration_plant)
"tm" = (
/turf/closed/wall/r_wall,
/area/bigredv2/outside/filtration_plant)
"uc" = (
/obj/structure/reagent_dispensers/watertank,
/turf/open/floor{
	dir = 1;
	icon_state = "bot"
	},
/area/bigredv2/outside/filtration_plant)
"ux" = (
/obj/structure/window/framed/colony/reinforced/hull,
/turf/open/floor/plating,
/area/bigredv2/outside/filtration_plant)
"uU" = (
/obj/machinery/atmospherics/components/unary/vent_pump,
/turf/open/floor,
/area/bigredv2/outside/filtration_plant)
"vN" = (
/obj/machinery/door/airlock/mainship/engineering{
	dir = 1;
	name = "\improper Atmospherics Condenser";
	req_one_access = null
	},
/turf/open/floor,
/area/bigredv2/outside/filtration_plant)
"wk" = (
/obj/structure/cryofeed,
/turf/open/floor/engine,
/area/bigredv2/outside/filtration_plant)
"wY" = (
/obj/machinery/atmospherics/pipe/simple/green/hidden{
	dir = 5
	},
/obj/structure/cable,
/turf/open/floor,
/area/bigredv2/outside/filtration_plant)
"xv" = (
/obj/machinery/atmospherics/pipe/simple/green/hidden{
	dir = 5
	},
/turf/open/floor,
/area/bigredv2/outside/filtration_plant)
"xD" = (
/obj/structure/table,
/obj/item/tool/lighter/random,
/atom/movable/effect/decal/cleanable/dirt,
/turf/open/floor,
/area/bigredv2/outside/filtration_plant)
"xE" = (
/obj/structure/cargo_container/ch_red{
	dir = 1
	},
/atom/movable/effect/landmark/lv624/fog_blocker,
/turf/open/floor{
	dir = 1;
	icon_state = "bot"
	},
/area/bigredv2/outside/s)
"xJ" = (
/obj/machinery/atmospherics/components/unary/vent_pump,
/atom/movable/effect/decal/cleanable/dirt,
/atom/movable/effect/decal/cleanable/dirt,
/obj/structure/cable,
/turf/open/floor,
/area/bigredv2/outside/filtration_plant)
"xL" = (
/atom/movable/effect/landmark/lv624/fog_blocker,
/atom/movable/effect/landmark/weed_node,
/turf/open/floor,
/area/bigredv2/outside/s)
"xW" = (
/obj/machinery/door_control{
	id = "FiltrationShutters";
	name = "Airlock Shutters"
	},
/turf/open/floor,
/area/bigredv2/outside/s)
"xY" = (
/obj/structure/cryofeed/right{
	name = "\improper coolant feed"
	},
/turf/open/floor/engine,
/area/bigredv2/outside/filtration_plant)
"yj" = (
/obj/structure/window/framed/colony,
/obj/structure/sign/safety/vent,
/turf/open/floor/plating,
/area/bigredv2/outside/filtration_plant)
"yG" = (
/obj/structure/cable,
/turf/open/floor/plating,
/area/bigredv2/outside/filtration_plant)
"yS" = (
/atom/movable/effect/ai_node,
/atom/movable/effect/landmark/weed_node,
/turf/open/floor{
	dir = 1;
	icon_state = "asteroidfloor"
	},
/area/bigredv2/outside/s)
"ze" = (
/obj/structure/table,
/turf/open/floor,
/area/bigredv2/outside/filtration_plant)
"zq" = (
/atom/movable/effect/landmark/lv624/fog_blocker,
/turf/open/floor{
	dir = 4;
	icon_state = "asteroidwarning"
	},
/area/bigredv2/outside/s)
"zX" = (
/obj/machinery/door/poddoor/shutters/mainship{
	dir = 1;
	id = "FiltrationShutters";
	name = "\improper Airlock Shutters"
	},
/turf/open/floor,
/area/bigredv2/outside/filtration_plant)
"Af" = (
/obj/machinery/atmospherics/pipe/simple/green/hidden{
	dir = 4
	},
/atom/movable/effect/landmark/weed_node,
/obj/structure/cable,
/turf/open/floor,
/area/bigredv2/outside/filtration_plant)
"AH" = (
/obj/structure/cargo_container/ch_red{
	dir = 4
	},
/turf/open/floor{
	dir = 1;
	icon_state = "bot"
	},
/area/bigredv2/outside/s)
"Bq" = (
/obj/machinery/atmospherics/pipe/simple/green/hidden{
	dir = 4
	},
/obj/structure/cable,
/turf/open/floor,
/area/bigredv2/outside/filtration_plant)
"BP" = (
/turf/closed/wall/r_wall/unmeltable,
/area/bigredv2/outside/s)
"CD" = (
/atom/movable/effect/ai_node,
/atom/movable/effect/landmark/weed_node,
/turf/open/floor,
/area/bigredv2/outside/s)
"CJ" = (
/obj/structure/table,
/atom/movable/effect/spawner/random/technology_scanner,
/turf/open/floor,
/area/bigredv2/outside/filtration_plant)
"CW" = (
/turf/open/floor/marking/asteroidwarning{
	dir = 9
	},
/area/bigredv2/outside/se)
"Dl" = (
/atom/movable/effect/decal/cleanable/dirt,
/obj/machinery/atmospherics/pipe/simple/green/hidden{
	dir = 4
	},
/obj/structure/cable,
/turf/open/floor,
/area/bigredv2/outside/filtration_plant)
"Dx" = (
/obj/machinery/door/airlock/mainship/engineering{
	dir = 1;
	name = "\improper Atmospherics Condenser";
	req_one_access = null
	},
/obj/machinery/atmospherics/pipe/simple/green/hidden,
/obj/structure/cable,
/turf/open/floor,
/area/bigredv2/outside/filtration_plant)
"Ey" = (
/obj/machinery/atmospherics/components/unary/vent_pump{
	dir = 4
	},
/atom/movable/effect/ai_node,
/turf/open/floor,
/area/bigredv2/outside/filtration_plant)
"Fe" = (
/obj/structure/reagent_dispensers/fueltank,
/turf/open/floor{
	dir = 1;
	icon_state = "bot"
	},
/area/bigredv2/outside/filtration_plant)
"Ff" = (
/turf/closed/wall/r_wall/unmeltable,
/area/bigredv2/outside/filtration_plant)
"Fi" = (
/atom/movable/effect/ai_node,
/obj/machinery/power/apc/drained,
/obj/structure/cable,
/turf/open/floor,
/area/bigredv2/outside/filtration_plant)
"FG" = (
/atom/movable/effect/decal/cleanable/dirt,
/obj/machinery/atmospherics/pipe/simple/green/hidden{
	dir = 10
	},
/obj/structure/cable,
/turf/open/floor,
/area/bigredv2/outside/filtration_plant)
"FY" = (
/atom/movable/effect/decal/cleanable/dirt,
/obj/machinery/atmospherics/pipe/simple/green/hidden,
/turf/open/floor,
/area/bigredv2/outside/filtration_plant)
"GD" = (
/turf/open/floor/plating,
/area/bigredv2/outside/filtration_plant)
"Ha" = (
/atom/movable/effect/decal/warning_stripes/box/threeside,
/obj/machinery/computer3/server/rack,
/turf/open/floor,
/area/bigredv2/outside/filtration_plant)
"Hd" = (
/obj/structure/window_frame/colony/reinforced,
/obj/item/shard{
	icon_state = "small"
	},
/turf/open/floor/plating,
/area/bigredv2/outside/filtration_plant)
"Ht" = (
/turf/open/floor{
	dir = 1;
	icon_state = "bot"
	},
/area/bigredv2/outside/filtration_plant)
"HM" = (
/turf/open/floor,
/area/bigredv2/outside/filtration_plant)
"If" = (
/atom/movable/effect/decal/cleanable/dirt,
/obj/structure/window/framed/colony,
/obj/structure/cable,
/turf/open/floor/plating,
/area/bigredv2/outside/filtration_plant)
"Io" = (
/atom/movable/effect/landmark/weed_node,
/turf/open/floor/plating/ground/mars/random/cave,
/area/bigredv2/outside/se)
"Is" = (
/turf/open/floor{
	dir = 4;
	icon_state = "asteroidwarning"
	},
/area/bigredv2/outside/s)
"Iy" = (
/obj/structure/table,
/atom/movable/effect/spawner/random/tool,
/turf/open/floor,
/area/bigredv2/outside/filtration_plant)
"IM" = (
/obj/structure/cable,
/turf/open/floor,
/area/bigredv2/outside/filtration_plant)
"Jk" = (
/atom/movable/effect/landmark/weed_node,
/turf/open/floor{
	dir = 1;
	icon_state = "bot"
	},
/area/bigredv2/outside/filtration_plant)
"Jl" = (
/turf/closed/mineral/smooth/bigred,
/area/bigredv2/caves/rock)
"Jp" = (
/obj/item/tank/air,
/turf/open/floor,
/area/bigredv2/outside/s)
"Ju" = (
/atom/movable/effect/decal/cleanable/dirt,
/turf/closed/wall/r_wall/unmeltable,
/area/bigredv2/outside/filtration_plant)
"JF" = (
/obj/machinery/computer/area_atmos/area,
/turf/open/floor,
/area/bigredv2/outside/filtration_plant)
"JH" = (
/obj/machinery/atmospherics/pipe/simple/green/hidden,
/obj/structure/cable,
/turf/open/floor,
/area/bigredv2/outside/filtration_plant)
"JU" = (
/obj/machinery/atmospherics/pipe/simple/green/hidden{
	dir = 4
	},
/turf/open/floor,
/area/bigredv2/outside/filtration_plant)
"KR" = (
/atom/movable/effect/ai_node,
/turf/open/floor,
/area/bigredv2/outside/s)
"Lx" = (
/turf/closed/wall/r_wall,
/area/bigredv2/outside/s)
"LK" = (
/obj/structure/largecrate/random,
/turf/open/floor{
	dir = 1;
	icon_state = "bot"
	},
/area/bigredv2/outside/filtration_plant)
"LX" = (
/obj/machinery/atmospherics/pipe/simple/green/hidden,
/atom/movable/effect/landmark/weed_node,
/obj/structure/cable,
/turf/open/floor,
/area/bigredv2/outside/filtration_plant)
"Mj" = (
/obj/structure/table,
/obj/machinery/door_control/old{
	id = "FiltrationShutters";
	name = "Airlock Shutters";
	pixel_y = 2
	},
/turf/open/floor,
/area/bigredv2/outside/filtration_plant)
"Mx" = (
/obj/structure/cargo_container/ch_red,
/turf/open/floor{
	dir = 1;
	icon_state = "bot"
	},
/area/bigredv2/outside/s)
"ME" = (
/atom/movable/effect/landmark/lv624/fog_blocker,
/turf/open/floor/plating/ground/mars/random/cave,
/area/bigredv2/outside/se)
"Np" = (
/obj/machinery/atmospherics/pipe/manifold/green/hidden,
/atom/movable/effect/ai_node,
/obj/structure/cable,
/turf/open/floor,
/area/bigredv2/outside/filtration_plant)
"Ny" = (
/turf/open/floor/marking/asteroidwarning{
	dir = 5
	},
/area/bigredv2/outside/se)
"NN" = (
/obj/machinery/light,
/atom/movable/effect/ai_node,
/turf/open/floor{
	dir = 1;
	icon_state = "asteroidfloor"
	},
/area/bigredv2/outside/s)
"NR" = (
/obj/machinery/portable_atmospherics/scrubber/huge,
/atom/movable/effect/landmark/weed_node,
/turf/open/floor/plating,
/area/bigredv2/outside/filtration_plant)
"OK" = (
/obj/machinery/atmospherics/pipe/simple/green/hidden{
	dir = 4
	},
/obj/machinery/door/airlock/mainship/engineering{
	name = "\improper Atmospherics Condenser Storage";
	req_one_access = null
	},
/obj/structure/cable,
/turf/open/floor,
/area/bigredv2/outside/filtration_plant)
"PG" = (
/atom/movable/effect/ai_node,
/atom/movable/effect/landmark/weed_node,
/turf/open/floor,
/area/bigredv2/outside/filtration_plant)
"Qo" = (
/obj/machinery/atmospherics/pipe/manifold/green/hidden,
/turf/open/floor,
/area/bigredv2/outside/filtration_plant)
"Qp" = (
/atom/movable/effect/ai_node,
/turf/open/floor{
	dir = 1;
	icon_state = "bot"
	},
/area/bigredv2/outside/filtration_plant)
"Rb" = (
/turf/closed/wall,
/area/bigredv2/outside/s)
"Rj" = (
/obj/machinery/door/poddoor/shutters/mainship{
	dir = 1;
	id = "FiltrationShutters";
	name = "\improper Airlock Shutters"
	},
/turf/open/floor/marking/delivery,
/area/bigredv2/outside/filtration_plant)
"Ru" = (
/atom/movable/effect/decal/cleanable/dirt,
/turf/closed/wall,
/area/bigredv2/outside/filtration_plant)
"Rz" = (
/atom/movable/effect/landmark/lv624/fog_blocker,
/turf/open/floor{
	dir = 1;
	icon_state = "bot"
	},
/area/bigredv2/outside/s)
"SI" = (
/obj/machinery/computer3/server/rack,
/atom/movable/effect/decal/warning_stripes/box/threeside{
	dir = 1
	},
/turf/open/floor,
/area/bigredv2/outside/filtration_plant)
"SR" = (
/obj/machinery/computer/atmos_alert{
	dir = 8
	},
/obj/structure/table,
/turf/open/floor,
/area/bigredv2/outside/filtration_plant)
"Te" = (
/atom/movable/effect/decal/cleanable/dirt,
/atom/movable/effect/decal/cleanable/dirt,
/obj/structure/cable,
/turf/open/floor,
/area/bigredv2/outside/filtration_plant)
"Tm" = (
/obj/machinery/atmospherics/pipe/simple/green/hidden{
	dir = 4
	},
/atom/movable/effect/ai_node,
/turf/open/floor,
/area/bigredv2/outside/filtration_plant)
"TA" = (
/obj/structure/rack,
/obj/item/tank/air,
/obj/item/tool/pickaxe,
/turf/open/floor,
/area/bigredv2/outside/filtration_plant)
"TO" = (
/atom/movable/effect/decal/cleanable/dirt,
/obj/item/frame/table,
/atom/movable/effect/decal/cleanable/dirt,
/turf/open/floor,
/area/bigredv2/outside/filtration_plant)
"TP" = (
/atom/movable/effect/ai_node,
/turf/open/floor{
	dir = 1;
	icon_state = "asteroidfloor"
	},
/area/bigredv2/outside/s)
"UH" = (
/atom/movable/effect/landmark/weed_node,
/turf/open/floor{
	dir = 8;
	icon_state = "asteroidwarning"
	},
/area/bigredv2/outside/s)
"UL" = (
/obj/machinery/light{
	dir = 1
	},
/turf/open/floor,
/area/bigredv2/outside/filtration_plant)
"UP" = (
/atom/movable/effect/landmark/lv624/fog_blocker,
/turf/open/floor,
/area/bigredv2/outside/s)
"VK" = (
/obj/machinery/atmospherics/pipe/simple/green/hidden{
	dir = 10
	},
/atom/movable/effect/ai_node,
/turf/open/floor,
/area/bigredv2/outside/filtration_plant)
"Wn" = (
/obj/structure/table,
/atom/movable/effect/spawner/random/technology_scanner,
/obj/machinery/light,
/turf/open/floor,
/area/bigredv2/outside/filtration_plant)
"Wt" = (
/obj/machinery/atmospherics/pipe/simple/green/hidden{
	dir = 4
	},
/atom/movable/effect/landmark/weed_node,
/turf/open/floor,
/area/bigredv2/outside/filtration_plant)
"Wy" = (
/atom/movable/effect/decal/cleanable/dirt,
/atom/movable/effect/landmark/weed_node,
/turf/open/floor,
/area/bigredv2/outside/filtration_plant)
"WS" = (
/obj/structure/bed/chair{
	dir = 4
	},
/atom/movable/effect/decal/cleanable/dirt,
/turf/open/floor,
/area/bigredv2/outside/filtration_plant)
"Xr" = (
/obj/item/frame/table,
/obj/machinery/light,
/turf/open/floor,
/area/bigredv2/outside/filtration_plant)
"XH" = (
/obj/structure/table,
/obj/item/circuitboard/solar_tracker,
/turf/open/floor,
/area/bigredv2/outside/filtration_plant)
"Yh" = (
/atom/movable/effect/ai_node,
/turf/open/floor/plating/ground/mars/random/sand,
/area/bigredv2/outside/se)
"ZD" = (
/obj/machinery/light,
/turf/open/floor,
/area/bigredv2/outside/s)

(1,1,1) = {"
em
OK
em
em
em
em
em
em
em
jl
jl
Hd
Ff
Ff
Ff
Ff
eH
qc
eH
eH
eH
qc
eH
eH
Rb
"}
(2,1,1) = {"
rU
Bq
gj
em
Fe
Ht
Fe
Fe
em
jX
HM
pY
Ff
nS
nS
Ff
eH
eH
eH
TP
eH
eH
eH
NN
BP
"}
(3,1,1) = {"
rU
dP
gg
em
UL
PG
HM
HM
kO
HM
Ey
HM
Ff
Ff
Ff
Ff
Is
iW
Is
Is
hR
Is
iW
Is
Lx
"}
(4,1,1) = {"
rU
Bq
HM
em
sk
uc
sk
Ht
em
HM
JU
HM
ss
kj
Mj
tm
xW
mH
mH
kf
ct
kf
mH
mH
Lx
"}
(5,1,1) = {"
em
OK
em
em
em
em
em
em
em
UL
Wt
HM
HM
jX
gg
tm
gl
kf
kf
kf
mH
by
by
ZD
Lx
"}
(6,1,1) = {"
xD
Dl
eT
em
Fi
cx
SI
HM
em
HM
JU
Qp
Ht
Ht
fH
Rj
mH
kf
kf
CD
mH
by
Mx
mH
BP
"}
(7,1,1) = {"
Wy
FG
xv
vN
IM
HM
HM
PG
kO
HM
Tm
Fe
LK
Ht
HM
Rj
mH
xL
UP
UP
UP
Rz
xE
UP
ni
"}
(8,1,1) = {"
Te
xJ
rm
jl
IM
Ha
SI
eT
jl
eT
Wt
Ht
Ht
LK
HM
Rj
mH
UP
mH
mH
mH
by
AH
mH
BP
"}
(9,1,1) = {"
FY
fg
rF
Dx
JH
LX
wY
gw
jl
jX
JU
Ht
Ht
Jk
fH
Rj
mH
UP
mH
KR
Jp
eR
by
ZD
Lx
"}
(10,1,1) = {"
eT
nt
WS
em
dn
HM
rT
ne
em
UL
JU
HM
HM
HM
eE
tm
gl
UP
ct
fx
mH
by
by
mH
Lx
"}
(11,1,1) = {"
ze
JF
SR
em
ok
uU
Qo
dR
em
em
lo
em
Ff
ux
ux
Ff
mH
UP
mH
mH
mH
ct
mH
mH
Lx
"}
(12,1,1) = {"
jl
jl
jl
em
ok
jX
Wt
IM
em
HM
JU
CJ
Ff
xY
xY
Ff
nG
qK
nG
nG
nG
UH
nG
nG
Lx
"}
(13,1,1) = {"
GD
NR
GD
em
pX
HM
VK
JH
eQ
LX
Np
CJ
Ju
wk
wk
Ff
eH
oz
eH
yS
eH
eH
eH
NN
Lx
"}
(14,1,1) = {"
yG
yG
yG
em
lt
HM
HM
gg
Ru
UL
Bq
Wn
Ff
xY
xY
Ff
Is
zq
Is
Is
hR
Is
Is
Is
Rb
"}
(15,1,1) = {"
qp
qp
qp
em
Iy
kH
ze
XH
em
HM
Bq
CJ
Ff
wk
wk
Ff
pg
ME
pg
pg
pg
Io
pg
pg
pg
"}
(16,1,1) = {"
em
em
em
em
em
em
Ru
em
em
HM
Bq
HM
Ff
ux
ux
Ff
pg
fI
lK
pg
pg
pg
pg
pg
pg
"}
(17,1,1) = {"
bz
bz
bz
bz
bz
tm
UL
TA
TA
HM
Af
Xr
em
pg
pg
pg
pg
ME
pg
Io
pg
pg
pg
pg
pg
"}
(18,1,1) = {"
Jl
bz
bz
bz
CW
zX
jX
HM
HM
jX
iQ
eT
qx
pg
pg
Io
pg
ME
pg
pg
pg
pg
Io
pg
Io
"}
(19,1,1) = {"
Jl
bz
Yh
ai
aO
zX
PG
HM
HM
uU
kB
HM
zX
cT
pg
pg
pg
ME
Io
cT
pg
pg
cT
pg
cT
"}
(20,1,1) = {"
bz
bz
bz
bz
Ny
zX
HM
HM
eT
pu
IM
TO
zX
pg
Io
pg
pg
ME
pg
pg
pg
pg
pg
pg
pg
"}
(21,1,1) = {"
ai
bz
ai
bz
bz
tm
UL
ok
ok
jX
IM
eE
tm
pg
Io
pg
pg
ME
pg
Io
pg
pg
pg
pg
pg
"}
(22,1,1) = {"
bz
bz
bz
bz
bz
tm
tm
no
tm
jl
If
yj
tm
pg
pg
pg
Io
ME
pg
pg
pg
pg
pg
Io
pg
"}
(23,1,1) = {"
bz
ai
bz
ai
bz
ai
bz
bz
tm
kY
ce
kY
tm
Jl
pg
pg
Jl
kI
pg
pg
pg
Io
pg
pg
pg
"}
(24,1,1) = {"
bz
bz
Yh
bz
bz
ai
bz
Yh
tm
tm
nO
tm
tm
Jl
Jl
Jl
Jl
Jl
kI
cT
pg
pg
pg
pg
cT
"}
