//MAP CONVERTED BY dmm2tgm.py THIS HEADER COMMENT PREVENTS RECONVERSION, DO NOT REMOVE
"a" = (
/turf/open/space/basic,
/area/space)
"b" = (
/atom/movable/effect/landmark/lv624/fog_blocker/xeno_spawn,
/turf/closed/mineral/bigred,
/area/bigredv2/caves/rock)
"i" = (
/atom/movable/effect/ai_node,
/turf/open/floor/plating/ground/mars/random/cave,
/area/bigredv2/caves/southwest)
"k" = (
/atom/movable/effect/landmark/excavation_site_spawner,
/turf/open/floor/plating/ground/mars/random/cave,
/area/bigredv2/caves/southwest)
"m" = (
/atom/movable/effect/ai_node,
/turf/open/floor/plating/ground/mars/random/cave/rock,
/area/bigredv2/caves/southwest)
"o" = (
/atom/movable/effect/landmark/lv624/fog_blocker/xeno_spawn,
/turf/open/floor/plating/ground/mars/random/cave,
/area/bigredv2/caves/southwest)
"q" = (
/atom/movable/effect/landmark/xeno_silo_spawn,
/turf/open/floor/plating/ground/mars/random/cave,
/area/bigredv2/caves/southwest)
"r" = (
/atom/movable/effect/landmark/weed_node,
/atom/movable/effect/ai_node,
/turf/open/floor/plating/ground/mars/random/cave,
/area/bigredv2/caves/southwest)
"s" = (
/turf/closed/wall/indestructible/mineral,
/area/space)
"v" = (
/atom/movable/effect/landmark/weed_node,
/atom/movable/effect/landmark/lv624/fog_blocker/xeno_spawn,
/turf/open/floor/plating/ground/mars/random/cave,
/area/bigredv2/caves/southwest)
"w" = (
/turf/open/floor/plating/ground/mars/random/cave/rock,
/area/bigredv2/caves/southwest)
"z" = (
/atom/movable/effect/landmark/excavation_site_spawner,
/atom/movable/effect/ai_node,
/turf/open/floor/plating/ground/mars/random/cave,
/area/bigredv2/caves/southwest)
"B" = (
/turf/closed/mineral/bigred,
/area/bigredv2/caves/rock)
"C" = (
/atom/movable/effect/landmark/lv624/fog_blocker,
/turf/closed/mineral/bigred,
/area/bigredv2/caves/rock)
"E" = (
/atom/movable/effect/landmark/weed_node,
/turf/open/floor/plating/ground/mars/random/cave/rock,
/area/bigredv2/caves/southwest)
"M" = (
/atom/movable/effect/landmark/lv624/fog_blocker,
/turf/open/floor/plating/ground/mars/random/cave,
/area/bigredv2/caves/southwest)
"Q" = (
/atom/movable/effect/landmark/weed_node,
/atom/movable/effect/landmark/weed_node,
/turf/open/floor/plating/ground/mars/random/cave,
/area/bigredv2/caves/southwest)
"R" = (
/atom/movable/effect/landmark/lv624/fog_blocker/xeno_spawn,
/turf/open/floor/plating/ground/mars/random/cave/rock,
/area/bigredv2/caves/southwest)
"S" = (
/atom/movable/effect/landmark/xeno_resin_door,
/turf/open/floor/plating/ground/mars/random/cave,
/area/bigredv2/caves/southwest)
"T" = (
/turf/open/floor/plating/ground/mars/random/cave,
/area/bigredv2/caves/southwest)
"Y" = (
/atom/movable/effect/landmark/weed_node,
/turf/open/floor/plating/ground/mars/random/cave,
/area/bigredv2/caves/southwest)

(1,1,1) = {"
s
s
s
s
s
s
s
s
s
s
s
s
s
s
s
s
s
s
s
s
s
s
s
s
s
s
s
s
s
s
s
s
s
s
s
s
a
a
a
a
a
a
a
"}
(2,1,1) = {"
B
B
B
B
B
B
B
B
B
B
B
B
B
b
B
B
B
B
B
B
B
B
B
B
B
B
B
B
B
B
B
B
B
B
B
s
a
a
a
a
a
a
a
"}
(3,1,1) = {"
B
B
B
B
B
B
B
B
B
B
B
B
B
b
B
B
B
B
B
B
B
B
B
B
B
B
B
B
B
B
B
B
B
B
B
s
a
a
a
a
a
a
a
"}
(4,1,1) = {"
B
B
B
B
B
B
B
B
B
B
B
B
B
b
B
B
B
B
B
B
B
B
B
B
B
B
B
B
B
B
B
B
B
B
B
s
a
a
a
a
a
a
a
"}
(5,1,1) = {"
B
B
B
B
B
B
B
B
B
B
B
B
B
b
B
B
B
B
B
B
B
B
T
T
T
T
T
B
B
B
B
B
B
B
B
s
a
a
a
a
a
a
a
"}
(6,1,1) = {"
B
B
B
B
B
B
B
B
B
B
B
B
B
b
B
B
B
T
w
w
w
w
w
T
Y
T
T
T
B
B
B
B
B
B
B
s
a
a
a
a
a
a
a
"}
(7,1,1) = {"
B
B
B
B
T
T
i
T
T
B
B
B
B
b
T
E
S
T
T
T
T
T
T
T
T
T
q
T
B
B
B
B
B
B
B
s
a
a
a
a
a
a
a
"}
(8,1,1) = {"
B
B
T
Y
T
Y
T
T
Y
T
T
B
B
o
m
T
S
T
T
Y
T
Y
i
T
T
T
T
i
T
B
B
B
B
B
B
s
a
a
a
a
a
a
a
"}
(9,1,1) = {"
B
T
T
T
T
T
T
T
T
T
T
T
T
o
T
T
S
T
T
T
T
T
T
Y
T
T
T
T
T
B
B
B
B
B
B
s
a
a
a
a
a
a
a
"}
(10,1,1) = {"
T
T
i
T
Y
Y
i
T
Y
T
Y
i
T
v
i
B
B
B
B
B
T
T
T
T
T
T
T
T
T
B
B
B
B
B
B
s
a
a
a
a
a
a
a
"}
(11,1,1) = {"
Y
T
T
T
T
T
Y
T
T
T
T
T
T
o
T
B
B
B
B
B
B
B
T
T
w
T
T
Y
T
B
B
B
B
B
B
s
a
a
a
a
a
a
a
"}
(12,1,1) = {"
T
T
T
T
T
T
T
T
T
T
B
B
B
o
T
T
B
B
B
B
B
B
B
B
T
T
T
T
T
B
B
B
B
B
B
s
a
a
a
a
a
a
a
"}
(13,1,1) = {"
T
w
m
B
B
B
B
B
B
B
B
B
B
o
T
Y
T
B
B
B
B
B
B
B
T
T
T
T
T
B
B
B
B
B
B
s
a
a
a
a
a
a
a
"}
(14,1,1) = {"
T
T
w
B
B
B
B
B
B
B
B
B
B
o
T
T
T
T
T
B
B
B
B
B
B
T
T
w
B
B
B
B
B
B
B
s
a
a
a
a
a
a
a
"}
(15,1,1) = {"
Y
T
T
w
w
B
B
B
B
B
B
B
B
R
i
T
T
T
T
Y
B
B
B
B
B
T
T
T
B
B
B
B
B
B
B
s
a
a
a
a
a
a
a
"}
(16,1,1) = {"
T
T
Q
T
w
B
B
B
B
B
B
B
B
b
T
i
Y
T
T
T
i
B
B
B
B
S
S
S
B
B
B
B
B
B
B
s
a
a
a
a
a
a
a
"}
(17,1,1) = {"
T
Y
T
T
w
B
B
B
B
B
B
B
B
b
T
T
T
T
T
k
T
i
T
T
T
T
T
m
B
B
B
B
B
B
B
s
a
a
a
a
a
a
a
"}
(18,1,1) = {"
T
T
T
T
w
B
B
B
B
B
B
B
B
b
T
T
T
Y
T
T
Y
T
T
Q
T
T
i
B
B
B
B
B
B
B
B
s
a
a
a
a
a
a
a
"}
(19,1,1) = {"
T
Y
i
T
m
B
B
B
B
B
B
B
B
b
b
o
o
o
o
o
o
v
o
R
o
o
o
b
b
b
b
b
b
b
b
s
a
a
a
a
a
a
a
"}
(20,1,1) = {"
B
T
T
T
Y
w
B
B
B
B
B
B
B
B
B
B
T
T
T
T
Y
T
T
w
T
T
T
B
B
B
B
B
B
B
B
s
a
a
a
a
a
a
a
"}
(21,1,1) = {"
B
B
B
T
T
w
B
B
B
B
B
B
B
B
B
B
B
T
T
T
T
T
w
T
T
Y
T
B
B
B
B
B
B
B
B
s
a
a
a
a
a
a
a
"}
(22,1,1) = {"
B
B
B
Y
T
T
w
T
B
B
B
B
B
B
B
B
B
B
B
B
T
T
w
B
B
T
T
B
B
B
B
B
B
B
B
s
a
a
a
a
a
a
a
"}
(23,1,1) = {"
B
B
B
T
T
T
T
T
T
B
B
B
B
B
B
B
B
B
B
B
B
B
B
B
B
T
T
T
B
B
B
B
B
B
B
s
a
a
a
a
a
a
a
"}
(24,1,1) = {"
B
B
B
T
T
Y
T
T
w
T
T
B
B
B
B
B
B
B
B
B
B
B
B
B
T
T
T
T
B
B
B
B
B
B
B
s
a
a
a
a
a
a
a
"}
(25,1,1) = {"
B
B
B
w
T
T
T
Y
T
T
E
T
B
B
B
B
B
B
B
B
B
B
B
B
T
r
T
T
B
B
B
B
B
B
B
s
a
a
a
a
a
a
a
"}
(26,1,1) = {"
B
B
B
B
i
T
T
T
T
T
T
Y
w
B
B
B
B
B
B
B
B
B
B
B
B
T
i
T
B
B
B
B
B
B
B
s
a
a
a
a
a
a
a
"}
(27,1,1) = {"
B
B
B
T
Y
i
T
T
T
T
T
T
T
T
B
B
B
B
B
B
B
B
B
B
B
T
T
Y
T
B
B
B
B
B
B
s
a
a
a
a
a
a
a
"}
(28,1,1) = {"
B
B
T
T
T
T
T
T
T
T
T
T
Y
T
w
B
B
B
B
B
B
B
B
B
B
B
T
T
T
B
B
B
B
B
B
s
a
a
a
a
a
a
a
"}
(29,1,1) = {"
B
B
T
T
T
T
T
Y
T
T
T
T
T
Y
T
B
B
B
B
B
B
B
B
B
B
B
T
Y
T
B
B
B
B
B
B
s
a
a
a
a
a
a
a
"}
(30,1,1) = {"
B
B
T
Y
T
T
T
T
Y
w
B
w
i
T
T
T
B
B
B
B
B
B
B
B
B
B
T
Y
T
T
B
B
B
B
B
s
a
a
a
a
a
a
a
"}
(31,1,1) = {"
B
T
T
T
T
T
T
T
T
w
B
B
w
i
Y
T
T
B
B
B
B
B
B
B
B
B
m
T
T
T
B
B
B
B
B
s
a
a
a
a
a
a
a
"}
(32,1,1) = {"
B
T
i
T
T
i
B
T
T
w
B
B
B
T
i
T
T
i
T
B
B
B
B
B
B
B
w
m
Y
T
B
B
B
B
B
s
a
a
a
a
a
a
a
"}
(33,1,1) = {"
B
T
T
T
B
B
B
w
w
B
B
B
B
T
T
T
Y
T
Y
T
w
B
B
B
B
B
B
w
i
T
T
B
B
B
B
s
a
a
a
a
a
a
a
"}
(34,1,1) = {"
B
T
T
T
B
B
B
B
B
B
B
B
B
B
T
T
T
T
T
T
T
w
B
B
B
B
B
B
T
T
Y
T
B
B
B
s
a
a
a
a
a
a
a
"}
(35,1,1) = {"
B
T
T
B
B
B
B
B
B
B
B
B
B
T
Y
T
T
T
T
T
w
B
B
B
B
B
B
B
T
T
T
B
B
B
B
s
a
a
a
a
a
a
a
"}
(36,1,1) = {"
B
T
T
B
B
B
B
B
B
B
B
B
B
w
T
T
T
T
Y
T
w
B
B
B
B
B
B
B
T
Y
T
B
B
B
B
s
a
a
a
a
a
a
a
"}
(37,1,1) = {"
T
T
T
B
B
B
B
B
B
B
B
B
B
B
B
B
T
z
T
T
T
m
B
B
B
B
B
B
T
k
T
B
B
B
B
s
a
a
a
a
a
a
a
"}
(38,1,1) = {"
T
T
T
B
B
B
B
B
B
B
B
B
B
B
B
B
T
T
T
T
T
w
B
B
B
B
w
E
T
Y
T
B
B
B
B
s
a
a
a
a
a
a
a
"}
(39,1,1) = {"
T
T
T
B
B
B
B
B
B
B
B
B
B
B
B
B
w
T
T
T
T
w
B
B
B
B
w
w
T
T
B
B
B
B
B
s
a
a
a
a
a
a
a
"}
(40,1,1) = {"
T
Y
T
B
B
B
B
B
B
B
B
B
B
B
B
B
B
B
B
Y
Y
T
w
w
B
B
B
B
T
T
B
B
B
B
B
s
a
a
a
a
a
a
a
"}
(41,1,1) = {"
M
M
M
C
C
C
C
C
C
C
C
C
C
C
B
B
B
B
B
T
T
T
T
w
B
B
B
B
T
Y
B
B
B
B
B
s
a
a
a
a
a
a
a
"}
