//MAP CONVERTED BY dmm2tgm.py THIS HEADER COMMENT PREVENTS RECONVERSION, DO NOT REMOVE
"a" = (
/turf/closed/mineral/bigred,
/area/bigredv2/caves/rock)
"b" = (
/obj/effect/landmark/weed_node,
/obj/effect/ai_node,
/turf/open/floor/plating/ground/mars/random/cave,
/area/bigredv2/caves/south)
"c" = (
/obj/effect/landmark/lv624/fog_blocker,
/turf/open/floor/plating/ground/mars/random/cave,
/area/bigredv2/caves/southwest)
"e" = (
/turf/open/floor/plating/ground/mars/random/cave,
/area/bigredv2/caves/south)
"f" = (
/obj/effect/landmark/weed_node,
/turf/open/floor/plating/ground/mars/random/cave/rock,
/area/bigredv2/caves/southwest)
"h" = (
/turf/open/floor/plating/ground/mars/random/cave/rock,
/area/bigredv2/caves/southwest)
"n" = (
/obj/effect/landmark/weed_node,
/obj/effect/ai_node,
/turf/open/floor/plating/ground/mars/random/cave,
/area/bigredv2/caves/southwest)
"r" = (
/obj/effect/landmark/weed_node,
/turf/open/floor/plating/ground/mars/random/cave/rock,
/area/bigredv2/caves/south)
"t" = (
/obj/machinery/miner/damaged/platinum,
/turf/open/floor/plating/ground/mars/random/cave,
/area/bigredv2/caves/south)
"y" = (
/obj/effect/ai_node,
/turf/open/floor/plating/ground/mars/random/cave,
/area/bigredv2/caves/southwest)
"z" = (
/obj/effect/ai_node,
/turf/open/floor/plating/ground/mars/random/cave/rock,
/area/bigredv2/caves/southwest)
"C" = (
/turf/open/floor/plating/ground/mars/random/cave/rock,
/area/bigredv2/caves/south)
"D" = (
/obj/effect/landmark/lv624/fog_blocker,
/obj/effect/landmark/weed_node,
/turf/open/floor/plating/ground/mars/random/cave/rock,
/area/bigredv2/caves/southwest)
"E" = (
/turf/open/floor/plating,
/area/bigredv2/caves/south)
"F" = (
/obj/effect/ai_node,
/turf/open/floor/plating/ground/mars/random/cave,
/area/bigredv2/caves/south)
"H" = (
/turf/open/floor/plating/ground/mars/random/cave,
/area/bigredv2/caves/southwest)
"J" = (
/obj/effect/landmark/lv624/fog_blocker,
/turf/open/floor/plating/ground/mars/random/cave,
/area/bigredv2/caves/south)
"N" = (
/obj/effect/landmark/weed_node,
/turf/open/floor/plating/ground/mars/random/cave,
/area/bigredv2/caves/south)
"O" = (
/obj/effect/landmark/lv624/fog_blocker,
/turf/closed/mineral/bigred,
/area/bigredv2/caves/rock)
"Q" = (
/obj/effect/landmark/weed_node,
/turf/open/floor/plating/ground/mars/random/cave,
/area/bigredv2/caves/southwest)
"R" = (
/obj/effect/landmark/excavation_site_spawner,
/turf/open/floor/plating/ground/mars/random/cave,
/area/bigredv2/caves/south)
"W" = (
/obj/machinery/miner/damaged/platinum,
/turf/open/floor/plating/ground/mars/random/cave,
/area/bigredv2/caves/southwest)

(1,1,1) = {"
O
a
a
a
a
a
h
H
H
H
h
a
a
a
a
H
Q
a
a
a
a
a
"}
(2,1,1) = {"
c
a
a
a
a
a
a
H
y
Q
h
a
a
a
a
H
H
H
a
a
a
a
"}
(3,1,1) = {"
c
a
a
a
a
a
a
H
H
H
h
a
a
a
h
H
H
a
a
a
a
a
"}
(4,1,1) = {"
c
a
a
a
a
a
H
H
Q
H
h
a
a
a
h
H
Q
a
a
a
a
a
"}
(5,1,1) = {"
c
h
a
a
a
a
H
H
H
H
H
a
a
h
H
H
H
a
a
a
a
a
"}
(6,1,1) = {"
c
h
a
a
h
h
H
Q
H
H
H
a
a
H
Q
y
a
a
a
a
a
a
"}
(7,1,1) = {"
c
Q
h
z
H
H
H
H
y
H
a
a
a
H
y
a
a
a
a
a
a
a
"}
(8,1,1) = {"
c
H
H
h
H
H
H
H
H
a
a
a
H
Q
H
a
a
a
a
a
a
a
"}
(9,1,1) = {"
c
f
H
H
Q
H
H
a
a
a
a
a
H
H
H
a
a
a
a
a
a
a
"}
(10,1,1) = {"
D
H
H
y
a
a
a
a
a
a
a
a
H
H
H
a
a
a
a
a
a
a
"}
(11,1,1) = {"
O
a
a
a
a
a
a
a
a
a
a
a
H
Q
H
H
a
a
a
a
a
a
"}
(12,1,1) = {"
a
O
a
a
a
a
a
a
a
a
a
H
H
H
H
H
a
a
a
a
a
a
"}
(13,1,1) = {"
a
a
O
O
a
a
a
a
a
a
a
H
H
H
Q
H
a
a
a
a
a
a
"}
(14,1,1) = {"
a
a
a
a
O
a
a
a
a
a
a
H
H
H
H
H
a
a
a
a
a
a
"}
(15,1,1) = {"
a
a
a
a
a
O
a
a
a
a
H
H
H
H
H
h
a
a
a
a
a
a
"}
(16,1,1) = {"
a
a
a
a
a
a
O
a
a
a
y
H
H
H
y
h
h
a
a
a
a
a
"}
(17,1,1) = {"
H
a
a
a
a
a
O
a
a
a
H
H
H
H
f
h
a
a
a
a
a
a
"}
(18,1,1) = {"
Q
y
a
a
a
a
O
a
a
a
H
H
H
H
H
H
a
a
a
a
a
a
"}
(19,1,1) = {"
H
H
a
a
a
a
O
a
a
a
H
H
H
W
H
H
H
a
a
a
a
a
"}
(20,1,1) = {"
h
H
a
a
a
a
O
a
a
H
H
H
H
H
Q
h
Q
a
a
a
a
a
"}
(21,1,1) = {"
h
H
H
a
a
a
O
a
a
H
H
H
H
H
H
h
H
a
a
a
a
a
"}
(22,1,1) = {"
Q
y
H
H
n
a
O
a
a
H
Q
H
H
H
H
a
a
a
a
a
a
a
"}
(23,1,1) = {"
H
H
H
H
H
a
O
a
a
H
y
H
Q
H
y
a
a
a
a
a
a
a
"}
(24,1,1) = {"
H
H
H
H
H
a
O
a
a
a
H
H
H
H
H
a
a
a
a
a
a
a
"}
(25,1,1) = {"
H
H
H
H
H
a
O
a
a
H
H
h
Q
H
H
a
a
a
a
a
a
a
"}
(26,1,1) = {"
N
e
e
e
N
a
O
a
a
e
e
e
e
C
e
a
a
a
a
a
a
a
"}
(27,1,1) = {"
e
F
e
e
e
a
O
a
a
a
e
e
e
e
e
a
a
a
a
a
a
a
"}
(28,1,1) = {"
C
e
e
e
e
a
O
a
a
a
e
e
e
e
e
e
a
a
a
a
a
a
"}
(29,1,1) = {"
C
N
e
e
e
a
O
a
a
a
F
e
e
e
F
r
a
a
a
a
a
a
"}
(30,1,1) = {"
e
e
e
e
N
a
O
a
a
a
e
e
e
e
e
e
e
a
a
a
a
a
"}
(31,1,1) = {"
e
e
N
e
e
a
O
a
a
a
e
e
e
e
e
e
e
a
a
a
a
a
"}
(32,1,1) = {"
e
e
e
e
e
a
O
a
a
e
e
e
e
e
e
e
e
N
a
a
a
a
"}
(33,1,1) = {"
e
e
e
e
e
e
J
e
e
e
e
e
e
e
e
e
e
e
a
a
a
a
"}
(34,1,1) = {"
C
e
e
e
e
e
J
e
e
e
e
e
e
e
e
e
e
F
a
a
a
a
"}
(35,1,1) = {"
C
F
N
e
F
e
J
e
e
e
F
e
e
e
e
e
F
e
a
a
a
a
"}
(36,1,1) = {"
C
e
e
e
e
e
J
e
e
e
a
a
a
e
e
F
e
e
e
a
a
a
"}
(37,1,1) = {"
e
e
e
e
e
e
J
e
a
a
a
a
a
a
e
e
e
e
e
e
e
a
"}
(38,1,1) = {"
e
F
e
e
e
e
O
a
a
a
a
a
a
a
e
e
e
N
e
e
e
e
"}
(39,1,1) = {"
e
e
N
a
a
a
O
a
a
a
a
a
a
a
e
F
e
e
e
e
e
F
"}
(40,1,1) = {"
e
e
e
a
a
a
O
a
a
a
a
a
a
a
N
e
e
e
t
e
b
e
"}
(41,1,1) = {"
e
e
e
a
a
a
O
a
a
a
a
a
a
e
e
e
e
e
C
e
e
e
"}
(42,1,1) = {"
e
e
a
a
a
a
O
a
a
a
a
a
e
e
e
e
e
e
e
R
e
e
"}
(43,1,1) = {"
e
a
a
a
a
a
O
a
a
a
a
e
F
e
C
b
e
e
F
r
a
a
"}
(44,1,1) = {"
a
a
a
a
a
a
O
a
a
a
a
a
e
C
E
e
e
C
a
a
a
a
"}
