//MAP CONVERTED BY dmm2tgm.py THIS HEADER COMMENT PREVENTS RECONVERSION, DO NOT REMOVE
"c" = (
/atom/movable/effect/ai_node,
/turf/open/floor/plating/ground/mars/random/cave,
/area/bigredv2/caves/northeast)
"f" = (
/obj/machinery/chem_dispenser,
/turf/open/floor/tile/whiteyellow{
	dir = 1
	},
/area/bigredv2/caves/lambda_lab)
"g" = (
/turf/open/floor/plating/ground/mars/random/cave/rock,
/area/bigredv2/caves/northeast)
"h" = (
/obj/machinery/miner/damaged/platinum,
/turf/open/floor/plating/ground/mars/random/cave,
/area/bigredv2/caves/northeast)
"i" = (
/turf/open/floor/plating/ground/mars/random/cave,
/area/bigredv2/caves/northeast)
"j" = (
/obj/machinery/chem_dispenser,
/turf/open/floor/tile/whiteyellow{
	dir = 9
	},
/area/bigredv2/caves/lambda_lab)
"k" = (
/atom/movable/effect/landmark/lv624/fog_blocker,
/turf/closed/mineral/smooth/bigred,
/area/bigredv2/caves/rock)
"m" = (
/turf/open/floor/plating,
/area/bigredv2/caves/lambda_lab)
"q" = (
/obj/structure/closet/crate/freezer/rations,
/turf/open/floor/plating,
/area/bigredv2/caves/lambda_lab)
"s" = (
/turf/closed/mineral/smooth/bigred,
/area/bigredv2/caves/rock)
"t" = (
/atom/movable/effect/landmark/excavation_site_spawner,
/turf/open/floor/plating/ground/mars/random/cave,
/area/bigredv2/caves/northeast)
"x" = (
/turf/closed/wall/r_wall,
/area/bigredv2/caves/rock)
"F" = (
/turf/closed/mineral/smooth/bigred/indestructible,
/area/space)
"H" = (
/atom/movable/effect/ai_node,
/atom/movable/effect/landmark/excavation_site_spawner,
/turf/open/floor/plating/ground/mars/random/cave,
/area/bigredv2/caves/northeast)
"I" = (
/obj/machinery/chem_master,
/turf/open/floor/tile/whiteyellow{
	dir = 5
	},
/area/bigredv2/caves/lambda_lab)
"J" = (
/atom/movable/effect/landmark/weed_node,
/atom/movable/effect/ai_node,
/turf/open/floor/plating/ground/mars/random/cave,
/area/bigredv2/caves/northeast)
"M" = (
/atom/movable/effect/landmark/weed_node,
/turf/open/floor/plating/ground/mars/random/cave,
/area/bigredv2/caves/northeast)
"N" = (
/atom/movable/effect/landmark/xeno_resin_wall,
/turf/open/floor/plating/ground/mars/random/cave,
/area/bigredv2/caves/northeast)
"P" = (
/turf/open/space/basic,
/area/space)
"S" = (
/turf/closed/wall/r_wall,
/area/bigredv2/caves/lambda_lab)
"V" = (
/obj/structure/closet/crate/internals,
/turf/open/floor/plating,
/area/bigredv2/caves/lambda_lab)
"W" = (
/atom/movable/effect/landmark/weed_node,
/turf/open/floor/plating/ground/mars/random/cave/rock,
/area/bigredv2/caves/northeast)
"X" = (
/atom/movable/effect/landmark/lv624/fog_blocker,
/turf/open/floor/plating/ground/mars/random/cave,
/area/bigredv2/caves/northeast)

(1,1,1) = {"
P
P
P
P
P
P
P
P
P
P
P
P
P
P
F
F
F
F
F
F
s
s
s
s
s
i
i
i
i
g
s
s
"}
(2,1,1) = {"
P
P
P
P
P
P
P
P
P
P
P
P
P
P
P
P
P
P
P
F
s
s
s
g
g
M
i
i
i
g
s
s
"}
(3,1,1) = {"
P
P
P
P
P
P
P
P
P
P
P
P
P
P
P
P
P
P
P
F
s
s
s
i
i
i
i
i
i
g
s
s
"}
(4,1,1) = {"
P
P
P
P
P
P
P
P
P
P
P
P
P
P
P
P
P
P
P
F
s
s
s
i
i
i
i
i
i
i
g
s
"}
(5,1,1) = {"
P
P
P
P
P
P
P
P
P
P
P
P
P
P
P
P
P
P
P
F
s
s
s
i
c
i
i
M
i
c
g
s
"}
(6,1,1) = {"
P
P
P
P
P
P
P
P
P
P
P
P
P
P
P
P
P
P
P
F
s
s
s
W
i
i
i
i
i
i
g
s
"}
(7,1,1) = {"
P
P
P
P
P
P
P
P
P
P
P
P
P
P
P
P
P
P
P
F
s
s
s
s
s
g
i
i
i
i
g
s
"}
(8,1,1) = {"
P
P
P
P
P
P
P
P
P
P
P
P
P
P
P
P
P
P
P
F
s
s
s
s
s
s
i
i
i
i
M
g
"}
(9,1,1) = {"
P
P
P
P
P
P
P
P
P
P
P
P
P
P
P
P
P
P
P
F
s
s
s
s
s
s
W
i
i
i
i
i
"}
(10,1,1) = {"
P
P
P
P
P
P
P
P
P
P
P
P
P
P
P
P
P
P
P
F
s
s
s
s
s
s
s
g
i
c
i
i
"}
(11,1,1) = {"
P
P
P
P
P
P
P
P
P
P
P
P
P
P
P
P
P
P
P
F
s
s
s
s
s
s
s
s
s
i
c
i
"}
(12,1,1) = {"
P
P
P
P
P
P
P
P
P
P
P
P
P
P
P
P
P
P
P
F
s
s
s
s
s
s
s
s
s
g
i
c
"}
(13,1,1) = {"
P
P
P
P
P
P
P
P
P
P
P
P
P
P
P
P
P
P
P
F
s
s
s
s
s
s
s
s
s
s
s
s
"}
(14,1,1) = {"
P
P
P
P
P
P
P
P
P
P
P
P
P
P
P
P
P
P
P
F
s
s
s
s
s
s
s
s
s
s
s
s
"}
(15,1,1) = {"
P
P
P
P
P
P
P
P
P
P
P
P
P
P
P
P
P
P
P
F
s
s
s
s
s
s
s
x
x
x
x
x
"}
(16,1,1) = {"
P
P
P
P
P
P
P
P
P
P
P
P
P
P
P
P
P
P
P
F
s
s
s
s
s
s
s
x
N
N
N
N
"}
(17,1,1) = {"
P
P
P
P
P
P
P
P
P
P
P
P
P
P
P
P
P
P
P
F
s
s
s
s
s
s
s
x
N
i
i
i
"}
(18,1,1) = {"
P
P
P
P
P
P
P
P
P
P
P
P
P
P
P
P
P
P
P
F
s
s
s
s
s
s
s
x
N
i
i
c
"}
(19,1,1) = {"
P
P
P
P
P
P
P
P
P
P
P
P
P
P
P
P
P
P
P
F
s
s
s
s
s
s
s
N
N
i
i
i
"}
(20,1,1) = {"
P
P
P
P
P
P
P
P
P
P
P
P
P
P
P
P
P
P
P
F
s
s
s
s
s
s
s
i
i
i
i
i
"}
(21,1,1) = {"
P
P
P
P
P
P
P
P
P
P
P
P
P
P
P
P
P
P
P
F
s
s
s
s
s
s
s
i
i
M
i
i
"}
(22,1,1) = {"
P
P
P
P
P
P
P
P
P
P
P
P
P
P
P
P
P
P
P
F
s
s
s
s
s
s
i
i
i
i
i
i
"}
(23,1,1) = {"
P
P
P
P
P
P
P
P
P
P
P
P
P
P
P
P
P
P
P
F
s
s
s
s
s
i
c
i
i
i
i
c
"}
(24,1,1) = {"
P
P
P
P
P
P
P
P
P
P
P
P
P
P
P
P
P
P
P
F
s
s
s
s
s
i
i
i
i
i
M
i
"}
(25,1,1) = {"
P
P
P
P
P
P
P
P
P
P
P
P
P
P
P
P
P
P
P
F
s
s
s
s
i
i
i
i
i
i
i
i
"}
(26,1,1) = {"
P
P
P
P
P
P
P
P
P
P
P
P
P
P
P
P
P
P
P
F
s
s
s
s
M
i
i
i
t
i
i
s
"}
(27,1,1) = {"
P
P
P
P
P
P
P
P
P
P
P
P
P
P
P
P
P
P
P
F
s
s
s
i
i
i
i
i
i
s
s
s
"}
(28,1,1) = {"
P
P
P
P
P
P
P
P
P
P
P
P
P
P
P
P
P
P
P
F
s
s
c
i
i
i
J
i
s
s
s
k
"}
(29,1,1) = {"
P
P
P
P
P
P
P
P
P
P
P
P
P
P
P
P
P
P
P
F
s
s
s
i
i
i
i
s
s
s
k
s
"}
(30,1,1) = {"
P
P
P
P
P
P
P
P
P
P
P
P
P
P
P
P
P
P
P
F
s
s
s
i
i
i
i
s
s
k
s
s
"}
(31,1,1) = {"
P
P
P
P
P
P
P
P
P
P
P
P
P
P
P
P
P
P
P
F
s
s
s
i
i
i
i
s
s
k
s
S
"}
(32,1,1) = {"
P
P
P
P
P
P
P
P
P
P
P
P
P
P
P
P
P
P
P
F
s
s
i
i
i
i
i
s
s
k
s
S
"}
(33,1,1) = {"
P
P
P
P
P
P
P
P
P
P
P
P
P
P
P
P
P
P
P
F
s
s
i
i
c
i
J
s
s
k
s
S
"}
(34,1,1) = {"
P
P
P
P
P
P
P
P
P
P
P
P
P
P
P
P
P
P
P
F
s
s
s
i
i
i
i
s
s
k
s
S
"}
(35,1,1) = {"
P
P
P
P
P
P
P
P
P
P
P
P
P
P
P
P
P
P
P
F
s
s
i
i
i
i
s
s
s
k
s
S
"}
(36,1,1) = {"
P
P
P
P
P
P
P
P
P
P
P
P
P
P
P
P
P
P
P
F
s
s
i
i
i
M
s
s
s
k
s
s
"}
(37,1,1) = {"
P
P
P
P
P
P
P
P
P
P
P
P
P
P
P
P
P
P
P
F
s
s
i
i
i
i
s
s
s
k
s
s
"}
(38,1,1) = {"
P
P
P
P
P
P
P
P
P
P
P
P
P
P
P
P
P
P
P
F
s
s
i
i
i
i
s
s
s
k
s
s
"}
(39,1,1) = {"
P
P
P
P
P
P
P
P
P
P
P
P
P
P
P
P
P
P
P
F
s
s
s
i
i
i
i
s
s
k
S
S
"}
(40,1,1) = {"
P
P
P
P
P
P
P
P
P
P
P
P
P
P
P
P
P
P
P
F
s
s
s
i
i
i
M
i
s
k
S
m
"}
(41,1,1) = {"
P
P
P
P
P
P
P
P
P
P
P
P
P
P
P
P
P
P
P
F
s
s
s
i
i
i
M
i
s
k
S
V
"}
(42,1,1) = {"
P
P
P
P
P
P
P
P
P
P
P
P
P
P
P
P
P
P
P
F
s
s
s
i
i
i
i
i
s
k
S
q
"}
(43,1,1) = {"
P
P
P
P
P
P
P
P
P
P
P
P
P
P
P
P
P
P
P
F
s
s
i
i
J
i
c
i
s
k
S
S
"}
(44,1,1) = {"
P
P
P
P
P
P
P
P
P
P
P
P
P
P
P
P
P
P
P
F
s
s
i
i
i
i
i
i
i
k
S
j
"}
(45,1,1) = {"
P
P
P
P
P
P
P
P
P
P
P
P
P
P
P
P
P
P
P
F
s
s
i
i
i
i
i
i
i
X
S
f
"}
(46,1,1) = {"
P
P
P
P
P
P
P
P
P
P
P
P
P
P
P
P
P
P
P
F
s
s
i
i
i
i
i
i
i
X
S
f
"}
(47,1,1) = {"
P
P
P
P
P
P
P
P
P
P
P
P
P
P
P
P
P
P
P
F
s
s
s
i
i
i
i
i
s
k
S
I
"}
(48,1,1) = {"
P
P
P
P
P
P
P
P
P
P
P
P
P
P
P
P
P
P
P
F
s
s
s
s
i
i
i
s
s
k
S
S
"}
(49,1,1) = {"
P
P
P
P
P
P
P
P
P
P
P
P
P
P
P
P
P
P
P
F
s
s
s
s
i
i
i
s
s
s
k
S
"}
(50,1,1) = {"
P
P
P
P
P
P
P
P
P
P
P
P
P
P
P
P
P
P
P
F
s
s
s
s
i
i
i
i
s
s
s
k
"}
(51,1,1) = {"
P
P
P
P
P
P
P
P
P
P
P
P
P
P
P
P
P
P
P
F
s
s
s
s
s
i
i
H
i
i
i
g
"}
(52,1,1) = {"
P
P
P
P
P
P
P
P
P
P
P
P
P
P
P
P
P
P
P
F
s
s
s
s
s
i
c
i
i
i
c
i
"}
(53,1,1) = {"
P
P
P
P
P
P
P
P
P
P
P
P
P
P
P
P
P
P
P
F
s
s
s
s
s
s
i
i
M
i
i
i
"}
(54,1,1) = {"
P
P
P
P
P
P
P
P
P
P
P
P
P
P
P
P
P
P
P
F
s
s
s
s
s
s
i
i
i
i
i
i
"}
(55,1,1) = {"
P
P
P
P
P
P
P
P
P
P
P
P
P
P
P
P
P
P
P
F
s
s
s
s
s
s
s
i
h
i
i
i
"}
(56,1,1) = {"
P
P
P
P
P
P
P
P
P
P
P
P
P
P
P
P
P
P
P
F
s
s
s
s
s
s
s
i
i
i
M
i
"}
(57,1,1) = {"
P
P
P
P
P
P
P
P
P
P
P
P
P
P
P
P
P
P
P
F
s
s
s
s
s
s
s
i
i
i
i
i
"}
(58,1,1) = {"
P
P
P
P
P
P
P
P
P
P
P
P
P
P
P
P
P
P
P
F
s
s
s
s
s
s
s
i
i
i
c
i
"}
(59,1,1) = {"
P
P
P
P
P
P
P
P
P
P
P
P
P
P
P
P
P
P
P
F
s
s
s
s
s
s
s
i
i
i
i
i
"}
(60,1,1) = {"
P
P
P
P
P
P
P
P
P
P
P
P
P
P
P
P
P
P
P
F
s
s
s
s
s
s
s
s
i
i
c
i
"}
(61,1,1) = {"
P
P
P
P
P
P
P
P
P
P
P
P
P
P
P
P
P
P
P
F
s
s
s
s
s
s
s
s
s
i
M
i
"}
(62,1,1) = {"
P
P
P
P
P
P
P
P
P
P
P
P
P
P
P
P
P
P
P
F
s
s
s
s
s
s
s
s
s
i
i
i
"}
(63,1,1) = {"
P
P
P
P
P
P
P
P
P
P
P
P
P
P
P
P
P
P
P
F
s
s
s
s
s
s
s
s
s
i
i
i
"}
(64,1,1) = {"
P
P
P
P
P
P
P
P
P
P
P
P
P
P
P
P
P
P
P
F
s
s
s
s
s
s
s
s
s
i
i
i
"}
(65,1,1) = {"
P
P
P
P
P
P
P
P
P
P
P
P
P
P
P
P
P
P
P
F
s
s
s
s
s
s
s
s
s
i
M
i
"}
