//MAP CONVERTED BY dmm2tgm.py THIS HEADER COMMENT PREVENTS RECONVERSION, DO NOT REMOVE
"as" = (
/obj/structure/window/framed/colony,
/obj/machinery/door/poddoor/shutters/mainship{
	dir = 2;
	id = "Dormitories";
	name = "\improper Dormitories Shutters"
	},
/turf/open/floor/plating,
/area/bigredv2/outside/general_offices)
"aE" = (
/obj/structure/bed,
/turf/open/floor/wood,
/area/bigredv2/outside/general_offices)
"aW" = (
/obj/effect/landmark/weed_node,
/obj/structure/closet/secure_closet/personal/cabinet,
/obj/effect/spawner/random/hats,
/obj/machinery/light/small{
	dir = 4
	},
/turf/open/floor/wood,
/area/bigredv2/outside/general_offices)
"bp" = (
/obj/effect/landmark/weed_node,
/turf/open/floor/plating,
/area/bigredv2/outside/general_offices)
"bv" = (
/obj/machinery/atmospherics/pipe/simple/green/hidden{
	dir = 4
	},
/obj/effect/landmark/weed_node,
/obj/structure/cable,
/turf/open/floor,
/area/bigredv2/outside/general_offices)
"bw" = (
/obj/structure/table,
/obj/item/paper/hydroponics,
/turf/open/floor,
/area/bigredv2/outside/hydroponics)
"bQ" = (
/obj/effect/ai_node,
/turf/open/floor/plating/ground/mars/random/sand,
/area/bigredv2/caves/northeast)
"ck" = (
/obj/machinery/vending/snack,
/turf/open/floor,
/area/bigredv2/outside/general_offices)
"cA" = (
/obj/machinery/atmospherics/pipe/simple/green/hidden,
/obj/structure/cable,
/obj/effect/landmark/weed_node,
/turf/open/floor/tile/green/whitegreenfull,
/area/bigredv2/outside/hydroponics)
"dD" = (
/obj/effect/decal/cleanable/dirt,
/obj/machinery/atmospherics/pipe/simple/green/hidden{
	dir = 6
	},
/obj/effect/ai_node,
/obj/effect/landmark/weed_node,
/turf/open/floor,
/area/bigredv2/outside/general_offices)
"dN" = (
/obj/machinery/atmospherics/pipe/simple/green/hidden{
	dir = 4
	},
/obj/effect/decal/cleanable/blood/oil,
/obj/effect/landmark/weed_node,
/turf/open/floor,
/area/bigredv2/outside/general_offices)
"dR" = (
/obj/effect/decal/cleanable/blood/oil,
/obj/machinery/light{
	dir = 4;
	icon_state = "tube1";
	},
/turf/open/floor,
/area/bigredv2/outside/general_offices)
"dU" = (
/obj/machinery/washing_machine,
/turf/open/floor/freezer,
/area/bigredv2/outside/general_offices)
"eh" = (
/obj/structure/bed,
/obj/effect/decal/cleanable/dirt,
/obj/effect/spawner/random/outdoors_snacks,
/turf/open/floor/wood,
/area/bigredv2/outside/general_offices)
"ep" = (
/obj/structure/cable,
/obj/machinery/atmospherics/pipe/simple/green/hidden{
	dir = 4
	},
/obj/effect/ai_node,
/obj/effect/landmark/weed_node,
/turf/open/floor/asteroidfloor,
/area/bigredv2/outside/ne)
"eZ" = (
/obj/structure/barricade/wooden{
	dir = 8
	},
/turf/open/floor/marking/asteroidwarning,
/area/bigredv2/outside/ne)
"fe" = (
/obj/structure/cable,
/obj/machinery/atmospherics/pipe/simple/green/hidden,
/turf/open/floor/asteroidfloor,
/area/bigredv2/outside/ne)
"fo" = (
/obj/structure/cable,
/obj/machinery/atmospherics/pipe/simple/green/hidden{
	dir = 4
	},
/turf/open/floor/asteroidfloor,
/area/bigredv2/outside/ne)
"fs" = (
/obj/machinery/atmospherics/pipe/simple/green/hidden{
	dir = 4
	},
/obj/effect/decal/cleanable/dirt,
/turf/open/floor,
/area/bigredv2/outside/general_offices)
"fH" = (
/obj/effect/landmark/lv624/fog_blocker,
/obj/effect/landmark/weed_node,
/turf/open/floor/plating,
/area/bigredv2/caves/northeast)
"fK" = (
/obj/effect/landmark/weed_node,
/turf/open/floor,
/area/bigredv2/outside/general_offices)
"fW" = (
/turf/open/floor/plating/ground/mars/random/sand,
/area/bigredv2/caves/northeast)
"gi" = (
/obj/effect/landmark/weed_node,
/turf/open/floor/wood,
/area/bigredv2/outside/general_offices)
"hz" = (
/obj/machinery/atmospherics/pipe/manifold/green/hidden{
	dir = 1
	},
/obj/structure/cable,
/obj/effect/ai_node,
/obj/effect/landmark/weed_node,
/turf/open/floor,
/area/bigredv2/outside/general_offices)
"hS" = (
/obj/effect/decal/cleanable/dirt,
/obj/effect/landmark/weed_node,
/obj/effect/landmark/weed_node,
/turf/open/floor,
/area/bigredv2/outside/general_offices)
"in" = (
/obj/machinery/atmospherics/components/unary/vent_pump{
	dir = 8;
	on = 1
	},
/obj/effect/ai_node,
/turf/open/floor/freezer,
/area/bigredv2/outside/general_offices)
"iP" = (
/obj/structure/table,
/obj/item/paper,
/obj/item/paper,
/obj/item/tool/pen/invisible,
/turf/open/floor/wood,
/area/bigredv2/outside/general_offices)
"iV" = (
/obj/structure/table,
/turf/open/floor,
/area/bigredv2/outside/hydroponics)
"jj" = (
/obj/structure/rack,
/obj/effect/spawner/random/tool,
/obj/effect/spawner/random/tool,
/obj/effect/spawner/random/tool,
/turf/open/floor,
/area/bigredv2/outside/general_offices)
"jq" = (
/obj/structure/closet/toolcloset,
/turf/open/floor,
/area/bigredv2/outside/general_offices)
"jr" = (
/obj/machinery/atmospherics/pipe/simple/green/hidden,
/obj/effect/landmark/weed_node,
/turf/open/floor,
/area/bigredv2/outside/general_offices)
"jv" = (
/turf/open/floor/freezer,
/area/bigredv2/outside/general_offices)
"jZ" = (
/obj/machinery/atmospherics/pipe/simple/green/hidden{
	dir = 4
	},
/obj/structure/cable,
/turf/open/floor/plating,
/area/bigredv2/outside/bar)
"kn" = (
/obj/machinery/atmospherics/pipe/simple/green/hidden{
	dir = 4
	},
/obj/structure/barricade/wooden{
	dir = 8
	},
/turf/open/floor,
/area/bigredv2/outside/general_offices)
"ko" = (
/obj/item/clothing/under/darkred,
/turf/open/floor/freezer,
/area/bigredv2/outside/general_offices)
"kr" = (
/obj/effect/landmark/weed_node,
/turf/open/floor/plating/ground/mars/random/dirt,
/area/bigredv2/outside/ne)
"kz" = (
/obj/structure/cable,
/obj/machinery/atmospherics/pipe/simple/green/hidden{
	dir = 4
	},
/obj/structure/barricade/wooden{
	dir = 8
	},
/turf/open/floor/asteroidfloor,
/area/bigredv2/outside/ne)
"kA" = (
/obj/machinery/atmospherics/pipe/manifold4w/green/hidden,
/obj/effect/decal/cleanable/blood/oil,
/turf/open/floor,
/area/bigredv2/outside/general_offices)
"lb" = (
/turf/open/floor/asteroidfloor,
/area/bigredv2/outside/general_offices)
"lo" = (
/obj/machinery/washing_machine,
/obj/item/clothing/under/darkred,
/turf/open/floor/freezer,
/area/bigredv2/outside/general_offices)
"lq" = (
/obj/structure/table,
/obj/effect/landmark/weed_node,
/turf/open/floor/wood,
/area/bigredv2/outside/general_offices)
"lw" = (
/obj/machinery/atmospherics/pipe/simple/green/hidden{
	dir = 9
	},
/obj/structure/cable,
/obj/effect/ai_node,
/obj/effect/landmark/weed_node,
/turf/open/floor,
/area/bigredv2/outside/general_offices)
"lN" = (
/obj/structure/barricade/wooden{
	dir = 8
	},
/turf/open/floor,
/area/bigredv2/outside/general_offices)
"mm" = (
/obj/machinery/atmospherics/pipe/manifold/green/hidden{
	dir = 4
	},
/turf/open/floor,
/area/bigredv2/outside/general_offices)
"mq" = (
/obj/machinery/light{
	dir = 1
	},
/turf/open/floor/plating,
/area/bigredv2/outside/bar)
"ms" = (
/obj/machinery/atmospherics/pipe/simple/green/hidden{
	dir = 4
	},
/turf/open/floor,
/area/bigredv2/outside/general_offices)
"ne" = (
/obj/structure/bed/fancy,
/obj/effect/landmark/weed_node,
/turf/open/floor/wood,
/area/bigredv2/outside/general_offices)
"ni" = (
/obj/machinery/atmospherics/pipe/simple/green/hidden,
/turf/open/floor,
/area/bigredv2/outside/general_offices)
"nj" = (
/obj/machinery/atmospherics/pipe/simple/green/hidden{
	dir = 4
	},
/turf/open/floor/wood,
/area/bigredv2/outside/general_offices)
"nx" = (
/turf/open/floor/marking/asteroidwarning,
/area/bigredv2/outside/ne)
"nP" = (
/obj/structure/cable,
/turf/open/floor/plating,
/area/bigredv2/outside/general_offices)
"nZ" = (
/obj/effect/decal/cleanable/dirt,
/turf/open/floor,
/area/bigredv2/outside/general_offices)
"oQ" = (
/obj/machinery/atmospherics/components/unary/vent_pump{
	dir = 4;
	on = 1
	},
/obj/effect/spawner/random/clothing,
/obj/effect/decal/cleanable/dirt,
/turf/open/floor/wood,
/area/bigredv2/outside/general_offices)
"ph" = (
/turf/closed/wall/r_wall,
/area/bigredv2/outside/general_offices)
"pj" = (
/obj/effect/decal/cleanable/dirt,
/turf/open/floor/asteroidfloor,
/area/bigredv2/outside/general_offices)
"ps" = (
/obj/machinery/atmospherics/pipe/manifold4w/green/hidden,
/turf/open/floor,
/area/bigredv2/outside/general_offices)
"pz" = (
/obj/structure/table,
/obj/effect/spawner/random/toolbox,
/obj/machinery/atmospherics/components/unary/vent_pump,
/turf/open/floor,
/area/bigredv2/outside/general_offices)
"pL" = (
/obj/effect/spawner/random/clothing,
/obj/effect/decal/cleanable/dirt,
/obj/structure/bed/chair/wood{
	dir = 4
	},
/turf/open/floor/wood,
/area/bigredv2/outside/general_offices)
"pP" = (
/obj/machinery/light{
	dir = 1
	},
/turf/open/floor,
/area/bigredv2/outside/general_offices)
"pU" = (
/obj/machinery/vending/hydronutrients,
/turf/open/floor,
/area/bigredv2/outside/hydroponics)
"qk" = (
/obj/machinery/light{
	dir = 8
	},
/obj/structure/cable,
/obj/machinery/atmospherics/pipe/simple/green/hidden,
/turf/open/floor/asteroidfloor,
/area/bigredv2/outside/general_offices)
"qr" = (
/obj/item/clothing/under/brown,
/turf/open/floor/freezer,
/area/bigredv2/outside/general_offices)
"qt" = (
/turf/open/floor/marking/asteroidwarning{
	dir = 4
	},
/area/bigredv2/outside/ne)
"qB" = (
/obj/machinery/vending/hydroseeds,
/turf/open/floor,
/area/bigredv2/outside/hydroponics)
"qC" = (
/obj/effect/landmark/lv624/fog_blocker,
/turf/closed/mineral/smooth/bigred,
/area/bigredv2/caves/rock)
"rh" = (
/obj/machinery/light,
/obj/effect/decal/cleanable/dirt,
/obj/structure/cable,
/turf/open/floor,
/area/bigredv2/outside/general_offices)
"rw" = (
/obj/machinery/atmospherics/pipe/manifold/green/hidden{
	dir = 4
	},
/obj/structure/cable,
/obj/effect/ai_node,
/obj/effect/landmark/weed_node,
/turf/open/floor/asteroidfloor,
/area/bigredv2/outside/ne)
"rD" = (
/turf/closed/wall,
/area/bigredv2/outside/hydroponics)
"rT" = (
/turf/open/floor/plating/ground/mars/random/sand,
/area/bigredv2/outside/ne)
"sB" = (
/turf/closed/wall,
/area/bigredv2/outside/bar)
"sL" = (
/obj/structure/rack,
/obj/effect/spawner/random/toolbox,
/obj/effect/landmark/weed_node,
/turf/open/floor,
/area/bigredv2/outside/general_offices)
"te" = (
/turf/open/floor,
/area/bigredv2/outside/general_offices)
"tf" = (
/obj/effect/decal/cleanable/dirt,
/turf/open/floor/wood,
/area/bigredv2/outside/general_offices)
"to" = (
/obj/effect/landmark/weed_node,
/turf/open/floor/freezer,
/area/bigredv2/outside/general_offices)
"tp" = (
/obj/machinery/atmospherics/pipe/simple/green/hidden{
	dir = 4
	},
/obj/structure/cable,
/turf/open/floor,
/area/bigredv2/outside/general_offices)
"tu" = (
/obj/effect/decal/cleanable/dirt,
/obj/machinery/atmospherics/pipe/simple/green/hidden,
/obj/structure/cable,
/turf/open/floor,
/area/bigredv2/outside/general_offices)
"tw" = (
/obj/effect/landmark/lv624/fog_blocker,
/turf/open/floor/plating/ground/mars/random/sand,
/area/bigredv2/caves/northeast)
"tY" = (
/obj/machinery/light{
	dir = 8
	},
/obj/effect/landmark/weed_node,
/turf/open/floor/plating,
/area/bigredv2/outside/general_offices)
"tZ" = (
/obj/machinery/atmospherics/pipe/simple/green/hidden{
	dir = 9
	},
/turf/open/floor,
/area/bigredv2/outside/general_offices)
"ue" = (
/obj/structure/table,
/obj/effect/spawner/random/clothing,
/turf/open/floor/wood,
/area/bigredv2/outside/general_offices)
"ut" = (
/obj/effect/landmark/corpsespawner/colonist,
/obj/effect/decal/cleanable/blood/oil,
/turf/open/floor,
/area/bigredv2/outside/general_offices)
"uL" = (
/turf/open/floor/wood,
/area/bigredv2/outside/general_offices)
"va" = (
/obj/structure/bed/chair{
	dir = 8
	},
/turf/open/floor,
/area/bigredv2/outside/general_offices)
"vX" = (
/obj/effect/ai_node,
/turf/open/floor/marking/asteroidwarning{
	dir = 6
	},
/area/bigredv2/outside/ne)
"wi" = (
/obj/machinery/light{
	dir = 8
	},
/turf/open/floor,
/area/bigredv2/outside/general_offices)
"wB" = (
/turf/open/floor/plating/ground/mars/random/sand,
/area/bigredv2/outside/n)
"xj" = (
/obj/machinery/door/airlock/multi_tile/mainship/generic{
	name = "\improper Dormitories Tool Storage"
	},
/turf/open/floor,
/area/bigredv2/outside/general_offices)
"xq" = (
/obj/machinery/light{
	dir = 8
	},
/obj/effect/landmark/weed_node,
/turf/open/floor,
/area/bigredv2/outside/general_offices)
"xI" = (
/obj/machinery/light{
	dir = 8
	},
/turf/open/floor/wood,
/area/bigredv2/outside/general_offices)
"ye" = (
/obj/machinery/atmospherics/pipe/simple/green/hidden{
	dir = 4
	},
/obj/item/paper/crumpled/bloody,
/turf/open/floor/wood,
/area/bigredv2/outside/general_offices)
"yg" = (
/obj/machinery/atmospherics/pipe/simple/green/hidden{
	dir = 4
	},
/obj/effect/landmark/corpsespawner/security,
/obj/structure/barricade/wooden{
	dir = 8
	},
/turf/open/floor,
/area/bigredv2/outside/general_offices)
"zx" = (
/obj/machinery/light{
	dir = 8
	},
/obj/effect/landmark/weed_node,
/turf/open/floor/wood,
/area/bigredv2/outside/general_offices)
"zD" = (
/obj/effect/decal/cleanable/dirt,
/obj/structure/barricade/wooden{
	dir = 8
	},
/turf/open/floor,
/area/bigredv2/outside/general_offices)
"zY" = (
/obj/machinery/vending/tool,
/turf/open/floor,
/area/bigredv2/outside/general_offices)
"AS" = (
/obj/structure/cable,
/obj/machinery/atmospherics/pipe/simple/green/hidden{
	dir = 4
	},
/obj/machinery/door/airlock/mainship/maint/free_access{
	name = "\improper Bar Maintenance"
	},
/turf/open/floor/plating,
/area/bigredv2/outside/bar)
"Bk" = (
/obj/structure/window/framed/colony,
/obj/machinery/door/poddoor/shutters/mainship{
	dir = 2;
	id = "Greenhouse";
	name = "\improper Greenhouse Shutters"
	},
/turf/open/floor/plating,
/area/bigredv2/outside/hydroponics)
"Cm" = (
/obj/structure/bed/fancy,
/obj/effect/spawner/random/clothing,
/obj/effect/spawner/random/hats,
/turf/open/floor/wood,
/area/bigredv2/outside/general_offices)
"CD" = (
/obj/machinery/door/airlock/mainship/medical/glass/free_access{
	name = "\improper Dormitories Lavatory"
	},
/obj/machinery/atmospherics/pipe/simple/green/hidden{
	dir = 4
	},
/turf/open/floor/freezer,
/area/bigredv2/outside/general_offices)
"CJ" = (
/obj/machinery/vending/engivend,
/turf/open/floor,
/area/bigredv2/outside/general_offices)
"CS" = (
/obj/machinery/atmospherics/components/unary/vent_pump{
	dir = 8;
	on = 1
	},
/obj/effect/spawner/random/clothing,
/turf/open/floor/wood,
/area/bigredv2/outside/general_offices)
"Db" = (
/obj/structure/cable,
/obj/machinery/atmospherics/pipe/simple/green/hidden,
/turf/open/floor/asteroidfloor,
/area/bigredv2/outside/general_offices)
"Dw" = (
/turf/open/floor/plating/ground/mars/random/sand,
/area/bigredv2/outside/general_offices)
"DX" = (
/obj/machinery/door/airlock/mainship/maint/free_access{
	dir = 1;
	name = "\improper Dormitories Tool Storage Maintenance"
	},
/obj/structure/cable,
/turf/open/floor/plating,
/area/bigredv2/outside/general_offices)
"Eg" = (
/obj/effect/decal/cleanable/dirt,
/obj/effect/landmark/weed_node,
/turf/open/floor,
/area/bigredv2/outside/general_offices)
"Ev" = (
/obj/structure/table,
/turf/open/floor/wood,
/area/bigredv2/outside/general_offices)
"Ex" = (
/turf/open/floor/plating,
/area/bigredv2/outside/bar)
"Ey" = (
/turf/open/floor/plating/ground/mars/random/dirt,
/area/bigredv2/outside/ne)
"Ez" = (
/obj/structure/rack,
/obj/effect/spawner/random/tool,
/turf/open/floor,
/area/bigredv2/outside/general_offices)
"EB" = (
/obj/machinery/atmospherics/pipe/simple/green/hidden{
	dir = 4
	},
/obj/structure/cable,
/obj/effect/landmark/weed_node,
/turf/open/floor/plating,
/area/bigredv2/outside/bar)
"EF" = (
/obj/structure/cable,
/turf/open/floor,
/area/bigredv2/outside/general_offices)
"EH" = (
/obj/machinery/atmospherics/pipe/simple/green/hidden{
	dir = 4
	},
/turf/open/floor/freezer,
/area/bigredv2/outside/general_offices)
"EU" = (
/turf/open/floor/plating/ground/mars/dirttosand{
	dir = 8
	},
/area/bigredv2/caves/northeast)
"Fl" = (
/obj/machinery/atmospherics/pipe/simple/green/hidden{
	dir = 4
	},
/obj/effect/landmark/weed_node,
/turf/open/floor/wood,
/area/bigredv2/outside/general_offices)
"Fz" = (
/obj/machinery/atmospherics/pipe/simple/green/hidden,
/obj/effect/decal/cleanable/dirt,
/obj/effect/landmark/weed_node,
/turf/open/floor,
/area/bigredv2/outside/general_offices)
"FQ" = (
/obj/effect/decal/cleanable/dirt,
/turf/open/floor/marking/asteroidwarning{
	dir = 1
	},
/area/bigredv2/outside/general_offices)
"FT" = (
/obj/structure/rack,
/obj/effect/spawner/random/tool,
/obj/effect/spawner/random/tool,
/turf/open/floor,
/area/bigredv2/outside/general_offices)
"Gd" = (
/obj/machinery/atmospherics/pipe/simple/green/hidden{
	dir = 4
	},
/obj/effect/landmark/weed_node,
/turf/open/floor,
/area/bigredv2/outside/general_offices)
"Go" = (
/turf/open/floor/plating/ground/mars/dirttosand{
	dir = 10
	},
/area/bigredv2/outside/ne)
"GG" = (
/obj/machinery/atmospherics/pipe/manifold/green/hidden{
	dir = 1
	},
/turf/open/floor,
/area/bigredv2/outside/general_offices)
"GV" = (
/obj/structure/closet/secure_closet/personal/cabinet,
/obj/machinery/light/small{
	dir = 4
	},
/turf/open/floor/wood,
/area/bigredv2/outside/general_offices)
"GW" = (
/obj/effect/landmark/weed_node,
/turf/open/floor/plating/ground/mars/random/sand,
/area/bigredv2/outside/ne)
"Hh" = (
/obj/machinery/vending/cola,
/turf/open/floor,
/area/bigredv2/outside/general_offices)
"Hm" = (
/obj/structure/window/framed/colony,
/turf/open/floor/plating,
/area/bigredv2/outside/hydroponics)
"Hq" = (
/obj/machinery/atmospherics/pipe/simple/green/hidden,
/obj/effect/decal/cleanable/dirt,
/turf/open/floor,
/area/bigredv2/outside/general_offices)
"Hw" = (
/obj/machinery/door/airlock/mainship/generic{
	dir = 1;
	name = "\improper Dormitories Bedroom"
	},
/turf/open/floor/wood,
/area/bigredv2/outside/general_offices)
"HD" = (
/obj/structure/closet/secure_closet/personal/cabinet,
/obj/effect/spawner/random/clothing,
/obj/machinery/light/small{
	dir = 4
	},
/turf/open/floor/wood,
/area/bigredv2/outside/general_offices)
"HO" = (
/obj/structure/table,
/obj/effect/spawner/random/toolbox,
/obj/item/stack/cable_coil,
/turf/open/floor,
/area/bigredv2/outside/general_offices)
"HV" = (
/obj/structure/cable,
/obj/machinery/atmospherics/pipe/simple/green/hidden,
/obj/machinery/door/airlock/multi_tile/mainship/generic{
	name = "\improper Dormitories"
	},
/turf/open/floor,
/area/bigredv2/outside/general_offices)
"HX" = (
/obj/machinery/washing_machine,
/obj/machinery/light,
/turf/open/floor/freezer,
/area/bigredv2/outside/general_offices)
"Iw" = (
/obj/effect/decal/cleanable/dirt,
/obj/machinery/atmospherics/pipe/simple/green/hidden{
	dir = 9
	},
/turf/open/floor,
/area/bigredv2/outside/general_offices)
"Iy" = (
/obj/structure/barricade/wooden{
	dir = 8
	},
/obj/machinery/atmospherics/pipe/simple/green/hidden{
	dir = 4
	},
/obj/structure/cable,
/turf/open/floor,
/area/bigredv2/outside/general_offices)
"Iz" = (
/obj/effect/ai_node,
/turf/open/floor/plating/ground/mars/random/dirt,
/area/bigredv2/caves/northeast)
"IE" = (
/obj/effect/decal/cleanable/dirt,
/obj/effect/decal/cleanable/dirt,
/turf/open/floor/asteroidfloor,
/area/bigredv2/outside/general_offices)
"Jo" = (
/obj/structure/cable,
/obj/effect/ai_node,
/turf/open/floor/plating,
/area/bigredv2/outside/general_offices)
"Jy" = (
/obj/effect/ai_node,
/turf/open/floor/plating/ground/mars/random/sand,
/area/bigredv2/outside/ne)
"Ki" = (
/obj/structure/bed/chair{
	dir = 1
	},
/obj/effect/landmark/weed_node,
/turf/open/floor,
/area/bigredv2/outside/general_offices)
"Kk" = (
/obj/structure/table,
/obj/effect/spawner/random/drink_alcohol_bottle,
/turf/open/floor/wood,
/area/bigredv2/outside/general_offices)
"Ky" = (
/obj/structure/table,
/obj/effect/decal/cleanable/dirt,
/turf/open/floor/wood,
/area/bigredv2/outside/general_offices)
"Kz" = (
/obj/machinery/portable_atmospherics/hydroponics,
/turf/open/floor/tile/green/whitegreenfull,
/area/bigredv2/outside/hydroponics)
"KC" = (
/obj/effect/landmark/weed_node,
/turf/open/floor/plating/ground/mars/random/sand,
/area/bigredv2/outside/n)
"Lp" = (
/turf/closed/wall,
/area/bigredv2/outside/general_offices)
"Lt" = (
/obj/effect/decal/cleanable/dirt,
/obj/structure/cable,
/turf/open/floor,
/area/bigredv2/outside/general_offices)
"Lu" = (
/obj/structure/bed/fancy,
/turf/open/floor/wood,
/area/bigredv2/outside/general_offices)
"Lv" = (
/turf/closed/mineral/smooth/bigred,
/area/bigredv2/caves/rock)
"LV" = (
/obj/docking_port/stationary/crashmode,
/turf/open/floor,
/area/bigredv2/outside/general_offices)
"Mj" = (
/turf/open/floor,
/area/bigredv2/outside/hydroponics)
"Mq" = (
/obj/structure/bed,
/obj/effect/spawner/random/clothing,
/obj/effect/landmark/corpsespawner/colonist,
/turf/open/floor/wood,
/area/bigredv2/outside/general_offices)
"ME" = (
/obj/machinery/atmospherics/pipe/simple/green/hidden,
/obj/structure/cable,
/obj/machinery/door/airlock/mainship/medical/glass/free_access{
	dir = 1;
	name = "\improper Greenhouse"
	},
/turf/open/floor,
/area/bigredv2/outside/hydroponics)
"NA" = (
/obj/effect/landmark/corpsespawner/security,
/obj/effect/decal/cleanable/blood/oil,
/turf/open/floor,
/area/bigredv2/outside/general_offices)
"NC" = (
/obj/machinery/atmospherics/pipe/manifold/green/hidden,
/obj/effect/ai_node,
/obj/structure/cable,
/turf/open/floor,
/area/bigredv2/outside/general_offices)
"Oj" = (
/obj/machinery/door/airlock/mainship/generic{
	locked = 1;
	name = "\improper Dormitories Bedroom"
	},
/obj/machinery/atmospherics/pipe/simple/green/hidden{
	dir = 4
	},
/turf/open/floor,
/area/bigredv2/outside/general_offices)
"OD" = (
/turf/open/floor/plating,
/area/bigredv2/caves/northeast)
"OQ" = (
/obj/machinery/atmospherics/components/unary/vent_pump{
	dir = 4;
	on = 1
	},
/obj/effect/landmark/weed_node,
/obj/effect/decal/cleanable/dirt,
/turf/open/floor/wood,
/area/bigredv2/outside/general_offices)
"OX" = (
/obj/structure/table,
/obj/structure/bedsheetbin,
/obj/effect/landmark/weed_node,
/turf/open/floor/freezer,
/area/bigredv2/outside/general_offices)
"Ps" = (
/turf/open/floor/marking/asteroidwarning{
	dir = 9
	},
/area/bigredv2/outside/general_offices)
"Pw" = (
/obj/machinery/atmospherics/components/unary/vent_pump{
	dir = 4;
	on = 1
	},
/turf/open/floor/wood,
/area/bigredv2/outside/general_offices)
"PA" = (
/obj/machinery/light,
/turf/open/floor,
/area/bigredv2/outside/general_offices)
"PC" = (
/obj/structure/cable,
/obj/machinery/atmospherics/pipe/simple/green/hidden,
/obj/effect/landmark/weed_node,
/turf/open/floor/asteroidfloor,
/area/bigredv2/outside/general_offices)
"PX" = (
/obj/effect/landmark/excavation_site_spawner,
/turf/open/floor,
/area/bigredv2/outside/general_offices)
"Qs" = (
/obj/structure/table,
/turf/open/floor,
/area/bigredv2/outside/general_offices)
"QL" = (
/obj/machinery/door/airlock/mainship/generic{
	name = "\improper Dormitories Bedroom"
	},
/obj/machinery/atmospherics/pipe/simple/green/hidden{
	dir = 4
	},
/turf/open/floor,
/area/bigredv2/outside/general_offices)
"QQ" = (
/obj/machinery/atmospherics/pipe/simple/green/hidden{
	dir = 6
	},
/turf/open/floor,
/area/bigredv2/outside/general_offices)
"Rs" = (
/obj/machinery/atmospherics/pipe/simple/green/hidden{
	dir = 4
	},
/obj/effect/landmark/weed_node,
/turf/open/floor/freezer,
/area/bigredv2/outside/general_offices)
"Rx" = (
/obj/machinery/light{
	dir = 1
	},
/obj/effect/decal/cleanable/dirt,
/turf/open/floor,
/area/bigredv2/outside/general_offices)
"RW" = (
/obj/effect/spawner/random/trash,
/obj/machinery/light{
	dir = 8
	},
/turf/open/floor,
/area/bigredv2/outside/general_offices)
"St" = (
/obj/machinery/power/apc{
	dir = 4
	},
/obj/structure/cable,
/turf/open/floor/plating,
/area/bigredv2/outside/general_offices)
"SP" = (
/obj/item/clothing/under/lightbrown,
/turf/open/floor/freezer,
/area/bigredv2/outside/general_offices)
"SU" = (
/obj/structure/table,
/obj/item/tool/shovel/spade,
/turf/open/floor,
/area/bigredv2/outside/hydroponics)
"SV" = (
/turf/open/floor/marking/asteroidwarning{
	dir = 1
	},
/area/bigredv2/outside/general_offices)
"TI" = (
/turf/open/floor/plating/ground/mars/random/dirt,
/area/bigredv2/caves/northeast)
"Ub" = (
/obj/structure/window/framed/colony,
/obj/machinery/door/poddoor/shutters/mainship{
	id = "Greenhouse";
	name = "\improper Greenhouse Shutters"
	},
/turf/open/floor/plating,
/area/bigredv2/outside/hydroponics)
"Uf" = (
/obj/machinery/washing_machine,
/obj/item/clothing/under/brown,
/turf/open/floor/freezer,
/area/bigredv2/outside/general_offices)
"Ug" = (
/obj/machinery/washing_machine,
/obj/item/clothing/under/lightbrown,
/turf/open/floor/freezer,
/area/bigredv2/outside/general_offices)
"Ux" = (
/obj/structure/table,
/obj/effect/decal/cleanable/dirt,
/obj/effect/spawner/random/kitchen,
/turf/open/floor/wood,
/area/bigredv2/outside/general_offices)
"Uy" = (
/obj/machinery/vending/cigarette/colony,
/turf/open/floor,
/area/bigredv2/outside/general_offices)
"UD" = (
/obj/machinery/atmospherics/pipe/manifold/green/hidden,
/obj/effect/landmark/weed_node,
/turf/open/floor,
/area/bigredv2/outside/general_offices)
"Vo" = (
/obj/machinery/atmospherics/components/unary/vent_pump{
	dir = 8;
	on = 1
	},
/turf/open/floor/wood,
/area/bigredv2/outside/general_offices)
"VW" = (
/obj/machinery/light{
	dir = 4;
	icon_state = "tube1";
	},
/turf/open/floor,
/area/bigredv2/outside/general_offices)
"Wf" = (
/obj/effect/decal/cleanable/dirt,
/obj/effect/landmark/excavation_site_spawner,
/turf/open/floor,
/area/bigredv2/outside/general_offices)
"Wn" = (
/obj/structure/table,
/obj/item/flashlight/lamp/green,
/turf/open/floor/wood,
/area/bigredv2/outside/general_offices)
"WK" = (
/obj/structure/cable,
/obj/machinery/atmospherics/pipe/simple/green/hidden{
	dir = 4
	},
/obj/effect/decal/cleanable/dirt,
/obj/effect/landmark/weed_node,
/turf/open/floor/asteroidfloor,
/area/bigredv2/outside/ne)
"WV" = (
/obj/structure/barricade/wooden,
/obj/machinery/atmospherics/pipe/simple/green/hidden,
/obj/structure/cable,
/turf/open/floor,
/area/bigredv2/outside/general_offices)
"Xg" = (
/obj/effect/decal/cleanable/dirt,
/obj/machinery/atmospherics/pipe/simple/green/hidden,
/turf/open/floor,
/area/bigredv2/outside/general_offices)
"Xy" = (
/turf/open/floor/plating,
/area/bigredv2/outside/general_offices)
"Xz" = (
/turf/open/floor/plating/ground/mars/dirttosand,
/area/bigredv2/outside/ne)
"XZ" = (
/obj/structure/sign/safety/EVA{
	dir = 1
	},
/turf/open/floor,
/area/bigredv2/outside/general_offices)
"Yq" = (
/obj/structure/cable,
/obj/machinery/atmospherics/pipe/simple/green/hidden{
	dir = 4
	},
/obj/effect/decal/cleanable/dirt,
/turf/open/floor/asteroidfloor,
/area/bigredv2/outside/ne)
"Yv" = (
/obj/machinery/portable_atmospherics/hydroponics,
/obj/effect/landmark/weed_node,
/turf/open/floor/tile/green/whitegreenfull,
/area/bigredv2/outside/hydroponics)
"YF" = (
/obj/structure/barricade/wooden,
/obj/effect/ai_node,
/turf/open/floor,
/area/bigredv2/outside/general_offices)
"YL" = (
/obj/structure/closet/secure_closet/personal/cabinet,
/obj/machinery/light/small{
	dir = 8
	},
/turf/open/floor/wood,
/area/bigredv2/outside/general_offices)
"YO" = (
/obj/machinery/atmospherics/pipe/simple/green/hidden,
/obj/structure/cable,
/turf/open/floor,
/area/bigredv2/outside/general_offices)
"Zf" = (
/obj/effect/ai_node,
/obj/effect/landmark/weed_node,
/obj/structure/cable,
/turf/open/floor,
/area/bigredv2/outside/general_offices)
"Zk" = (
/obj/structure/table,
/obj/structure/bedsheetbin,
/turf/open/floor/freezer,
/area/bigredv2/outside/general_offices)
"Zy" = (
/obj/machinery/washing_machine,
/obj/item/clothing/under/lightred,
/turf/open/floor/freezer,
/area/bigredv2/outside/general_offices)
"ZS" = (
/obj/structure/table,
/obj/effect/spawner/random/technology_scanner,
/obj/effect/spawner/random/technology_scanner,
/turf/open/floor,
/area/bigredv2/outside/general_offices)

(1,1,1) = {"
wB
wB
as
fK
te
QQ
jr
mm
ni
ni
jr
ni
ni
ni
UD
te
te
Ki
sB
mq
jZ
Ex
Ex
sB
"}
(2,1,1) = {"
wB
wB
Lp
Lp
Lp
CD
Lp
Lp
Lp
Lp
Lp
Lp
Lp
pP
ms
te
va
Qs
sB
Ex
EB
Ex
Ex
sB
"}
(3,1,1) = {"
wB
wB
Lp
lo
to
EH
jv
Ug
Lp
jj
FT
FT
Lp
lN
kn
lN
Lp
Lp
sB
sB
AS
sB
sB
sB
"}
(4,1,1) = {"
wB
wB
Lp
dU
jv
Rs
jv
dU
Lp
pP
hS
te
Lp
nZ
yg
te
Hw
uL
zx
Lp
Yq
nx
kr
sB
"}
(5,1,1) = {"
wB
wB
Lp
dU
jv
EH
to
Uf
Lp
te
Eg
te
Lp
zD
Gd
te
Lp
Ev
aE
Lp
Yq
nx
Ey
sB
"}
(6,1,1) = {"
wB
KC
Lp
dU
ko
in
jv
HX
Lp
CJ
nZ
te
Lp
nZ
ms
PA
Lp
Lp
Lp
Lp
WK
nx
Ey
sB
"}
(7,1,1) = {"
Lv
Lv
Lp
dU
jv
Zk
qr
dU
Lp
zY
te
te
xj
LV
ms
te
Hw
uL
xI
Lp
Yq
nx
Ey
sB
"}
(8,1,1) = {"
qC
Lv
Lp
Uf
SP
OX
jv
dU
Lp
HO
dD
tu
YO
YO
NC
te
Lp
lq
aE
Lp
fo
nx
Xz
rT
"}
(9,1,1) = {"
Lv
qC
Lp
dU
to
jv
to
Zy
Lp
pz
Iw
Lt
Lp
PX
bv
te
Lp
Lp
Lp
Lp
ep
nx
kr
Go
"}
(10,1,1) = {"
Lv
qC
Lp
Lp
Lp
Lp
Lp
Lp
Lp
jq
nZ
rh
Lp
Wf
tp
te
Hw
gi
xI
Lp
Yq
nx
Ey
Xz
"}
(11,1,1) = {"
fW
fH
Dw
Xy
St
tY
Xy
bp
Lp
jq
nZ
Lt
Lp
nZ
tp
te
Lp
Ev
aE
Lp
Yq
nx
rD
Ub
"}
(12,1,1) = {"
bQ
tw
Xy
Xy
Jo
nP
nP
nP
DX
EF
Zf
EF
Lp
zD
Iy
PA
Lp
Lp
Lp
Lp
kz
eZ
Bk
Kz
"}
(13,1,1) = {"
OD
tw
Ps
Lp
Lp
Lp
Lp
Lp
Lp
Lp
Lp
Lp
Lp
Rx
hz
WV
HV
PC
qk
Db
rw
fe
ME
cA
"}
(14,1,1) = {"
fW
tw
FQ
Lp
YL
Cm
Lp
YL
ne
Lp
YL
Lu
Lp
lN
tp
YF
te
lb
lb
pj
qt
vX
Bk
Kz
"}
(15,1,1) = {"
fW
tw
FQ
Lp
uL
OQ
Lp
pL
Pw
Lp
uL
oQ
Lp
XZ
Iy
te
Lp
Lp
Lp
Lp
rT
rT
Bk
Kz
"}
(16,1,1) = {"
fW
tw
SV
Lp
ue
nj
Lp
Wn
nj
Lp
Ux
Fl
Lp
te
tp
te
Hw
uL
zx
Lp
rT
rT
Bk
Kz
"}
(17,1,1) = {"
EU
qC
pj
Lp
Lp
QL
Lp
Lp
QL
Lp
Lp
QL
Lp
te
lw
te
Lp
Ev
aE
Lp
GW
rT
Bk
Kz
"}
(18,1,1) = {"
TI
qC
pj
Lp
Ez
ms
RW
nZ
ms
xq
nZ
dN
wi
nZ
ms
ut
Lp
Lp
Lp
Lp
rT
rT
Bk
Kz
"}
(19,1,1) = {"
TI
qC
pj
Lp
sL
GG
Hq
Fz
kA
Hq
ni
ps
Hq
Xg
tZ
te
Hw
uL
xI
Lp
rT
rT
Bk
Yv
"}
(20,1,1) = {"
Iz
qC
lb
Lp
ZS
fs
dR
nZ
ms
VW
Eg
ms
VW
lN
lN
PA
Lp
lq
aE
Lp
rT
rT
rD
Hm
"}
(21,1,1) = {"
TI
qC
lb
ph
Lp
QL
Lp
Lp
Oj
Lp
Lp
QL
ph
nZ
fK
lN
Lp
Lp
Lp
Lp
GW
Jy
rD
pU
"}
(22,1,1) = {"
Lv
qC
lb
ph
iP
Fl
Lp
Ky
ye
Lp
Kk
nj
ph
nZ
te
te
Lp
Lv
rT
rT
rT
rT
rD
qB
"}
(23,1,1) = {"
Lv
qC
pj
ph
tf
Vo
Lp
gi
Vo
Lp
uL
CS
ph
nZ
NA
fK
Lp
Lv
rT
rT
rT
rT
rD
iV
"}
(24,1,1) = {"
Lv
qC
lb
ph
HD
aE
Lp
GV
Mq
Lp
aW
eh
ph
Eg
te
te
Lp
Lv
Lv
rT
rT
rT
rD
SU
"}
(25,1,1) = {"
Lv
qC
pj
ph
ph
ph
ph
ph
ph
ph
ph
ph
ph
pP
te
fK
Lp
Lv
Lv
rT
GW
rT
rD
bw
"}
(26,1,1) = {"
Lv
qC
lb
pj
lb
pj
lb
lb
pj
IE
pj
lb
ph
Hh
Uy
ck
Lp
Lv
Lv
rT
rT
rT
rD
Mj
"}
