//MAP CONVERTED BY dmm2tgm.py THIS HEADER COMMENT PREVENTS RECONVERSION, DO NOT REMOVE
"a" = (
/turf/closed/mineral/smooth/bigred,
/area/bigredv2/caves/rock)
"b" = (
/obj/machinery/chem_dispenser,
/turf/open/floor/tile/whiteyellow{
	dir = 9
	},
/area/bigredv2/caves/lambda_lab)
"c" = (
/obj/machinery/miner/damaged/platinum,
/turf/open/floor/plating/ground/mars/random/cave,
/area/bigredv2/caves/northeast)
"d" = (
/obj/effect/landmark/lv624/fog_blocker,
/turf/open/floor/plating/ground/mars/random/cave,
/area/bigredv2/caves/northeast)
"h" = (
/turf/closed/wall/r_wall,
/area/bigredv2/caves/lambda_lab)
"i" = (
/obj/machinery/chem_master,
/turf/open/floor/tile/whiteyellow{
	dir = 5
	},
/area/bigredv2/caves/lambda_lab)
"p" = (
/obj/structure/closet/crate/freezer/rations,
/turf/open/floor/plating,
/area/bigredv2/caves/lambda_lab)
"t" = (
/obj/effect/landmark/weed_node,
/turf/open/floor/plating/ground/mars/random/cave/rock,
/area/bigredv2/caves/northeast)
"u" = (
/turf/closed/wall/r_wall,
/area/bigredv2/caves/rock)
"y" = (
/obj/effect/ai_node,
/obj/effect/landmark/excavation_site_spawner,
/turf/open/floor/plating/ground/mars/random/cave,
/area/bigredv2/caves/northeast)
"z" = (
/obj/effect/landmark/lv624/fog_blocker,
/turf/closed/mineral/smooth/bigred,
/area/bigredv2/caves/rock)
"C" = (
/turf/closed/mineral/smooth/bigred/indestructible,
/area/space)
"E" = (
/turf/open/floor/plating/ground/mars/random/cave/rock,
/area/bigredv2/caves/northeast)
"K" = (
/obj/effect/ai_node,
/turf/open/floor/plating/ground/mars/random/cave,
/area/bigredv2/caves/northeast)
"M" = (
/obj/machinery/chem_dispenser,
/turf/open/floor/tile/whiteyellow{
	dir = 1
	},
/area/bigredv2/caves/lambda_lab)
"R" = (
/obj/effect/landmark/weed_node,
/turf/open/floor/plating/ground/mars/random/cave,
/area/bigredv2/caves/northeast)
"S" = (
/turf/open/space/basic,
/area/space)
"T" = (
/obj/effect/landmark/xeno_resin_wall,
/turf/open/floor/plating/ground/mars/random/cave,
/area/bigredv2/caves/northeast)
"W" = (
/obj/structure/closet/crate/internals,
/turf/open/floor/plating,
/area/bigredv2/caves/lambda_lab)
"X" = (
/turf/open/floor/plating/ground/mars/random/cave,
/area/bigredv2/caves/northeast)
"Y" = (
/turf/open/floor/plating,
/area/bigredv2/caves/lambda_lab)

(1,1,1) = {"
S
S
S
S
S
S
S
S
S
C
C
C
C
C
C
a
a
a
a
a
a
a
a
a
a
X
X
X
X
E
a
a
"}
(2,1,1) = {"
S
S
S
S
S
S
S
S
S
C
a
a
a
a
a
a
a
a
a
a
a
a
a
E
E
R
X
X
X
E
a
a
"}
(3,1,1) = {"
S
S
S
S
S
S
S
S
S
C
a
a
a
a
a
a
a
a
a
a
a
a
X
X
X
X
X
X
X
E
a
a
"}
(4,1,1) = {"
S
S
S
S
S
S
S
S
S
C
a
a
a
a
a
a
a
a
a
a
a
X
X
X
X
X
X
X
X
X
E
a
"}
(5,1,1) = {"
S
S
S
S
S
S
S
S
S
C
a
a
a
a
a
a
a
a
a
a
X
X
K
X
K
X
X
R
X
K
E
a
"}
(6,1,1) = {"
S
S
S
S
S
S
S
S
S
C
a
a
a
a
a
a
a
K
X
X
X
K
X
t
X
X
X
X
X
X
E
a
"}
(7,1,1) = {"
S
S
S
S
S
S
S
S
S
C
a
a
a
a
a
a
X
X
X
X
X
X
X
a
a
E
X
X
X
X
E
a
"}
(8,1,1) = {"
S
S
S
S
S
S
S
S
S
C
a
a
a
a
a
a
X
X
X
a
X
X
a
a
a
a
X
X
X
X
R
E
"}
(9,1,1) = {"
S
S
S
S
S
S
S
S
S
C
a
a
a
a
a
a
X
K
X
a
a
a
a
a
a
a
t
X
X
X
X
X
"}
(10,1,1) = {"
S
S
S
S
S
S
S
S
S
C
a
a
a
a
a
X
K
X
X
a
a
a
a
a
a
a
a
E
X
K
X
X
"}
(11,1,1) = {"
S
S
S
S
S
S
S
S
S
C
a
a
a
a
X
X
X
X
X
a
a
a
a
a
a
a
a
a
a
X
K
X
"}
(12,1,1) = {"
S
S
S
S
S
S
S
S
S
C
a
a
a
a
X
X
X
X
X
a
a
a
a
a
a
a
a
a
a
E
X
K
"}
(13,1,1) = {"
S
S
S
S
S
S
S
S
S
C
a
a
a
X
X
X
X
X
a
a
a
a
a
a
a
a
a
a
a
a
a
a
"}
(14,1,1) = {"
S
S
S
S
S
S
S
S
S
C
a
a
K
X
X
X
K
a
a
a
a
a
a
a
a
a
a
a
a
a
a
a
"}
(15,1,1) = {"
S
S
S
S
S
S
S
S
S
C
a
a
X
X
X
a
a
a
a
a
a
a
a
a
a
a
a
u
u
u
u
u
"}
(16,1,1) = {"
S
S
S
S
S
S
S
S
S
C
a
a
X
X
X
a
a
a
a
a
a
a
a
a
a
a
a
u
a
T
T
T
"}
(17,1,1) = {"
S
S
S
S
S
S
S
S
S
C
a
X
X
X
a
a
a
a
a
a
a
a
a
a
a
a
a
u
a
X
X
X
"}
(18,1,1) = {"
S
S
S
S
S
S
S
S
S
C
a
X
K
X
a
a
a
a
a
a
a
a
a
a
a
a
a
u
a
X
X
K
"}
(19,1,1) = {"
S
S
S
S
S
S
S
S
S
C
a
K
X
X
X
a
a
a
a
a
a
a
a
a
a
a
a
a
a
X
X
X
"}
(20,1,1) = {"
S
S
S
S
S
S
S
S
S
C
a
a
X
X
X
X
X
a
a
a
a
a
a
a
a
a
a
a
a
X
X
X
"}
(21,1,1) = {"
S
S
S
S
S
S
S
S
S
C
a
a
X
X
X
X
X
X
X
a
a
a
a
a
a
a
a
a
a
a
X
X
"}
(22,1,1) = {"
S
S
S
S
S
S
S
S
S
C
a
a
K
X
X
X
K
X
X
a
a
a
a
a
a
a
a
a
a
a
X
X
"}
(23,1,1) = {"
S
S
S
S
S
S
S
S
S
C
a
a
a
X
X
X
X
X
X
a
a
a
a
a
a
a
a
a
a
a
X
K
"}
(24,1,1) = {"
S
S
S
S
S
S
S
S
S
C
a
a
a
a
X
X
X
X
X
X
a
a
a
a
a
a
a
a
a
a
R
X
"}
(25,1,1) = {"
S
S
S
S
S
S
S
S
S
C
a
a
a
a
X
X
X
a
X
X
a
a
a
a
a
a
a
a
a
a
a
X
"}
(26,1,1) = {"
S
S
S
S
S
S
S
S
S
C
a
a
a
X
X
X
X
a
X
X
X
a
a
a
a
a
a
a
a
a
a
a
"}
(27,1,1) = {"
S
S
S
S
S
S
S
S
S
C
a
a
X
X
X
X
X
X
X
X
X
a
a
a
a
a
a
a
a
a
a
a
"}
(28,1,1) = {"
S
S
S
S
S
S
S
S
S
C
a
a
K
X
X
X
K
X
X
X
X
a
a
a
a
a
a
a
a
a
a
z
"}
(29,1,1) = {"
S
S
S
S
S
S
S
S
S
C
a
a
X
X
X
a
X
K
X
X
K
a
a
a
a
a
a
a
a
a
z
a
"}
(30,1,1) = {"
S
S
S
S
S
S
S
S
S
C
a
a
X
X
a
a
a
X
X
X
a
a
a
a
a
a
a
a
a
z
a
a
"}
(31,1,1) = {"
S
S
S
S
S
S
S
S
S
C
a
a
X
X
a
a
a
X
X
X
a
a
a
a
a
a
a
a
a
z
a
h
"}
(32,1,1) = {"
S
S
S
S
S
S
S
S
S
C
a
a
X
X
a
a
a
X
X
X
a
a
a
a
a
a
a
a
a
z
a
h
"}
(33,1,1) = {"
S
S
S
S
S
S
S
S
S
C
a
X
X
X
a
a
a
X
X
X
a
a
a
a
a
a
a
a
a
z
a
h
"}
(34,1,1) = {"
S
S
S
S
S
S
S
S
S
C
a
X
X
X
a
a
X
X
X
X
X
a
a
a
a
a
a
a
a
z
a
h
"}
(35,1,1) = {"
S
S
S
S
S
S
S
S
S
C
a
X
X
X
X
X
X
X
X
X
X
a
a
a
a
a
a
a
a
z
a
h
"}
(36,1,1) = {"
S
S
S
S
S
S
S
S
S
C
a
a
K
X
X
X
X
K
X
X
X
X
a
a
a
a
a
a
a
z
a
a
"}
(37,1,1) = {"
S
S
S
S
S
S
S
S
S
C
a
a
a
a
X
X
X
X
X
X
X
X
X
a
a
a
a
a
a
z
a
a
"}
(38,1,1) = {"
S
S
S
S
S
S
S
S
S
C
a
a
a
a
a
a
a
K
X
X
X
X
X
K
X
a
a
a
a
z
a
a
"}
(39,1,1) = {"
S
S
S
S
S
S
S
S
S
C
a
a
a
a
a
a
a
a
a
a
a
X
X
X
X
X
X
a
a
z
h
h
"}
(40,1,1) = {"
S
S
S
S
S
S
S
S
S
C
C
C
C
C
C
C
C
C
C
C
a
X
X
X
X
X
R
X
a
z
h
Y
"}
(41,1,1) = {"
S
S
S
S
S
S
S
S
S
S
S
S
S
S
S
S
S
S
S
C
a
a
X
X
X
X
R
X
a
z
h
W
"}
(42,1,1) = {"
S
S
S
S
S
S
S
S
S
S
S
S
S
S
S
S
S
S
S
C
a
a
a
X
X
X
X
X
a
z
h
p
"}
(43,1,1) = {"
S
S
S
S
S
S
S
S
S
S
S
S
S
S
S
S
S
S
S
C
a
a
a
K
R
X
K
X
X
z
h
h
"}
(44,1,1) = {"
S
S
S
S
S
S
S
S
S
S
S
S
S
S
S
S
S
S
S
C
a
a
a
X
X
X
X
X
X
d
h
b
"}
(45,1,1) = {"
S
S
S
S
S
S
S
S
S
S
S
S
S
S
S
S
S
S
S
C
a
a
a
X
X
X
X
X
X
d
h
M
"}
(46,1,1) = {"
S
S
S
S
S
S
S
S
S
S
S
S
S
S
S
S
S
S
S
C
a
a
a
X
X
X
X
X
X
d
h
M
"}
(47,1,1) = {"
S
S
S
S
S
S
S
S
S
S
S
S
S
S
S
S
S
S
S
C
a
a
a
X
X
X
X
X
a
z
h
i
"}
(48,1,1) = {"
S
S
S
S
S
S
S
S
S
S
S
S
S
S
S
S
S
S
S
C
a
a
a
a
X
X
X
R
a
z
h
h
"}
(49,1,1) = {"
S
S
S
S
S
S
S
S
S
S
S
S
S
S
S
S
S
S
S
C
a
a
a
a
X
X
X
X
a
a
z
h
"}
(50,1,1) = {"
S
S
S
S
S
S
S
S
S
S
S
S
S
S
S
S
S
S
S
C
a
a
a
a
X
X
X
X
X
X
a
z
"}
(51,1,1) = {"
S
S
S
S
S
S
S
S
S
S
S
S
S
S
S
S
S
S
S
C
a
a
a
a
a
X
X
y
X
X
X
E
"}
(52,1,1) = {"
S
S
S
S
S
S
S
S
S
S
S
S
S
S
S
S
S
S
S
C
a
a
a
a
a
X
K
X
X
X
K
X
"}
(53,1,1) = {"
S
S
S
S
S
S
S
S
S
S
S
S
S
S
S
S
S
S
S
C
a
a
a
a
a
a
X
X
R
X
X
X
"}
(54,1,1) = {"
S
S
S
S
S
S
S
S
S
S
S
S
S
S
S
S
S
S
S
C
a
a
a
a
a
a
X
X
X
X
X
X
"}
(55,1,1) = {"
S
S
S
S
S
S
S
S
S
S
S
S
S
S
S
S
S
S
S
C
a
a
a
a
a
a
a
X
c
X
X
X
"}
(56,1,1) = {"
S
S
S
S
S
S
S
S
S
S
S
S
S
S
S
S
S
S
S
C
a
a
a
a
a
a
a
X
X
X
R
X
"}
(57,1,1) = {"
S
S
S
S
S
S
S
S
S
S
S
S
S
S
S
S
S
S
S
C
a
a
a
a
a
a
a
X
X
X
X
X
"}
(58,1,1) = {"
S
S
S
S
S
S
S
S
S
S
S
S
S
S
S
S
S
S
S
C
a
a
a
a
a
a
a
X
X
X
K
X
"}
(59,1,1) = {"
S
S
S
S
S
S
S
S
S
S
S
S
S
S
S
S
S
S
S
C
a
a
a
a
a
a
a
X
X
X
X
X
"}
(60,1,1) = {"
S
S
S
S
S
S
S
S
S
S
S
S
S
S
S
S
S
S
S
C
a
a
a
a
a
a
a
a
X
X
K
X
"}
(61,1,1) = {"
S
S
S
S
S
S
S
S
S
S
S
S
S
S
S
S
S
S
S
C
a
a
a
a
a
a
a
a
a
X
R
X
"}
(62,1,1) = {"
S
S
S
S
S
S
S
S
S
S
S
S
S
S
S
S
S
S
S
C
a
a
a
a
a
a
a
a
a
X
X
X
"}
(63,1,1) = {"
S
S
S
S
S
S
S
S
S
S
S
S
S
S
S
S
S
S
S
C
a
a
a
a
a
a
a
a
a
X
X
X
"}
(64,1,1) = {"
S
S
S
S
S
S
S
S
S
S
S
S
S
S
S
S
S
S
S
C
a
a
a
a
a
a
a
a
a
X
X
X
"}
(65,1,1) = {"
S
S
S
S
S
S
S
S
S
S
S
S
S
S
S
S
S
S
S
C
a
a
a
a
a
a
a
a
a
X
R
X
"}
