//MAP CONVERTED BY dmm2tgm.py THIS HEADER COMMENT PREVENTS RECONVERSION, DO NOT REMOVE
"aa" = (
/obj/effect/landmark/weed_node,
/turf/open/floor/plating/ground/mars/random/cave,
/area/bigredv2/caves/east)
"ab" = (
/obj/effect/landmark/xeno_resin_door,
/turf/open/floor/plating/ground/mars/random/cave,
/area/bigredv2/caves/east)
"ac" = (
/obj/effect/landmark/xeno_silo_spawn,
/turf/open/floor/plating/ground/mars/random/cave,
/area/bigredv2/caves/east)
"ad" = (
/obj/docking_port/stationary/crashmode,
/turf/closed/mineral/bigred,
/area/bigredv2/caves/rock)
"ae" = (
/obj/effect/landmark/xeno_resin_door,
/obj/effect/ai_node,
/turf/open/floor/plating/ground/mars/random/cave,
/area/bigredv2/caves/east)
"af" = (
/obj/machinery/miner/damaged/platinum,
/turf/open/floor/plating/ground/mars/random/cave,
/area/bigredv2/caves/east)
"ag" = (
/atom/movable/effect/landmark/xeno_resin_door,
/atom/movable/effect/ai_node,
/turf/open/floor/plating/ground/mars/random/cave,
/area/bigredv2/caves/east)
"ah" = (
/obj/effect/landmark/lv624/fog_blocker,
/turf/closed/mineral/bigred,
/area/bigredv2/caves/rock)
"ai" = (
/obj/effect/ai_node,
/turf/open/floor/plating/ground/mars/random/cave/rock,
/area/bigredv2/caves/east)
"aj" = (
/turf/closed/wall/indestructible/mineral,
/area/space)
"ak" = (
/atom/movable/effect/landmark/xeno_silo_spawn,
/turf/open/floor/plating/ground/mars/random/cave,
/area/bigredv2/caves/east)
"al" = (
/atom/movable/effect/landmark/xeno_resin_door,
/turf/open/floor/plating/ground/mars/random/cave,
/area/bigredv2/caves/east)
"am" = (
/obj/effect/landmark/lv624/fog_blocker/xeno_spawn,
/obj/effect/landmark/xeno_resin_wall,
/turf/open/floor/plating/ground/mars/random/cave,
/area/bigredv2/caves/east)
"an" = (
/obj/structure/fence,
/obj/effect/landmark/lv624/fog_blocker,
/turf/open/floor/plating/ground/mars/random/cave,
/area/bigredv2/caves/east)
"ao" = (
/turf/open/floor/plating/ground/mars/random/cave/rock,
/area/bigredv2/caves/east)
"ap" = (
/atom/movable/effect/landmark/lv624/fog_blocker,
/turf/closed/mineral/smooth/bigred,
/area/bigredv2/caves/rock)
"aq" = (
/obj/effect/ai_node,
/turf/open/floor/plating/ground/mars/random/sand,
/area/bigredv2/outside/se)
"ar" = (
/turf/closed/mineral/smooth/bigred,
/area/bigredv2/caves/rock)
"as" = (
/obj/effect/landmark/lv624/fog_blocker/xeno_spawn,
/turf/closed/mineral/bigred,
/area/bigredv2/caves/rock)
"at" = (
/atom/movable/effect/landmark/weed_node,
/turf/open/floor/plating/ground/mars/random/sand,
/area/bigredv2/outside/se)
"au" = (
/obj/effect/landmark/lv624/fog_blocker/xeno_spawn,
/turf/open/floor/plating/ground/mars/random/cave/rock,
/area/bigredv2/caves/east)
"av" = (
/obj/docking_port/stationary/crashmode,
/turf/open/floor/plating/ground/mars/random/cave,
/area/bigredv2/caves/east)
"aw" = (
/obj/effect/landmark/lv624/fog_blocker/xeno_spawn,
/obj/effect/landmark/lv624/fog_blocker/xeno_spawn,
/turf/open/floor/plating/ground/mars/random/cave,
/area/bigredv2/caves/east)
"ax" = (
/atom/movable/effect/ai_node,
/turf/open/floor/plating/ground/mars/random/cave,
/area/bigredv2/caves/east)
"ay" = (
/atom/movable/effect/landmark/excavation_site_spawner,
/turf/open/floor/plating/ground/mars/random/cave,
/area/bigredv2/caves/east)
"az" = (
/turf/closed/mineral/smooth/bigred/indestructible,
/area/space)
"aA" = (
/turf/open/floor/plating/ground/mars/random/sand,
/area/bigredv2/outside/se)
"aB" = (
/atom/movable/effect/landmark/xeno_resin_door,
/turf/open/floor/plating/ground/mars/random/cave/rock,
/area/bigredv2/caves/east)
"aC" = (
/atom/movable/effect/landmark/lv624/fog_blocker/xeno_spawn,
/atom/movable/effect/landmark/xeno_resin_wall,
/turf/open/floor/plating/ground/mars/random/cave,
/area/bigredv2/caves/east)
"aD" = (
/obj/effect/landmark/excavation_site_spawner,
/turf/open/floor/plating/ground/mars/random/cave,
/area/bigredv2/caves/east)
"aE" = (
/atom/movable/effect/landmark/lv624/fog_blocker/xeno_spawn,
/turf/open/floor/plating/ground/mars/random/cave/rock,
/area/bigredv2/caves/east)
"aF" = (
/turf/closed/mineral/bigred,
/area/bigredv2/caves/rock)
"aG" = (
/obj/effect/landmark/weed_node,
/turf/open/floor/plating/ground/mars/random/sand,
/area/bigredv2/outside/se)
"aH" = (
/obj/docking_port/stationary/crashmode,
/turf/closed/mineral/smooth/bigred,
/area/bigredv2/caves/rock)
"aI" = (
/obj/effect/landmark/lv624/fog_blocker/xeno_spawn,
/turf/open/floor/plating/ground/mars/random/cave,
/area/bigredv2/caves/east)
"aJ" = (
/atom/movable/effect/landmark/lv624/fog_blocker/xeno_spawn,
/atom/movable/effect/landmark/lv624/fog_blocker/xeno_spawn,
/turf/closed/mineral/smooth/bigred,
/area/bigredv2/caves/rock)
"aK" = (
/obj/effect/landmark/lv624/fog_blocker/xeno_spawn,
/obj/effect/landmark/lv624/fog_blocker/xeno_spawn,
/turf/closed/mineral/bigred,
/area/bigredv2/caves/rock)
"aL" = (
/atom/movable/effect/ai_node,
/turf/open/floor/plating/ground/mars/random/cave/rock,
/area/bigredv2/caves/east)
"aM" = (
/obj/effect/landmark/xeno_resin_door,
/turf/open/floor/plating/ground/mars/random/cave/rock,
/area/bigredv2/caves/east)
"aN" = (
/turf/open/floor/plating/ground/mars/random/cave,
/area/bigredv2/caves/east)
"aO" = (
/obj/effect/landmark/weed_node,
/turf/open/floor/plating/ground/mars/random/cave/rock,
/area/bigredv2/caves/east)
"aP" = (
/atom/movable/effect/landmark/weed_node,
/turf/open/floor/plating/ground/mars/random/cave/rock,
/area/bigredv2/caves/east)
"aQ" = (
/obj/effect/landmark/weed_node,
/obj/effect/ai_node,
/turf/open/floor/plating/ground/mars/random/cave,
/area/bigredv2/caves/east)
"aR" = (
/atom/movable/effect/landmark/xeno_resin_wall,
/turf/open/floor/plating/ground/mars/random/cave,
/area/bigredv2/caves/east)
"aS" = (
/obj/structure/fence,
/atom/movable/effect/landmark/lv624/fog_blocker,
/turf/open/floor/plating/ground/mars/random/cave,
/area/bigredv2/caves/east)
"aT" = (
/atom/movable/effect/landmark/weed_node,
/atom/movable/effect/ai_node,
/turf/open/floor/plating/ground/mars/random/cave,
/area/bigredv2/caves/east)
"aU" = (
/obj/effect/ai_node,
/turf/open/floor/plating/ground/mars/random/cave,
/area/bigredv2/caves/east)
"aV" = (
/atom/movable/effect/landmark/weed_node,
/turf/open/floor/plating/ground/mars/random/cave,
/area/bigredv2/caves/east)
"aW" = (
/atom/movable/effect/landmark/lv624/fog_blocker/xeno_spawn,
/atom/movable/effect/landmark/lv624/fog_blocker/xeno_spawn,
/turf/open/floor/plating/ground/mars/random/cave,
/area/bigredv2/caves/east)
"aX" = (
/atom/movable/effect/landmark/lv624/fog_blocker/xeno_spawn,
/turf/closed/mineral/smooth/bigred,
/area/bigredv2/caves/rock)
"aY" = (
/atom/movable/effect/landmark/lv624/fog_blocker/xeno_spawn,
/turf/open/floor/plating/ground/mars/random/cave,
/area/bigredv2/caves/east)
"aZ" = (
/obj/effect/landmark/xeno_resin_wall,
/turf/open/floor/plating/ground/mars/random/cave,
/area/bigredv2/caves/east)
"DC" = (
/atom/movable/effect/ai_node,
/turf/open/floor/plating/ground/mars/random/sand,
/area/bigredv2/outside/se)

(1,1,1) = {"
aA
aA
aA
aA
aA
aA
aA
aA
aA
aA
aA
ar
ar
ar
aS
aN
aV
aN
aN
aV
aN
aN
aN
aN
aN
aV
aN
aN
ar
ar
ar
ar
ar
ar
ar
ar
ar
aN
aV
aN
aN
aV
"}
(2,1,1) = {"
aA
aA
at
aA
aA
aA
at
aA
aA
aA
aA
ar
ar
ar
ap
aN
aN
aN
aN
aN
aN
aN
aN
aN
aN
aN
aN
aN
ar
ar
ar
ar
ar
ar
ar
ar
ar
ar
aN
aN
ax
aN
"}
(3,1,1) = {"
aA
aA
aA
aA
aA
aA
aA
aA
aA
aA
aA
ar
ar
ar
ap
aN
aN
aN
aN
aN
aN
ar
ar
ar
ar
ar
aN
aN
aN
ar
ar
ar
ar
ar
ar
ar
ar
ar
aN
aN
aN
aN
"}
(4,1,1) = {"
aA
ar
ar
ar
ar
aA
aA
aA
at
aA
aA
at
ar
ar
ap
aN
aN
aN
aV
aN
aN
ar
ar
ar
ar
ar
ao
aN
aN
aN
aN
aV
aN
aN
aN
ar
ao
ao
aN
aN
aN
aN
"}
(5,1,1) = {"
aA
ar
ar
ar
ar
ar
ar
aA
aA
aA
aA
aA
aA
ar
ap
ar
aN
aW
aY
aY
aX
aX
aX
aX
aX
aX
aY
aE
aW
aN
aN
aN
aN
aN
aV
ao
aN
aN
aV
aN
aN
aV
"}
(6,1,1) = {"
aA
aA
ar
ar
ar
ar
ar
ar
aA
aA
aA
aA
aA
ar
ap
ar
ar
aY
aN
ar
ar
ar
ar
ar
ar
aN
aN
aN
aE
aP
ax
aN
aN
aN
aN
aN
aN
aN
aN
aN
ax
ao
"}
(7,1,1) = {"
aA
aA
aA
aA
aA
aA
aA
aA
aA
aA
aA
aA
aA
ar
ap
ar
ar
aC
aR
aR
aN
ar
aN
ar
ar
aN
ax
aN
aY
ax
aN
aN
aV
aN
aN
aN
aN
aV
aN
af
aN
ao
"}
(8,1,1) = {"
aA
at
aA
aA
at
aA
aA
aA
at
aA
aA
at
aA
ar
ap
ar
ar
aX
aN
aN
aN
aT
aN
aN
ag
ax
aN
aN
aY
aN
aN
aN
aN
aN
aN
aN
ao
aN
aN
aN
ao
ar
"}
(9,1,1) = {"
aA
aA
aA
aA
aA
DC
aA
aA
aA
DC
aA
aA
aA
ar
ap
ar
ar
aX
aN
aN
aN
aN
aN
aN
al
aN
aN
ar
aX
ar
ar
ar
aN
aN
aN
aN
aV
ao
aN
aN
aN
ao
"}
(10,1,1) = {"
aA
aA
aA
aA
aA
aA
aA
aA
aA
aA
aA
aA
ar
ar
ap
ar
ar
aX
ar
ar
aN
aN
aN
aN
aR
ar
ar
ar
aX
ar
ar
ar
ar
ar
ar
ar
aN
aN
aN
aV
aV
ao
"}
(11,1,1) = {"
aA
aA
ar
aA
aA
aA
aA
aA
aA
aA
aA
ar
ar
ar
ap
ar
ar
aX
ar
aN
aN
aN
aN
aN
aR
aR
ar
ar
aX
ar
ar
ar
ar
ar
ar
ar
aN
aN
aN
aN
aN
ao
"}
(12,1,1) = {"
aA
ar
ar
aA
at
aA
aA
aA
at
ar
ar
ar
ar
ar
ap
ar
ar
aX
aN
ao
aN
aN
aP
aV
aN
aN
ar
ar
aX
ar
ar
ar
ar
ar
ar
ar
aN
aN
aN
aV
aN
ao
"}
(13,1,1) = {"
ar
ar
ar
aA
aA
aA
aA
aA
aA
ar
ar
ar
ar
ar
ap
ar
ar
aX
aN
aV
aN
aN
aN
aN
aN
aN
ar
ar
aX
ar
ar
ar
ar
ar
ar
ar
ao
aN
aV
aN
ao
ar
"}
(14,1,1) = {"
ar
ar
aA
aA
aA
aA
aA
aA
aA
ar
ar
ar
ar
ar
ap
ar
ar
aX
aN
aN
aN
ax
ak
aN
aN
aV
aN
ar
aX
ar
ar
ar
ar
ar
ar
ar
aN
aN
aV
aN
ax
ao
"}
(15,1,1) = {"
ar
aA
aA
aA
aA
aA
ar
ar
ar
ar
ar
ar
ar
ar
ap
ar
ar
aX
aN
aN
aN
aN
aN
aN
aV
aN
ar
ar
aX
ar
ar
ar
ar
ar
ar
ar
ar
ao
aN
aN
aN
ao
"}
(16,1,1) = {"
at
aA
aA
aA
at
DC
ar
ar
ar
ar
ar
ar
ar
ar
ap
ar
ar
aX
ar
ar
ar
aN
aN
aN
aN
ar
ar
ar
aX
ar
ar
ar
ar
ar
ar
ar
ar
ar
al
al
al
al
"}
(17,1,1) = {"
aA
aA
aA
aA
aA
aA
ar
ar
ar
ar
ar
ar
ar
ar
ap
ar
ar
aX
ar
ar
ar
ar
ar
ar
ar
ar
ar
ar
aX
ar
ar
ar
ar
ar
ar
ar
ar
ar
aN
aN
aN
aN
"}
(18,1,1) = {"
ar
ar
ar
ar
ar
ar
ar
ar
ar
ar
ar
ar
ar
ar
ap
ar
ar
aJ
aX
aX
aX
aX
aX
aX
aX
aX
aX
aX
aJ
ar
ar
ar
ar
ar
ar
ar
aN
aN
aN
aN
aN
aN
"}
(19,1,1) = {"
ap
ap
ap
ap
ap
ap
ap
ap
ap
ap
ap
ap
ap
ap
ap
ar
ar
ar
ar
ar
ar
ar
ar
ar
ar
ar
ar
ar
ar
ar
ar
ar
ar
ar
ar
aN
aN
aN
aN
aV
aN
aN
"}
(20,1,1) = {"
ar
ar
ar
ar
ar
ar
ar
ar
ar
ar
ar
ar
ar
ar
ar
ar
ar
ar
ar
ar
ar
ar
ar
ar
ar
aH
ar
ar
ar
ar
ar
ar
ar
ar
aN
aN
aN
aN
aN
aN
aN
aN
"}
(21,1,1) = {"
ar
ar
ar
ar
ar
ar
ar
ar
ar
ar
ar
ar
ar
ar
ar
ar
ar
ar
ar
ar
ar
ar
ar
ar
ar
ar
ar
ar
ar
ar
ar
ar
aN
aN
aN
aV
aN
aN
aN
ao
aN
aN
"}
(22,1,1) = {"
ar
ao
ao
ao
ao
ao
ar
ar
ar
ar
ar
ar
ar
ar
ar
ar
ar
ar
ar
ar
ar
ar
ao
ao
ao
ao
ao
ar
ar
ar
aN
aN
aN
ax
aN
aN
aN
aN
aN
aN
ax
aN
"}
(23,1,1) = {"
ar
ax
aN
aV
aN
aN
aL
ar
ar
ar
ar
ar
ar
ar
ar
ar
ar
ar
aL
ao
ao
ao
aV
aN
ax
aN
aN
ao
aP
aN
aN
aN
ax
aV
aN
aN
ao
ar
ar
aN
aV
aN
"}
(24,1,1) = {"
ar
ao
aN
aN
aN
aN
ao
ar
ar
ar
ar
ar
ar
ar
ar
ar
ar
ar
aN
aN
aN
aN
aN
aN
aN
aV
aN
aN
aN
aN
ao
aN
aN
ao
aN
aN
ao
ar
ar
aN
aN
aN
"}
(25,1,1) = {"
ar
ar
ar
ao
aN
aN
ao
aN
aN
aN
aN
ar
ar
ar
ar
ar
ar
ao
aN
aV
aN
aN
aN
aN
aN
aN
aN
aN
aN
aN
aN
aN
ao
aN
aN
ao
ar
ar
ar
aN
aN
aN
"}
(26,1,1) = {"
ar
ar
ar
ar
ar
aN
ao
aN
aN
aN
aN
ar
ar
ar
ar
ao
ao
aN
aN
aN
aV
aN
aN
aV
aN
aN
aN
aN
aN
aN
aV
aN
aN
aN
ao
ar
ar
ar
ar
aN
ax
aN
"}
(27,1,1) = {"
ao
ao
ao
ao
ao
aN
ao
aV
aN
aN
aN
aN
al
aN
aN
aN
aN
aN
aN
aN
aN
aN
aN
aN
aN
aN
aV
aN
aN
aN
aN
aN
aN
aN
aN
ao
ar
ao
ao
aN
ay
aN
"}
(28,1,1) = {"
aN
aN
aN
aN
aN
aN
ax
ao
ao
ao
ao
ao
aB
ao
aV
aN
aL
aN
ax
aN
aN
aN
aN
aN
aN
af
aN
aN
aN
aN
aV
aN
aN
aN
aN
aN
ao
aN
aN
aN
aN
aN
"}
(29,1,1) = {"
aN
aN
aN
aV
aN
aN
aN
aN
aN
aN
aV
aN
al
aN
aN
aN
ao
aN
aN
ao
aN
aN
aN
ay
aN
aN
aN
aN
aN
aN
aN
aN
aN
aN
aV
aN
aN
aN
aN
aV
aN
aN
"}
(30,1,1) = {"
aN
aN
aN
aN
aN
aN
aN
aN
aN
aN
aN
aN
al
aN
aN
aN
aL
aN
aN
aN
aV
aN
aN
aN
ax
ao
aN
aV
aN
aN
aV
aN
aN
ax
aN
aN
aN
aN
aN
aN
aL
ar
"}
(31,1,1) = {"
aV
aN
aN
aN
aN
aN
aN
aN
aN
aN
aN
ao
ar
ar
aN
aN
ao
aN
aN
aN
aN
aN
aN
aN
aN
ax
aN
aN
aN
aN
aN
aN
aN
aN
aN
aN
aN
aN
aN
aN
ao
ar
"}
(32,1,1) = {"
ao
aN
aN
aN
aN
aN
aN
ar
ar
ar
ar
ar
ar
ar
ar
aN
ao
aN
aN
aN
aN
aN
aN
aN
aN
aN
aN
aN
aN
aN
aN
aN
aN
aN
aN
aN
aV
aN
aN
ao
aN
ar
"}
(33,1,1) = {"
aN
aN
aN
aV
af
aN
aN
ar
ar
ar
ar
ar
ar
ar
ar
aN
ao
aV
aN
aN
ax
aN
aN
aV
aN
aN
aN
aN
ar
ar
ar
ar
ar
ar
aN
aN
aN
aN
ao
aN
aN
aN
"}
(34,1,1) = {"
ao
aN
aN
ao
aN
aN
aN
ar
ar
ar
ar
ar
ar
ar
ao
aN
aN
aN
aN
aN
aN
ar
ar
ar
ar
ar
ar
ar
ar
ar
ar
ar
ar
ar
aV
aN
aN
aN
ao
aN
aN
aN
"}
(35,1,1) = {"
ar
ao
aN
aN
aN
aN
aN
aN
ar
ar
ar
ar
ar
ao
aN
aN
aN
aN
aN
aN
ar
ar
ar
ar
ar
ar
ar
ar
ar
ar
ar
ar
ar
ar
ar
ar
ar
ar
ar
al
al
al
"}
(36,1,1) = {"
ar
ar
ar
aN
aN
ao
aN
aN
aN
ar
ar
ar
ao
aN
aN
aN
aN
aN
aN
ar
ar
ar
ar
ar
ar
ar
ar
ar
ar
ar
ar
ar
ar
ar
ar
ar
ar
ar
ar
ar
ax
aN
"}
(37,1,1) = {"
ar
ar
ar
aN
aN
aP
ax
aN
av
ao
aN
aN
aN
aN
aN
aN
aL
ar
ar
ar
ar
ar
ar
ar
ar
ar
ar
ar
ar
ar
ar
ar
ar
ar
ar
ar
ar
ar
ar
ar
aN
aN
"}
(38,1,1) = {"
ar
ar
ar
aN
aN
ay
aN
aN
aN
aN
aN
aN
aN
aV
aN
ao
ao
ar
ar
ar
ar
ar
ar
ar
ar
ar
ar
ar
ar
ar
ar
ar
ar
ar
ar
ar
ar
ar
ar
ar
ar
aN
"}
(39,1,1) = {"
ar
ar
ar
ar
aN
aN
aN
aN
aN
aN
aN
aN
aN
aV
aN
ar
ar
ar
ar
ar
ar
ar
ar
ar
ar
ar
ar
ar
ar
ar
ar
ar
ar
ar
ar
ar
ar
ar
ar
ar
ar
ar
"}
(40,1,1) = {"
ar
ar
ar
ar
aN
aN
aN
aN
aN
aV
aN
aN
aN
aN
aN
ar
ar
ar
ar
ar
ar
ar
ar
ar
ar
ar
ar
ar
ar
ar
ar
ar
ar
ar
ar
ar
ar
ar
ar
ar
ar
ar
"}
(41,1,1) = {"
ar
ar
ar
aN
aN
aN
aN
aN
aN
aN
aN
aN
aN
aN
ar
ar
ar
ar
ar
ar
ar
ar
ar
ar
ar
ar
ar
ar
ar
ar
ar
ar
ar
ar
ar
ar
ar
ar
ar
ar
ar
ar
"}
(42,1,1) = {"
ar
ar
ar
aN
aN
aN
aV
aN
aN
ar
ar
ar
ar
ar
ar
ar
ar
ar
ar
ar
ar
ar
ar
ar
ar
ar
ar
ar
ar
ar
ar
ar
ar
ar
ar
ar
ar
ar
ar
ar
ar
ar
"}
(43,1,1) = {"
ar
ar
aN
aN
aN
aN
aN
aN
aN
ar
ar
ar
ar
ar
ar
ar
ar
ar
ar
aX
aX
aX
aX
aX
aX
aX
aX
aX
aX
aX
aX
ar
ar
ar
ar
ar
ar
ar
ar
ar
ar
ar
"}
(44,1,1) = {"
ar
ar
al
al
al
al
al
al
ar
ar
ar
ar
ar
ar
ar
ar
ar
ar
ar
aX
ar
ar
ar
ar
ar
ar
ar
ar
ar
ar
aX
ar
ar
ar
ar
ar
ar
ar
ar
ar
ar
ar
"}
(45,1,1) = {"
ar
ar
aN
aN
aN
aN
aN
aN
ar
ar
ar
ar
ar
ar
ar
ar
ar
ar
ar
aX
ar
ar
ar
aN
aV
aN
aN
aV
ar
ar
aX
ar
ar
ar
ar
ar
ar
ar
ar
ar
ar
ar
"}
(46,1,1) = {"
aN
aN
aN
aN
aN
aV
aN
aN
ar
ar
ar
ar
ar
ar
ar
ar
ar
ar
ar
aX
ar
ar
aN
aN
aN
aN
ak
aN
aN
ar
aX
ar
ar
ar
aN
aN
aN
aN
aN
aN
aN
aN
"}
(47,1,1) = {"
aN
aN
ax
aN
aN
aN
ax
ar
ar
ar
ar
ar
ar
ar
ar
ar
ar
ar
ar
aX
ar
ar
aN
aN
aN
aN
aN
aN
aV
aN
aX
ar
ar
ar
aN
aN
aN
aN
aN
aN
aN
aN
"}
(48,1,1) = {"
aN
aN
aV
aN
aN
aN
aN
ar
ar
ar
ar
ar
ar
ar
ar
ar
ar
ar
ar
aX
ar
ar
aN
aV
aN
aN
aN
aN
aN
aN
aX
ar
ar
aN
aN
aN
aN
aN
aN
ax
aN
aN
"}
(49,1,1) = {"
aN
aN
ax
aN
aV
aN
ar
ar
ar
ar
ar
ar
ar
ar
ar
ar
ar
ar
ar
aX
ar
aR
aR
aR
al
al
al
al
aR
aR
aX
ar
ar
aN
aN
aN
aV
aN
aN
aN
aV
aN
"}
(50,1,1) = {"
aN
aN
aN
aN
aN
aN
ar
ar
ar
ar
ar
ar
ar
ar
ar
ar
ar
ar
ar
aX
aY
aY
aY
aY
aY
aY
aY
aY
aY
aY
aY
aN
aN
aN
aN
aN
aN
aN
aN
aN
aN
aN
"}
(51,1,1) = {"
aN
aN
aN
aN
aN
aN
ar
ar
ar
ar
ar
ar
ar
ar
ar
ar
ar
ar
ar
ar
aN
aN
aN
aN
aN
aN
aN
aN
aN
aN
aN
aN
aN
aN
aN
aN
aN
aN
aN
aN
aN
aN
"}
(52,1,1) = {"
aN
aP
aN
aN
aN
aV
ar
ar
ar
aN
aN
aN
aN
aN
aN
aN
aN
aN
aN
aN
aN
aN
aN
aN
aN
aN
aN
aN
aN
aN
ax
aV
aN
aN
aN
aN
ay
aN
aV
ax
aN
aN
"}
(53,1,1) = {"
aN
aN
aN
aN
aN
aN
ar
ar
ar
aN
aN
aN
aN
aN
aN
aV
aN
aV
aN
aN
aN
aN
aN
ao
aV
aN
aN
aN
aN
aN
aN
aN
aN
aN
ao
aN
aN
aN
aN
aN
aN
aN
"}
(54,1,1) = {"
aN
aN
aN
aN
aN
aN
aN
aN
aN
aN
aN
aN
aN
aN
aN
aN
aN
aN
aN
ay
aV
aN
aN
aN
aN
aN
aN
af
aN
aN
aN
aN
aN
aN
aN
aN
aN
aN
aN
aN
aN
aN
"}
(55,1,1) = {"
aV
aN
ax
aN
aN
aV
aN
aN
aN
aN
aN
aV
ax
aN
aN
aV
aN
aN
aN
aN
ax
aN
aN
aN
aN
aV
aN
aN
aN
aN
ax
aN
aN
aN
aN
aN
aN
aN
aN
aN
aN
aN
"}
(56,1,1) = {"
aN
aN
aN
aN
aN
aN
aN
aN
aN
aN
aN
ao
aN
aN
aN
aN
aN
aN
aN
aN
aN
aN
aN
aN
aN
aN
aN
aN
aN
aN
aN
aV
aN
aN
ar
ar
ar
ar
ar
ar
ar
ar
"}
(57,1,1) = {"
aN
aN
aN
ar
aN
aN
aN
aN
aN
aN
aN
aN
aN
aN
aN
aN
aN
aP
aN
aN
aN
aN
aN
aN
aN
aN
aN
aN
aN
aN
aN
aN
aN
aN
ar
ar
ar
ar
ar
ar
ar
ar
"}
(58,1,1) = {"
aN
aN
aN
ar
ar
ar
ar
ar
ar
aN
aV
aN
aN
aN
aN
aN
aN
aN
aN
aN
aN
aN
aN
aN
aN
aN
ar
ar
ar
ar
ar
ar
ar
ar
ar
ar
ar
ar
ar
ar
ar
ar
"}
(59,1,1) = {"
aN
aN
ar
ar
ar
ar
ar
ar
ar
aN
aN
aN
aN
aN
aN
aN
aV
aN
aN
aN
aN
aN
aN
aN
aN
aN
ar
ar
ar
ar
ar
ar
ar
ar
ar
ar
ar
ar
ar
ar
ar
ar
"}
(60,1,1) = {"
ar
ar
ar
ar
ar
ar
ar
ar
ar
ar
ar
ar
ar
aN
aN
aN
aN
aN
ar
ar
ar
ar
ar
ar
ar
ar
ar
ar
ar
ar
ar
ar
ar
ar
ar
ar
ar
ar
ar
ar
ar
ar
"}
(61,1,1) = {"
ar
ar
ar
ar
ar
ar
ar
ar
ar
ar
ar
ar
ar
ar
ar
ar
ar
ar
ar
ar
ar
ar
ar
ar
ar
ar
ar
ar
ar
ar
ar
ar
ar
ar
ar
ar
ar
ar
ar
ar
ar
ar
"}
(62,1,1) = {"
aX
aX
ar
ar
ar
ar
ar
ar
ar
ar
ar
ar
ar
ar
ar
ar
ar
ar
ar
ar
ar
ar
ar
ar
ar
ar
ar
ar
ar
ar
ar
ar
ar
ar
ar
ar
ar
ar
ar
ar
ar
ar
"}
(63,1,1) = {"
ar
aX
aX
ar
ar
ar
ar
ar
ar
ar
ar
ar
ar
ar
ar
ar
ar
ar
ar
ar
ar
ar
ar
ar
ar
ar
ar
ar
ar
ar
ar
ar
ar
ar
ar
ar
ar
ar
ar
ar
ar
ar
"}
(64,1,1) = {"
ar
ar
aX
ar
ar
ar
ar
ar
ar
ar
ar
ar
ar
ar
ar
ar
ar
ar
ar
ar
ar
ar
ar
ar
ar
ar
ar
ar
ar
ar
ar
ar
ar
ar
ar
ar
ar
ar
ar
ar
ar
ar
"}
(65,1,1) = {"
ar
ar
aX
ar
ar
ar
ar
ar
ar
ar
ar
ar
ar
ar
ar
ar
ar
ar
ar
ar
ar
ar
ar
ar
ar
ar
ar
ar
ar
ar
ar
ar
ar
ar
ar
ar
ar
ar
ar
ar
ar
ar
"}
(66,1,1) = {"
aN
ar
az
az
az
az
az
az
az
az
az
az
az
az
az
az
az
az
az
az
az
az
az
az
az
az
az
az
az
az
az
az
az
az
az
az
az
az
az
az
az
az
"}
