//MAP CONVERTED BY dmm2tgm.py THIS HEADER COMMENT PREVENTS RECONVERSION, DO NOT REMOVE
"a" = (
/turf/open/space/basic,
/area/space)
"c" = (
/obj/effect/landmark/weed_node,
/turf/open/floor/plating/ground/mars/random/cave/rock,
/area/bigredv2/caves/southeast)
"e" = (
/obj/machinery/miner/damaged/platinum,
/turf/open/floor/plating/ground/mars/random/cave,
/area/bigredv2/caves/southeast)
"h" = (
/obj/docking_port/stationary/crashmode,
/turf/closed/mineral/bigred,
/area/bigredv2/caves/rock)
"i" = (
/obj/effect/landmark/start/job/xenomorph,
/turf/open/floor/plating/ground/mars/random/cave,
/area/bigredv2/caves/southeast)
"k" = (
/obj/effect/landmark/patrol_point{
	id = "TGMC_12";
	name = "TGMC exit point 12"
	},
/turf/open/floor/plating/ground/mars/random/cave,
/area/bigredv2/caves/southeast)
"l" = (
/obj/effect/landmark/patrol_point{
	id = "TGMC_13";
	name = "TGMC exit point 13"
	},
/turf/open/floor/plating/ground/mars/random/cave,
/area/bigredv2/caves/southeast)
"m" = (
/obj/effect/landmark/excavation_site_spawner,
/turf/open/floor/plating/ground/mars/random/cave,
/area/bigredv2/caves/southeast)
"n" = (
/obj/effect/landmark/xeno_resin_door,
/turf/open/floor/plating/ground/mars/random/cave,
/area/bigredv2/caves/southeast)
"q" = (
/obj/effect/landmark/lv624/fog_blocker/xeno_spawn,
/turf/open/floor/plating/ground/mars/random/cave,
/area/bigredv2/caves/southeast)
"r" = (
/obj/effect/landmark/weed_node,
/obj/effect/ai_node,
/turf/open/floor/plating/ground/mars/random/cave,
/area/bigredv2/caves/southeast)
"s" = (
/obj/effect/landmark/lv624/fog_blocker/xeno_spawn,
/turf/closed/mineral/bigred,
/area/bigredv2/caves/rock)
"t" = (
/obj/effect/landmark/xeno_resin_door,
/turf/open/floor/plating/ground/mars/random/cave/rock,
/area/bigredv2/caves/southeast)
"w" = (
/turf/open/floor/plating/ground/mars/random/cave,
/area/bigredv2/caves/southeast)
"x" = (
/turf/closed/mineral/bigred,
/area/bigredv2/caves/rock)
"y" = (
/turf/open/floor/plating/ground/mars/random/cave,
/area/bigredv2/caves/east)
"A" = (
/obj/effect/landmark/start/job/xenomorph,
/obj/effect/landmark/weed_node,
/turf/open/floor/plating/ground/mars/random/cave,
/area/bigredv2/caves/southeast)
"C" = (
/obj/effect/landmark/xeno_resin_wall,
/turf/open/floor/plating/ground/mars/random/cave,
/area/bigredv2/caves/southeast)
"E" = (
/obj/effect/landmark/patrol_point{
	id = "TGMC_11";
	name = "TGMC exit point 11"
	},
/turf/open/floor/plating/ground/mars/random/cave,
/area/bigredv2/caves/southeast)
"J" = (
/turf/closed/wall/indestructible/mineral,
/area/space)
"L" = (
/obj/effect/landmark/patrol_point{
	id = "TGMC_14";
	name = "TGMC exit point 14"
	},
/turf/open/floor/plating/ground/mars/random/cave,
/area/bigredv2/caves/southeast)
"N" = (
/obj/effect/ai_node,
/turf/open/floor/plating/ground/mars/random/cave/rock,
/area/bigredv2/caves/southeast)
"P" = (
/obj/effect/landmark/weed_node,
/turf/open/floor/plating/ground/mars/random/cave,
/area/bigredv2/caves/southeast)
"S" = (
/obj/effect/landmark/xeno_silo_spawn,
/turf/open/floor/plating/ground/mars/random/cave,
/area/bigredv2/caves/southeast)
"X" = (
/turf/open/floor/plating/ground/mars/random/cave/rock,
/area/bigredv2/caves/southeast)
"Z" = (
/obj/effect/ai_node,
/turf/open/floor/plating/ground/mars/random/cave,
/area/bigredv2/caves/southeast)

(1,1,1) = {"
x
x
x
x
x
x
x
x
x
x
x
x
x
x
x
x
w
w
w
w
w
P
X
x
x
x
x
x
x
x
x
w
w
w
w
w
w
x
x
x
x
x
x
x
x
x
x
x
x
x
n
n
n
n
x
x
x
x
x
x
x
x
x
x
J
J
a
"}
(2,1,1) = {"
y
x
x
x
x
x
x
x
x
x
x
x
x
x
X
X
w
w
w
x
w
w
X
x
x
x
x
x
x
x
x
n
n
n
n
n
x
x
x
x
x
x
x
x
x
x
x
x
x
x
w
P
w
w
x
x
x
x
x
x
x
x
x
x
x
J
a
"}
(3,1,1) = {"
x
x
x
x
x
x
x
x
x
x
x
x
x
x
w
w
w
w
w
x
X
w
X
x
x
x
x
x
x
x
x
w
w
w
w
w
x
x
x
x
x
x
x
x
x
x
x
x
x
x
w
w
w
w
x
x
x
x
x
x
x
x
x
x
x
J
a
"}
(4,1,1) = {"
x
x
x
x
x
x
x
x
x
x
x
x
x
N
w
w
r
w
x
x
x
w
X
x
x
x
x
x
x
x
x
w
w
i
w
w
x
x
x
x
x
x
x
x
x
x
x
x
x
x
w
w
w
w
x
x
x
x
x
x
x
x
x
x
x
J
a
"}
(5,1,1) = {"
x
x
x
x
x
x
x
x
x
x
x
x
x
w
P
X
w
w
x
x
x
w
X
x
x
x
x
x
x
x
x
w
w
w
w
w
x
x
x
x
x
x
x
x
x
x
x
x
x
x
w
w
Z
P
x
x
x
x
x
x
x
x
x
x
x
J
a
"}
(6,1,1) = {"
x
x
x
x
x
x
x
x
x
x
x
X
X
w
w
X
w
w
x
x
x
w
X
x
x
x
x
x
x
x
x
w
w
w
w
w
x
x
h
x
x
x
x
x
x
x
x
x
x
x
w
P
w
w
x
x
x
x
x
x
x
x
x
x
x
J
a
"}
(7,1,1) = {"
x
x
x
x
x
x
x
x
x
x
x
w
w
w
X
w
w
x
x
x
x
w
X
x
x
x
x
x
x
x
x
w
w
P
w
w
x
x
x
x
x
x
x
x
x
x
x
x
x
x
w
w
w
w
x
x
x
x
x
x
x
x
x
x
x
J
a
"}
(8,1,1) = {"
x
x
x
x
x
x
x
x
x
x
x
w
w
r
w
x
x
x
x
x
x
w
X
x
x
x
x
x
x
x
x
w
w
w
w
w
x
x
x
x
x
x
x
x
x
x
x
x
x
x
w
w
w
w
x
x
x
x
x
x
x
x
x
x
x
J
a
"}
(9,1,1) = {"
x
x
x
x
x
x
x
x
x
x
x
w
N
w
w
x
x
x
x
x
x
w
X
x
x
x
x
x
x
x
x
w
w
P
w
w
x
x
x
x
x
x
x
x
x
x
x
x
x
x
w
w
w
w
x
x
x
x
x
x
x
x
x
x
x
J
a
"}
(10,1,1) = {"
x
x
x
x
x
x
x
x
x
x
X
w
X
w
w
x
x
x
x
w
w
Z
c
x
x
x
x
x
x
x
w
w
w
w
w
w
x
x
x
x
x
x
x
x
x
x
x
x
x
x
w
w
P
w
x
x
x
x
x
x
x
x
x
x
x
J
a
"}
(11,1,1) = {"
x
x
x
x
x
x
x
x
x
x
w
w
X
m
X
X
X
X
X
w
w
w
X
x
x
x
x
x
x
w
w
w
w
Z
w
w
w
x
x
x
x
x
x
x
x
x
x
x
x
x
w
w
w
w
x
x
x
x
x
x
x
x
x
x
x
J
a
"}
(12,1,1) = {"
h
x
x
x
x
x
x
x
x
x
w
A
w
X
w
w
w
w
X
w
P
w
x
x
x
x
x
w
Z
w
w
w
Z
w
w
w
w
x
x
x
x
x
x
x
x
x
x
x
x
x
w
P
w
x
x
x
x
x
x
x
x
x
x
x
x
J
a
"}
(13,1,1) = {"
x
x
x
x
x
x
x
x
x
x
w
w
w
w
w
P
Z
w
P
w
w
w
x
x
x
x
x
w
w
w
w
w
P
w
w
w
w
x
x
x
x
x
x
x
x
x
x
x
x
w
w
w
w
x
x
x
x
x
x
x
x
x
x
x
x
J
a
"}
(14,1,1) = {"
X
w
x
x
x
x
x
x
x
X
w
w
w
w
w
w
w
w
w
w
w
X
x
x
x
x
x
w
P
w
w
w
w
w
w
w
w
w
w
x
x
x
x
x
x
x
x
x
x
w
w
w
Z
x
x
x
x
x
x
x
x
x
x
x
x
J
a
"}
(15,1,1) = {"
X
x
x
x
x
x
x
x
x
w
Z
w
Z
P
w
w
Z
w
w
X
x
x
x
x
x
w
w
w
w
w
w
w
w
w
w
w
P
w
w
w
w
x
x
x
x
x
x
x
w
w
w
Z
w
x
x
x
x
x
x
x
x
x
x
x
x
J
a
"}
(16,1,1) = {"
X
x
x
x
x
x
x
X
X
w
X
w
w
w
w
w
w
w
w
w
w
x
x
x
x
w
w
w
w
w
m
w
w
P
w
w
w
w
w
w
w
w
w
w
w
x
x
x
w
w
w
w
w
x
x
x
x
x
x
x
x
x
x
x
x
J
a
"}
(17,1,1) = {"
w
x
x
x
x
x
x
w
w
w
X
w
w
w
x
x
x
t
n
n
n
x
x
x
x
w
w
w
P
w
w
w
w
w
w
w
w
P
w
w
w
w
w
w
w
w
w
w
w
P
w
w
x
x
x
x
x
x
x
x
x
x
x
x
x
J
a
"}
(18,1,1) = {"
w
x
x
x
x
x
x
X
w
X
w
w
w
x
x
x
x
x
w
w
Z
w
w
P
P
w
w
w
w
w
P
w
w
w
w
w
w
w
w
w
w
P
w
P
w
w
w
w
w
w
w
w
x
x
x
x
x
x
x
x
x
x
x
x
x
J
J
"}
(19,1,1) = {"
w
x
x
x
x
x
w
w
w
X
w
x
x
x
x
x
x
x
x
x
w
w
w
w
w
w
w
w
Z
w
w
w
w
Z
w
w
w
w
w
w
w
w
Z
w
w
w
w
e
w
Z
w
Z
x
x
x
x
x
x
x
x
x
x
x
x
x
x
J
"}
(20,1,1) = {"
w
x
x
w
w
w
Z
w
w
w
Z
x
x
x
x
x
x
x
x
x
w
w
w
P
w
w
w
w
w
w
P
w
w
w
w
w
w
w
w
w
P
w
w
w
w
w
P
w
w
w
w
w
x
x
x
x
x
x
x
x
x
x
x
x
x
x
J
"}
(21,1,1) = {"
w
w
w
w
w
w
w
w
X
w
x
x
x
x
x
x
x
x
x
x
Z
w
w
w
Z
w
P
w
Z
w
w
w
w
w
w
x
x
w
w
w
w
w
w
w
w
w
w
w
w
w
w
x
x
x
x
x
x
x
x
x
x
x
x
x
x
x
J
"}
(22,1,1) = {"
w
w
w
w
X
X
w
w
w
w
x
x
x
x
x
x
x
x
x
x
x
w
w
w
w
w
w
w
w
w
e
w
w
w
x
x
x
x
x
w
w
w
w
w
P
w
w
w
w
w
w
x
x
x
x
x
x
x
x
x
x
x
x
x
x
x
J
"}
(23,1,1) = {"
e
Z
w
X
w
w
Z
w
w
x
x
x
x
x
x
x
x
x
x
x
x
x
x
x
x
x
x
x
w
w
w
w
w
x
x
x
x
x
x
x
w
w
w
w
w
w
w
w
w
w
w
x
x
x
x
x
x
x
x
x
x
x
x
x
x
x
J
"}
(24,1,1) = {"
w
X
c
w
w
w
w
X
x
x
x
x
x
x
x
x
x
x
x
x
x
x
x
x
x
x
x
x
x
x
x
x
x
x
x
x
x
x
x
x
w
P
w
w
w
w
m
w
P
w
w
w
x
x
x
x
x
x
x
x
x
x
x
x
x
x
J
"}
(25,1,1) = {"
X
w
w
X
x
x
x
x
x
x
x
x
x
x
x
x
x
x
x
x
x
x
x
x
x
x
x
x
x
x
x
x
x
x
x
x
x
x
x
x
w
w
w
w
w
w
w
w
w
w
w
w
x
x
x
x
x
x
x
x
x
x
x
x
x
x
J
"}
(26,1,1) = {"
w
w
w
X
x
x
x
x
x
x
x
x
x
x
x
x
x
x
x
x
x
x
x
x
x
x
x
x
x
x
x
x
x
x
x
x
x
x
x
x
w
w
w
w
w
P
w
w
w
w
P
w
x
x
x
x
x
x
x
x
x
x
x
x
x
x
J
"}
(27,1,1) = {"
x
x
x
x
x
x
x
x
x
x
x
x
x
x
x
x
x
x
x
x
x
x
x
x
x
x
x
x
x
x
x
x
x
x
x
x
x
x
x
w
w
w
P
w
w
w
w
w
w
w
w
w
x
x
x
x
x
x
x
x
x
x
x
x
x
x
J
"}
(28,1,1) = {"
x
x
x
x
x
x
x
x
x
x
x
x
x
x
x
x
x
x
x
x
x
x
x
x
x
x
x
x
x
x
x
x
x
x
x
x
x
x
w
P
w
w
w
w
w
w
w
w
w
x
x
x
x
x
x
x
x
x
x
x
x
x
x
x
x
x
J
"}
(29,1,1) = {"
x
x
x
x
x
x
x
x
x
x
x
x
x
x
x
x
x
x
x
x
x
x
x
x
x
x
x
x
x
x
x
x
x
x
x
x
x
w
w
w
w
w
w
P
w
w
w
w
x
x
x
x
x
x
x
x
x
x
x
x
x
x
x
x
x
x
J
"}
(30,1,1) = {"
x
x
x
x
x
x
x
x
x
x
x
x
x
x
x
x
x
x
x
x
x
x
x
x
x
x
x
x
x
x
x
x
x
x
x
x
l
w
w
w
w
w
w
w
w
w
w
w
x
x
x
x
x
x
x
x
x
x
x
x
x
x
x
x
x
x
J
"}
(31,1,1) = {"
x
x
x
x
x
x
x
x
x
x
x
x
x
x
x
x
x
x
x
x
x
x
x
x
x
x
x
x
x
x
x
x
x
x
x
x
w
w
w
w
w
w
w
w
w
w
P
w
x
x
x
x
x
x
x
x
x
x
x
x
x
x
x
x
x
x
J
"}
(32,1,1) = {"
w
w
x
x
x
x
x
x
x
x
x
x
x
x
x
x
x
x
x
x
x
x
x
x
x
x
x
x
x
x
x
x
x
w
w
w
w
w
P
w
q
q
q
q
q
q
q
q
s
s
s
s
x
x
x
x
x
x
x
x
x
x
x
x
x
x
J
"}
(33,1,1) = {"
w
w
P
w
Z
w
w
x
x
x
x
x
x
x
x
x
x
x
x
x
x
x
x
x
x
x
x
x
x
x
x
x
w
w
w
w
w
w
w
w
q
w
P
w
w
w
w
w
k
x
x
s
x
x
x
x
x
x
x
x
x
x
x
x
x
x
J
"}
(34,1,1) = {"
w
w
w
w
w
w
w
w
w
x
x
x
x
x
x
x
x
x
x
x
x
x
x
x
x
x
x
x
x
x
x
w
w
w
P
w
w
P
w
w
q
w
w
w
w
w
w
P
w
x
x
s
x
x
x
x
x
x
x
x
x
x
x
x
x
x
J
"}
(35,1,1) = {"
w
P
w
w
w
w
w
w
w
w
w
x
x
x
x
x
x
x
x
x
x
x
x
x
x
x
x
x
x
w
w
w
w
w
w
w
w
w
w
w
q
w
w
P
C
C
C
n
n
C
x
s
x
x
x
x
x
x
x
x
x
x
x
x
x
x
J
"}
(36,1,1) = {"
w
w
w
w
w
w
w
w
w
w
w
w
w
w
x
x
x
x
x
x
x
x
x
x
x
x
x
w
w
w
w
w
w
w
w
w
w
w
w
w
q
w
w
w
n
w
w
w
w
w
x
s
x
x
x
x
x
x
x
x
x
x
x
x
x
x
J
"}
(37,1,1) = {"
w
w
w
w
Z
P
w
Z
w
w
w
P
w
w
w
w
w
w
x
x
x
x
x
x
x
w
w
w
w
w
w
P
w
w
w
w
w
w
w
w
q
w
w
w
n
P
w
w
P
w
w
s
x
x
x
x
x
x
x
x
x
x
x
x
x
x
J
"}
(38,1,1) = {"
x
x
w
w
w
w
w
w
w
w
w
w
w
w
w
w
w
w
w
w
x
x
x
w
P
w
w
w
w
w
w
w
w
w
w
w
w
w
w
w
q
P
w
w
n
w
w
w
w
w
P
s
x
x
x
x
x
x
x
x
x
x
x
J
J
J
J
"}
(39,1,1) = {"
x
x
w
w
w
w
w
Z
w
w
w
w
w
w
Z
w
w
w
w
P
w
x
w
w
w
w
w
w
P
w
w
w
w
e
w
w
w
P
w
w
q
w
w
w
C
w
w
w
S
w
w
s
x
x
x
x
x
x
x
x
x
x
x
J
a
a
a
"}
(40,1,1) = {"
x
x
w
w
w
w
w
w
w
w
w
w
w
w
w
w
w
w
w
w
w
w
w
w
w
w
w
w
w
w
w
w
w
w
w
w
w
w
w
w
q
w
w
C
C
w
P
w
w
w
w
s
x
x
x
x
x
x
x
x
x
x
x
J
a
a
a
"}
(41,1,1) = {"
w
w
w
w
w
w
w
w
w
w
P
w
w
w
w
w
P
w
w
w
w
w
w
w
w
w
w
w
w
w
P
w
w
w
w
w
w
w
w
w
q
w
x
C
w
w
w
w
w
P
w
s
x
x
x
x
x
x
x
x
x
x
x
J
a
a
a
"}
(42,1,1) = {"
w
w
w
w
w
w
w
w
w
w
w
w
w
w
w
w
w
w
w
w
w
w
w
m
w
w
w
w
w
w
w
w
w
w
w
w
P
w
w
w
s
x
x
x
w
P
Z
w
r
w
w
s
x
x
x
x
x
x
x
x
x
x
x
J
a
a
a
"}
(43,1,1) = {"
w
w
w
P
w
w
w
w
w
w
w
w
w
w
w
e
w
w
w
w
w
P
w
w
w
w
w
w
w
w
w
w
w
P
w
w
w
w
x
x
s
x
x
x
w
w
w
w
P
w
x
s
x
x
x
x
x
x
x
x
x
x
x
J
a
a
a
"}
(44,1,1) = {"
w
w
w
w
w
w
w
P
w
w
w
w
P
w
w
w
w
w
w
w
w
w
w
w
w
w
P
w
w
w
w
w
w
w
L
w
x
x
x
x
s
x
x
x
w
P
w
w
w
x
x
s
x
x
x
x
x
x
x
x
x
x
x
J
a
a
a
"}
(45,1,1) = {"
w
Z
w
w
w
w
m
Z
w
w
w
w
w
w
r
w
w
w
w
w
w
w
w
w
w
w
w
w
w
w
w
w
w
w
x
x
x
x
x
x
s
x
x
x
x
E
w
w
x
x
x
s
x
x
x
x
x
x
x
x
x
x
x
J
a
a
a
"}
(46,1,1) = {"
w
w
w
w
w
w
w
w
w
w
w
w
w
w
w
w
w
w
w
P
w
w
w
w
w
w
w
w
w
w
P
w
w
w
x
x
x
x
x
x
s
x
x
x
x
x
x
x
x
x
x
s
x
x
x
x
x
x
x
x
x
x
x
J
a
a
a
"}
(47,1,1) = {"
w
w
P
w
w
P
w
P
w
w
w
w
w
w
w
w
w
w
P
w
w
w
w
w
w
w
w
w
w
w
w
w
w
w
x
x
x
x
x
x
s
x
x
x
x
x
x
x
x
x
x
s
x
x
x
x
x
x
x
x
x
x
x
J
a
a
a
"}
(48,1,1) = {"
w
w
w
w
w
w
w
w
w
w
w
w
w
w
w
w
w
w
w
w
w
w
w
w
w
w
w
w
w
w
w
w
w
x
x
x
x
x
x
x
s
s
s
s
s
s
s
s
s
s
s
s
x
x
x
x
x
x
x
x
x
x
x
J
a
a
a
"}
(49,1,1) = {"
w
Z
w
w
w
w
w
w
x
x
x
x
x
x
x
w
w
w
w
w
w
w
w
w
P
w
w
w
w
w
w
w
w
x
x
x
x
x
x
x
x
x
x
x
x
x
x
x
x
x
x
x
x
x
x
x
x
x
x
x
x
x
x
J
a
a
a
"}
(50,1,1) = {"
w
w
w
x
x
x
x
x
x
x
x
x
x
x
x
x
x
w
w
w
P
w
w
w
w
w
w
w
P
w
w
x
x
x
x
x
x
x
x
x
x
x
x
x
x
x
x
x
x
x
x
x
x
x
x
x
x
x
x
x
x
x
x
J
a
a
a
"}
(51,1,1) = {"
w
w
w
x
x
x
x
x
x
x
x
x
x
x
x
x
x
x
x
w
w
w
w
w
w
w
w
w
w
w
x
x
x
x
x
x
x
x
x
x
x
x
x
x
x
x
x
x
x
x
x
x
x
x
x
x
x
x
x
x
x
x
x
J
a
a
a
"}
(52,1,1) = {"
x
x
x
x
x
x
x
x
x
x
x
x
x
x
x
x
x
x
x
x
x
x
x
x
x
x
x
x
x
x
x
x
x
x
x
x
x
x
x
x
x
x
x
x
x
x
x
x
x
x
x
x
x
x
x
x
x
x
x
x
x
x
x
J
a
a
a
"}
(53,1,1) = {"
x
x
x
x
x
x
x
x
x
x
x
x
x
x
x
x
x
x
x
x
x
x
x
x
x
x
x
x
x
x
x
x
x
x
x
x
x
x
x
x
x
x
x
x
x
x
x
x
x
x
x
x
x
x
x
x
x
x
x
x
x
x
x
J
a
a
a
"}
(54,1,1) = {"
x
x
x
x
x
x
x
x
x
x
x
x
x
x
x
x
x
x
x
x
x
x
x
x
x
x
x
x
x
x
x
x
x
x
x
x
x
x
x
x
x
x
x
x
x
x
x
x
x
x
x
x
x
x
x
x
x
x
x
x
x
x
x
J
a
a
a
"}
(55,1,1) = {"
x
x
x
x
x
x
x
x
x
x
x
x
x
x
x
x
x
x
x
x
x
x
x
x
x
x
x
x
x
x
x
x
x
x
x
x
x
x
x
x
x
x
x
x
x
x
x
x
x
x
x
x
x
x
x
x
x
x
x
x
x
x
x
J
a
a
a
"}
(56,1,1) = {"
x
x
x
x
x
x
x
x
x
x
x
x
x
x
x
x
x
x
x
x
x
x
x
x
x
x
x
x
x
x
x
x
x
x
x
x
x
x
x
x
x
x
x
x
x
x
x
x
x
x
x
x
x
x
x
x
x
x
x
x
x
x
x
J
a
a
a
"}
(57,1,1) = {"
x
x
x
x
x
x
x
x
x
x
x
x
x
x
x
x
x
x
x
x
x
x
x
x
x
x
x
x
x
x
x
x
x
x
x
x
x
x
x
x
x
x
x
x
x
x
x
x
x
x
x
x
x
x
x
x
x
x
x
x
x
x
x
J
a
a
a
"}
(58,1,1) = {"
x
x
x
x
x
x
x
x
x
x
x
x
x
x
x
x
x
x
x
x
x
x
x
x
x
x
x
x
x
x
x
x
x
x
x
x
x
x
x
x
x
x
x
x
x
x
x
x
x
x
x
x
x
x
x
x
x
x
x
x
x
x
x
J
a
a
a
"}
(59,1,1) = {"
x
x
x
x
x
x
x
x
x
x
x
x
x
x
x
x
x
x
x
x
x
x
x
x
x
x
x
x
x
x
x
x
x
x
x
x
x
x
x
x
x
x
x
x
x
x
x
x
x
x
x
x
x
x
x
x
x
x
x
x
x
x
x
J
a
a
a
"}
(60,1,1) = {"
x
x
x
x
x
x
x
x
x
x
x
x
x
x
x
x
x
x
x
x
x
x
x
x
x
x
x
x
x
x
x
x
x
x
x
x
x
x
x
x
x
x
x
x
x
x
x
x
x
x
x
x
x
x
x
x
x
x
x
x
x
x
x
J
a
a
a
"}
(61,1,1) = {"
x
x
x
x
x
x
x
x
x
x
x
x
x
x
x
x
x
x
x
x
x
x
x
x
x
x
x
x
x
x
x
x
x
x
x
x
x
x
x
x
x
x
x
x
x
x
x
x
x
x
x
x
x
x
x
x
x
x
x
x
x
x
x
J
a
a
a
"}
(62,1,1) = {"
x
x
x
x
x
x
x
x
x
x
x
x
x
x
x
x
x
x
x
x
x
x
x
x
x
x
x
x
x
x
x
x
x
x
x
x
x
x
x
x
x
x
x
x
x
x
x
x
x
x
x
x
x
x
x
x
x
x
x
x
x
x
x
J
a
a
a
"}
(63,1,1) = {"
J
J
J
J
J
J
J
J
J
J
J
J
J
J
J
J
J
J
J
J
J
J
J
J
J
J
J
J
J
J
J
J
J
J
J
J
J
J
J
J
J
J
J
J
J
J
J
J
J
J
J
J
J
J
J
J
J
J
J
J
J
J
J
J
a
a
a
"}
(64,1,1) = {"
a
a
a
a
a
a
a
a
a
a
a
a
a
a
a
a
a
a
a
a
a
a
a
a
a
a
a
a
a
a
a
a
a
a
a
a
a
a
a
a
a
a
a
a
a
a
a
a
a
a
a
a
a
a
a
a
a
a
a
a
a
a
a
a
a
a
a
"}
(65,1,1) = {"
a
a
a
a
a
a
a
a
a
a
a
a
a
a
a
a
a
a
a
a
a
a
a
a
a
a
a
a
a
a
a
a
a
a
a
a
a
a
a
a
a
a
a
a
a
a
a
a
a
a
a
a
a
a
a
a
a
a
a
a
a
a
a
a
a
a
a
"}
(66,1,1) = {"
a
a
a
a
a
a
a
a
a
a
a
a
a
a
a
a
a
a
a
a
a
a
a
a
a
a
a
a
a
a
a
a
a
a
a
a
a
a
a
a
a
a
a
a
a
a
a
a
a
a
a
a
a
a
a
a
a
a
a
a
a
a
a
a
a
a
a
"}
(67,1,1) = {"
a
a
a
a
a
a
a
a
a
a
a
a
a
a
a
a
a
a
a
a
a
a
a
a
a
a
a
a
a
a
a
a
a
a
a
a
a
a
a
a
a
a
a
a
a
a
a
a
a
a
a
a
a
a
a
a
a
a
a
a
a
a
a
a
a
a
a
"}
(68,1,1) = {"
a
a
a
a
a
a
a
a
a
a
a
a
a
a
a
a
a
a
a
a
a
a
a
a
a
a
a
a
a
a
a
a
a
a
a
a
a
a
a
a
a
a
a
a
a
a
a
a
a
a
a
a
a
a
a
a
a
a
a
a
a
a
a
a
a
a
a
"}
(69,1,1) = {"
a
a
a
a
a
a
a
a
a
a
a
a
a
a
a
a
a
a
a
a
a
a
a
a
a
a
a
a
a
a
a
a
a
a
a
a
a
a
a
a
a
a
a
a
a
a
a
a
a
a
a
a
a
a
a
a
a
a
a
a
a
a
a
a
a
a
a
"}
(70,1,1) = {"
a
a
a
a
a
a
a
a
a
a
a
a
a
a
a
a
a
a
a
a
a
a
a
a
a
a
a
a
a
a
a
a
a
a
a
a
a
a
a
a
a
a
a
a
a
a
a
a
a
a
a
a
a
a
a
a
a
a
a
a
a
a
a
a
a
a
a
"}
(71,1,1) = {"
a
a
a
a
a
a
a
a
a
a
a
a
a
a
a
a
a
a
a
a
a
a
a
a
a
a
a
a
a
a
a
a
a
a
a
a
a
a
a
a
a
a
a
a
a
a
a
a
a
a
a
a
a
a
a
a
a
a
a
a
a
a
a
a
a
a
a
"}
