//MAP CONVERTED BY dmm2tgm.py THIS HEADER COMMENT PREVENTS RECONVERSION, DO NOT REMOVE
"a" = (
/turf/closed/mineral/smooth/bigred,
/area/bigredv2/caves/rock)
"b" = (
/obj/effect/landmark/weed_node,
/obj/effect/ai_node,
/turf/open/floor/plating/ground/mars/random/cave,
/area/bigredv2/caves/south)
"d" = (
/obj/effect/landmark/lv624/fog_blocker,
/obj/effect/landmark/weed_node,
/turf/open/floor/plating/ground/mars/random/cave/rock,
/area/bigredv2/caves/southwest)
"f" = (
/obj/effect/landmark/lv624/fog_blocker,
/turf/open/floor/plating/ground/mars/random/cave,
/area/bigredv2/caves/southwest)
"j" = (
/obj/effect/landmark/weed_node,
/turf/open/floor/plating/ground/mars/random/cave,
/area/bigredv2/caves/southwest)
"k" = (
/turf/open/floor/plating/ground/mars/random/cave/rock,
/area/bigredv2/caves/south)
"n" = (
/obj/effect/landmark/weed_node,
/turf/open/floor/plating/ground/mars/random/cave/rock,
/area/bigredv2/caves/southwest)
"o" = (
/obj/effect/ai_node,
/turf/open/floor/plating/ground/mars/random/cave,
/area/bigredv2/caves/southwest)
"p" = (
/obj/effect/ai_node,
/turf/open/floor/plating/ground/mars/random/cave/rock,
/area/bigredv2/caves/south)
"q" = (
/turf/open/floor/plating/ground/mars/random/cave/rock,
/area/bigredv2/caves/southwest)
"u" = (
/turf/open/floor/plating/ground/mars/random/cave,
/area/bigredv2/caves/south)
"A" = (
/turf/open/floor/plating,
/area/bigredv2/caves/south)
"E" = (
/obj/effect/landmark/weed_node,
/turf/open/floor/plating/ground/mars/random/cave,
/area/bigredv2/caves/south)
"F" = (
/obj/effect/ai_node,
/turf/open/floor/plating/ground/mars/random/cave,
/area/bigredv2/caves/south)
"J" = (
/obj/effect/landmark/excavation_site_spawner,
/turf/open/floor/plating/ground/mars/random/cave,
/area/bigredv2/caves/south)
"N" = (
/obj/effect/landmark/weed_node,
/turf/open/floor/plating/ground/mars/random/cave/rock,
/area/bigredv2/caves/south)
"Q" = (
/obj/effect/landmark/lv624/fog_blocker,
/turf/closed/mineral/smooth/bigred,
/area/bigredv2/caves/rock)
"V" = (
/turf/open/floor/plating/ground/mars/random/cave,
/area/bigredv2/caves/southwest)
"X" = (
/obj/effect/ai_node,
/turf/open/floor/plating/ground/mars/random/cave/rock,
/area/bigredv2/caves/southwest)
"Y" = (
/obj/machinery/miner/damaged/platinum,
/turf/open/floor/plating/ground/mars/random/cave,
/area/bigredv2/caves/south)

(1,1,1) = {"
Q
a
a
a
a
a
q
V
V
V
q
a
a
a
a
V
j
a
a
a
a
a
"}
(2,1,1) = {"
f
a
a
a
a
a
a
V
o
j
q
a
a
a
a
V
V
V
a
a
a
a
"}
(3,1,1) = {"
f
a
a
a
a
a
a
V
V
V
q
a
a
a
q
V
V
a
a
a
a
a
"}
(4,1,1) = {"
f
a
a
a
a
a
V
V
j
V
q
a
a
a
q
V
j
a
a
a
a
a
"}
(5,1,1) = {"
f
q
a
a
a
a
V
V
V
V
V
a
a
q
V
V
V
a
a
a
a
a
"}
(6,1,1) = {"
f
q
a
a
q
q
V
j
V
V
V
a
a
V
j
o
a
a
a
a
a
a
"}
(7,1,1) = {"
f
j
q
X
V
V
V
V
o
V
a
a
a
V
o
a
a
a
a
a
a
a
"}
(8,1,1) = {"
f
V
V
q
V
V
V
V
V
a
a
a
V
j
V
a
a
a
a
a
a
a
"}
(9,1,1) = {"
f
n
V
V
j
V
V
a
a
a
a
a
V
V
V
a
a
a
a
a
a
a
"}
(10,1,1) = {"
d
V
V
o
a
a
a
a
a
a
a
a
V
V
V
a
a
V
a
a
a
a
"}
(11,1,1) = {"
Q
a
a
a
a
a
a
a
a
a
a
a
V
j
V
V
V
V
a
a
a
a
"}
(12,1,1) = {"
a
Q
a
a
a
a
a
a
a
a
a
a
V
V
V
V
j
V
a
a
a
a
"}
(13,1,1) = {"
a
a
Q
Q
a
a
a
a
a
a
a
a
V
V
j
V
V
a
a
a
a
a
"}
(14,1,1) = {"
a
a
a
a
Q
a
a
a
a
a
a
a
V
V
V
V
a
a
a
a
a
a
"}
(15,1,1) = {"
a
a
a
a
a
Q
a
a
a
a
a
a
a
V
V
q
a
a
a
a
a
a
"}
(16,1,1) = {"
a
a
a
a
a
a
Q
a
a
a
a
a
a
V
o
q
q
a
a
a
a
a
"}
(17,1,1) = {"
V
a
a
a
a
a
Q
a
a
a
a
a
a
V
n
q
a
a
a
a
a
a
"}
(18,1,1) = {"
j
o
a
a
a
a
Q
a
a
a
a
a
a
V
V
V
a
a
a
a
a
a
"}
(19,1,1) = {"
V
V
a
a
a
a
Q
a
a
a
a
a
V
V
V
V
V
a
a
a
a
a
"}
(20,1,1) = {"
q
V
a
a
a
a
Q
a
a
a
V
V
V
V
j
q
j
a
a
a
a
a
"}
(21,1,1) = {"
q
V
V
a
a
a
Q
a
a
a
V
V
V
V
V
q
V
a
a
a
a
a
"}
(22,1,1) = {"
j
V
V
V
j
a
Q
a
a
a
j
V
V
V
V
a
a
a
a
a
a
a
"}
(23,1,1) = {"
V
V
V
V
V
a
Q
a
a
a
V
V
j
V
V
a
a
a
a
a
a
a
"}
(24,1,1) = {"
V
V
V
V
V
a
Q
a
a
a
V
V
V
V
V
a
a
a
a
a
a
a
"}
(25,1,1) = {"
V
V
V
V
V
a
Q
a
a
V
V
q
j
V
o
V
a
a
a
a
a
a
"}
(26,1,1) = {"
E
u
u
u
E
a
Q
a
a
u
u
u
u
k
u
J
a
a
a
a
a
a
"}
(27,1,1) = {"
u
F
u
u
u
a
Q
a
a
a
a
a
u
u
u
E
u
a
a
a
a
a
"}
(28,1,1) = {"
k
u
u
u
u
a
Q
a
a
a
a
a
a
u
u
u
u
u
u
a
a
a
"}
(29,1,1) = {"
k
E
u
u
u
a
Q
a
a
a
a
a
a
u
F
N
u
F
u
u
a
a
"}
(30,1,1) = {"
u
u
u
u
E
a
Q
a
a
a
a
a
a
a
u
u
u
u
E
u
u
a
"}
(31,1,1) = {"
u
u
E
u
u
a
Q
a
a
a
a
a
a
a
a
u
u
u
u
u
u
a
"}
(32,1,1) = {"
u
u
u
u
u
a
Q
a
a
a
a
a
a
a
a
u
u
E
u
u
u
u
"}
(33,1,1) = {"
u
u
u
u
u
a
Q
a
a
a
a
a
a
a
a
a
u
u
u
u
E
u
"}
(34,1,1) = {"
k
u
u
u
a
a
Q
a
a
a
a
a
a
a
a
a
a
F
u
u
F
u
"}
(35,1,1) = {"
k
u
E
u
a
a
Q
a
a
a
a
a
a
a
a
a
a
u
u
u
k
u
"}
(36,1,1) = {"
k
u
u
u
a
a
Q
a
a
a
a
a
a
a
a
a
a
a
u
E
u
u
"}
(37,1,1) = {"
u
u
u
u
a
a
Q
a
a
a
a
a
a
a
a
a
a
a
u
u
u
u
"}
(38,1,1) = {"
u
F
u
u
a
a
Q
a
a
a
a
a
a
a
a
a
a
E
u
u
u
u
"}
(39,1,1) = {"
u
u
E
a
a
a
Q
a
a
a
a
a
a
a
a
u
u
u
u
u
u
u
"}
(40,1,1) = {"
u
u
u
a
a
a
Q
a
a
a
a
a
a
a
E
u
u
u
Y
u
b
u
"}
(41,1,1) = {"
u
u
u
a
a
a
Q
a
a
a
a
a
a
u
u
u
u
u
p
u
u
F
"}
(42,1,1) = {"
u
u
a
a
a
a
Q
a
a
a
a
a
u
u
u
u
u
u
u
J
u
u
"}
(43,1,1) = {"
u
a
a
a
a
a
Q
a
a
a
a
u
F
u
k
b
u
u
F
N
a
a
"}
(44,1,1) = {"
a
a
a
a
a
a
Q
a
a
a
a
a
u
k
A
u
u
k
a
a
a
a
"}
