//MAP CONVERTED BY dmm2tgm.py THIS HEADER COMMENT PREVENTS RECONVERSION, DO NOT REMOVE
"a" = (
/turf/open/space/basic,
/area/space)
"b" = (
/atom/movable/effect/landmark/patrol_point{
	id = "TGMC_13";
	name = "TGMC exit point 13"
	},
/turf/open/floor/plating/ground/mars/random/cave,
/area/bigredv2/caves/southeast)
"d" = (
/atom/movable/effect/landmark/lv624/fog_blocker/xeno_spawn,
/turf/closed/mineral/smooth/bigred,
/area/bigredv2/caves/rock)
"e" = (
/obj/machinery/miner/damaged/platinum,
/turf/open/floor/plating/ground/mars/random/cave,
/area/bigredv2/caves/southeast)
"g" = (
/atom/movable/effect/landmark/patrol_point{
	id = "TGMC_11";
	name = "TGMC exit point 11"
	},
/turf/open/floor/plating/ground/mars/random/cave,
/area/bigredv2/caves/southeast)
"j" = (
/atom/movable/effect/landmark/lv624/fog_blocker/xeno_spawn,
/turf/open/floor/plating/ground/mars/random/cave,
/area/bigredv2/caves/southeast)
"o" = (
/atom/movable/effect/landmark/weed_node,
/turf/open/floor/plating/ground/mars/random/cave,
/area/bigredv2/caves/southeast)
"p" = (
/atom/movable/effect/landmark/xeno_resin_door,
/turf/open/floor/plating/ground/mars/random/cave,
/area/bigredv2/caves/southeast)
"u" = (
/atom/movable/effect/landmark/patrol_point{
	id = "TGMC_12";
	name = "TGMC exit point 12"
	},
/turf/open/floor/plating/ground/mars/random/cave,
/area/bigredv2/caves/southeast)
"v" = (
/turf/closed/mineral/smooth/bigred/indestructible,
/area/space)
"w" = (
/turf/open/floor/plating/ground/mars/random/cave,
/area/bigredv2/caves/southeast)
"y" = (
/turf/open/floor/plating/ground/mars/random/cave,
/area/bigredv2/caves/east)
"D" = (
/atom/movable/effect/landmark/start/job/xenomorph,
/turf/open/floor/plating/ground/mars/random/cave,
/area/bigredv2/caves/southeast)
"F" = (
/atom/movable/effect/ai_node,
/turf/open/floor/plating/ground/mars/random/cave,
/area/bigredv2/caves/southeast)
"G" = (
/atom/movable/effect/ai_node,
/turf/open/floor/plating/ground/mars/random/cave/rock,
/area/bigredv2/caves/southeast)
"H" = (
/atom/movable/effect/landmark/patrol_point{
	id = "TGMC_14";
	name = "TGMC exit point 14"
	},
/turf/open/floor/plating/ground/mars/random/cave,
/area/bigredv2/caves/southeast)
"I" = (
/obj/docking_port/stationary/crashmode,
/turf/closed/mineral/smooth/bigred,
/area/bigredv2/caves/rock)
"O" = (
/atom/movable/effect/landmark/excavation_site_spawner,
/turf/open/floor/plating/ground/mars/random/cave,
/area/bigredv2/caves/southeast)
"Q" = (
/atom/movable/effect/landmark/start/job/xenomorph,
/atom/movable/effect/landmark/weed_node,
/turf/open/floor/plating/ground/mars/random/cave,
/area/bigredv2/caves/southeast)
"R" = (
/atom/movable/effect/landmark/xeno_silo_spawn,
/turf/open/floor/plating/ground/mars/random/cave,
/area/bigredv2/caves/southeast)
"T" = (
/atom/movable/effect/landmark/xeno_resin_wall,
/turf/open/floor/plating/ground/mars/random/cave,
/area/bigredv2/caves/southeast)
"U" = (
/atom/movable/effect/landmark/weed_node,
/turf/open/floor/plating/ground/mars/random/cave/rock,
/area/bigredv2/caves/southeast)
"V" = (
/turf/closed/mineral/smooth/bigred,
/area/bigredv2/caves/rock)
"W" = (
/atom/movable/effect/landmark/xeno_resin_door,
/turf/open/floor/plating/ground/mars/random/cave/rock,
/area/bigredv2/caves/southeast)
"X" = (
/turf/open/floor/plating/ground/mars/random/cave/rock,
/area/bigredv2/caves/southeast)
"Y" = (
/atom/movable/effect/landmark/weed_node,
/atom/movable/effect/ai_node,
/turf/open/floor/plating/ground/mars/random/cave,
/area/bigredv2/caves/southeast)

(1,1,1) = {"
V
V
V
V
V
V
V
V
V
V
V
V
V
V
V
V
w
w
w
w
w
o
X
V
V
V
V
V
V
V
V
w
w
w
w
w
w
V
V
V
V
V
V
V
V
V
V
V
V
V
p
p
p
p
V
V
V
V
V
V
V
V
V
V
v
v
a
"}
(2,1,1) = {"
y
V
V
V
V
V
V
V
V
V
V
V
V
V
X
X
w
w
w
V
w
w
X
V
V
V
V
V
V
V
V
p
p
p
p
p
V
V
V
V
V
V
V
V
V
V
V
V
V
V
w
o
w
w
V
V
V
V
V
V
V
V
V
V
V
v
a
"}
(3,1,1) = {"
V
V
V
V
V
V
V
V
V
V
V
V
V
V
w
w
w
w
w
V
X
w
X
V
V
V
V
V
V
V
V
w
w
w
w
w
V
V
V
V
V
V
V
V
V
V
V
V
V
V
w
w
w
w
V
V
V
V
V
V
V
V
V
V
V
v
a
"}
(4,1,1) = {"
V
V
V
V
V
V
V
V
V
V
V
V
V
G
w
w
Y
w
V
V
V
w
X
V
V
V
V
V
V
V
V
w
w
D
w
w
V
V
V
V
V
V
V
V
V
V
V
V
V
V
w
w
w
w
V
V
V
V
V
V
V
V
V
V
V
v
a
"}
(5,1,1) = {"
V
V
V
V
V
V
V
V
V
V
V
V
V
w
o
X
w
w
V
V
V
w
X
V
V
V
V
V
V
V
V
w
w
w
w
w
V
V
V
V
V
V
V
V
V
V
V
V
V
V
w
w
F
o
V
V
V
V
V
V
V
V
V
V
V
v
a
"}
(6,1,1) = {"
V
V
V
V
V
V
V
V
V
V
V
X
X
w
w
X
w
w
V
V
V
w
X
V
V
V
V
V
V
V
V
w
w
w
w
w
V
V
I
V
V
V
V
V
V
V
V
V
V
V
w
o
w
w
V
V
V
V
V
V
V
V
V
V
V
v
a
"}
(7,1,1) = {"
V
V
V
V
V
V
V
V
V
V
V
w
w
w
X
w
w
V
V
V
V
w
X
V
V
V
V
V
V
V
V
w
w
o
w
w
V
V
V
V
V
V
V
V
V
V
V
V
V
V
w
w
w
w
V
V
V
V
V
V
V
V
V
V
V
v
a
"}
(8,1,1) = {"
V
V
V
V
V
V
V
V
V
V
V
w
w
Y
w
V
V
V
V
V
V
w
X
V
V
V
V
V
V
V
V
w
w
w
w
w
V
V
V
V
V
V
V
V
V
V
V
V
V
V
w
w
w
w
V
V
V
V
V
V
V
V
V
V
V
v
a
"}
(9,1,1) = {"
V
V
V
V
V
V
V
V
V
V
V
w
G
w
w
V
V
V
V
V
V
w
X
V
V
V
V
V
V
V
V
w
w
o
w
w
V
V
V
V
V
V
V
V
V
V
V
V
V
V
w
w
w
w
V
V
V
V
V
V
V
V
V
V
V
v
a
"}
(10,1,1) = {"
V
V
V
V
V
V
V
V
V
V
X
w
X
w
w
V
V
V
V
w
w
F
U
V
V
V
V
V
V
V
w
w
w
w
w
w
V
V
V
V
V
V
V
V
V
V
V
V
V
V
w
w
o
w
V
V
V
V
V
V
V
V
V
V
V
v
a
"}
(11,1,1) = {"
V
V
V
V
V
V
V
V
V
V
w
w
X
O
X
X
X
X
X
w
w
w
X
V
V
V
V
V
V
w
w
w
w
F
w
w
w
V
V
V
V
V
V
V
V
V
V
V
V
V
w
w
w
w
V
V
V
V
V
V
V
V
V
V
V
v
a
"}
(12,1,1) = {"
I
V
V
V
V
V
V
V
V
V
w
Q
w
X
w
w
w
w
X
w
o
w
V
V
V
V
V
w
F
w
w
w
F
w
w
w
w
V
V
V
V
V
V
V
V
V
V
V
V
V
w
o
w
V
V
V
V
V
V
V
V
V
V
V
V
v
a
"}
(13,1,1) = {"
V
V
V
V
V
V
V
V
V
V
w
w
w
w
w
o
F
w
o
w
w
w
V
V
V
V
V
w
w
w
w
w
o
w
w
w
w
V
V
V
V
V
V
V
V
V
V
V
V
w
w
w
w
V
V
V
V
V
V
V
V
V
V
V
V
v
a
"}
(14,1,1) = {"
X
w
V
V
V
V
V
V
V
X
w
w
w
w
w
w
w
w
w
w
w
X
V
V
V
V
V
w
o
w
w
w
w
w
w
w
w
w
w
V
V
V
V
V
V
V
V
V
V
w
w
w
F
V
V
V
V
V
V
V
V
V
V
V
V
v
a
"}
(15,1,1) = {"
X
V
V
V
V
V
V
V
V
w
F
w
F
o
w
w
F
w
w
X
V
V
V
V
V
w
w
w
w
w
w
w
w
w
w
w
o
w
w
w
w
V
V
V
V
V
V
V
w
w
w
F
w
V
V
V
V
V
V
V
V
V
V
V
V
v
a
"}
(16,1,1) = {"
X
V
V
V
V
V
V
X
X
w
X
w
w
w
w
w
w
w
w
w
w
V
V
V
V
w
w
w
w
w
O
w
w
o
w
w
w
w
w
w
w
w
w
w
w
V
V
V
w
w
w
w
w
V
V
V
V
V
V
V
V
V
V
V
V
v
a
"}
(17,1,1) = {"
w
V
V
V
V
V
V
w
w
w
X
w
w
w
V
V
V
W
p
p
p
V
V
V
V
w
w
w
o
w
w
w
w
w
w
w
w
o
w
w
w
w
w
w
w
w
w
w
w
o
w
w
V
V
V
V
V
V
V
V
V
V
V
V
V
v
a
"}
(18,1,1) = {"
w
V
V
V
V
V
V
X
w
X
w
w
w
V
V
V
V
V
w
w
F
w
w
o
o
w
w
w
w
w
o
w
w
w
w
w
w
w
w
w
w
o
w
o
w
w
w
w
w
w
w
w
V
V
V
V
V
V
V
V
V
V
V
V
V
v
v
"}
(19,1,1) = {"
w
V
V
V
V
V
w
w
w
X
w
V
V
V
V
V
V
V
V
V
w
w
w
w
w
w
w
w
F
w
w
w
w
F
w
w
w
w
w
w
w
w
F
w
w
w
w
e
w
F
w
F
V
V
V
V
V
V
V
V
V
V
V
V
V
V
v
"}
(20,1,1) = {"
w
V
V
w
w
w
F
w
w
w
F
V
V
V
V
V
V
V
V
V
w
w
w
o
w
w
w
w
w
w
o
w
w
w
w
w
w
w
w
w
o
w
w
w
w
w
o
w
w
w
w
w
V
V
V
V
V
V
V
V
V
V
V
V
V
V
v
"}
(21,1,1) = {"
w
w
w
w
w
w
w
w
X
w
V
V
V
V
V
V
V
V
V
V
F
w
w
w
F
w
o
w
F
w
w
w
w
w
w
V
V
w
w
w
w
w
w
w
w
w
w
w
w
w
w
V
V
V
V
V
V
V
V
V
V
V
V
V
V
V
v
"}
(22,1,1) = {"
w
w
w
w
X
X
w
w
w
w
V
V
V
V
V
V
V
V
V
V
V
w
w
w
w
w
w
w
w
w
e
w
w
w
V
V
V
V
V
w
w
w
w
w
o
w
w
w
w
w
w
V
V
V
V
V
V
V
V
V
V
V
V
V
V
V
v
"}
(23,1,1) = {"
e
F
w
X
w
w
F
w
w
V
V
V
V
V
V
V
V
V
V
V
V
V
V
V
V
V
V
V
w
w
w
w
w
V
V
V
V
V
V
V
w
w
w
w
w
w
w
w
w
w
w
V
V
V
V
V
V
V
V
V
V
V
V
V
V
V
v
"}
(24,1,1) = {"
w
X
U
w
w
w
w
X
V
V
V
V
V
V
V
V
V
V
V
V
V
V
V
V
V
V
V
V
V
V
V
V
V
V
V
V
V
V
V
V
w
o
w
w
w
w
O
w
o
w
w
w
V
V
V
V
V
V
V
V
V
V
V
V
V
V
v
"}
(25,1,1) = {"
X
w
w
X
V
V
V
V
V
V
V
V
V
V
V
V
V
V
V
V
V
V
V
V
V
V
V
V
V
V
V
V
V
V
V
V
V
V
V
V
w
w
w
w
w
w
w
w
w
w
w
w
V
V
V
V
V
V
V
V
V
V
V
V
V
V
v
"}
(26,1,1) = {"
w
w
w
X
V
V
V
V
V
V
V
V
V
V
V
V
V
V
V
V
V
V
V
V
V
V
V
V
V
V
V
V
V
V
V
V
V
V
V
V
w
w
w
w
w
o
w
w
w
w
o
w
V
V
V
V
V
V
V
V
V
V
V
V
V
V
v
"}
(27,1,1) = {"
V
V
V
V
V
V
V
V
V
V
V
V
V
V
V
V
V
V
V
V
V
V
V
V
V
V
V
V
V
V
V
V
V
V
V
V
V
V
V
w
w
w
o
w
w
w
w
w
w
w
w
w
V
V
V
V
V
V
V
V
V
V
V
V
V
V
v
"}
(28,1,1) = {"
V
V
V
V
V
V
V
V
V
V
V
V
V
V
V
V
V
V
V
V
V
V
V
V
V
V
V
V
V
V
V
V
V
V
V
V
V
V
w
o
w
w
w
w
w
w
w
w
w
V
V
V
V
V
V
V
V
V
V
V
V
V
V
V
V
V
v
"}
(29,1,1) = {"
V
V
V
V
V
V
V
V
V
V
V
V
V
V
V
V
V
V
V
V
V
V
V
V
V
V
V
V
V
V
V
V
V
V
V
V
V
w
w
w
w
w
w
o
w
w
w
w
V
V
V
V
V
V
V
V
V
V
V
V
V
V
V
V
V
V
v
"}
(30,1,1) = {"
V
V
V
V
V
V
V
V
V
V
V
V
V
V
V
V
V
V
V
V
V
V
V
V
V
V
V
V
V
V
V
V
V
V
V
V
b
w
w
w
w
w
w
w
w
w
w
w
V
V
V
V
V
V
V
V
V
V
V
V
V
V
V
V
V
V
v
"}
(31,1,1) = {"
V
V
V
V
V
V
V
V
V
V
V
V
V
V
V
V
V
V
V
V
V
V
V
V
V
V
V
V
V
V
V
V
V
V
V
V
w
w
w
w
w
w
w
w
w
w
o
w
V
V
V
V
V
V
V
V
V
V
V
V
V
V
V
V
V
V
v
"}
(32,1,1) = {"
w
w
V
V
V
V
V
V
V
V
V
V
V
V
V
V
V
V
V
V
V
V
V
V
V
V
V
V
V
V
V
V
V
w
w
w
w
w
o
w
j
j
j
j
j
j
j
j
d
d
d
d
V
V
V
V
V
V
V
V
V
V
V
V
V
V
v
"}
(33,1,1) = {"
w
w
o
w
F
w
w
V
V
V
V
V
V
V
V
V
V
V
V
V
V
V
V
V
V
V
V
V
V
V
V
V
w
w
w
w
w
w
w
w
j
w
o
w
w
w
w
w
u
V
V
d
V
V
V
V
V
V
V
V
V
V
V
V
V
V
v
"}
(34,1,1) = {"
w
w
w
w
w
w
w
w
w
V
V
V
V
V
V
V
V
V
V
V
V
V
V
V
V
V
V
V
V
V
V
w
w
w
o
w
w
o
w
w
j
w
w
w
w
w
w
o
w
V
V
d
V
V
V
V
V
V
V
V
V
V
V
V
V
V
v
"}
(35,1,1) = {"
w
o
w
w
w
w
w
w
w
w
w
V
V
V
V
V
V
V
V
V
V
V
V
V
V
V
V
V
V
w
w
w
w
w
w
w
w
w
w
w
j
w
w
o
T
T
T
p
p
T
V
d
V
V
V
V
V
V
V
V
V
V
V
V
V
V
v
"}
(36,1,1) = {"
w
w
w
w
w
w
w
w
w
w
w
w
w
w
V
V
V
V
V
V
V
V
V
V
V
V
V
w
w
w
w
w
w
w
w
w
w
w
w
w
j
w
w
w
p
w
w
w
w
w
V
d
V
V
V
V
V
V
V
V
V
V
V
V
V
V
v
"}
(37,1,1) = {"
w
w
w
w
F
o
w
F
w
w
w
o
w
w
w
w
w
w
V
V
V
V
V
V
V
w
w
w
w
w
w
o
w
w
w
w
w
w
w
w
j
w
w
w
p
o
w
w
o
w
w
d
V
V
V
V
V
V
V
V
V
V
V
V
V
V
v
"}
(38,1,1) = {"
V
V
w
w
w
w
w
w
w
w
w
w
w
w
w
w
w
w
w
w
V
V
V
w
o
w
w
w
w
w
w
w
w
w
w
w
w
w
w
w
j
o
w
w
p
w
w
w
w
w
o
d
V
V
V
V
V
V
V
V
V
V
V
v
v
v
v
"}
(39,1,1) = {"
V
V
w
w
w
w
w
F
w
w
w
w
w
w
F
w
w
w
w
o
w
V
w
w
w
w
w
w
o
w
w
w
w
e
w
w
w
o
w
w
j
w
w
w
T
w
w
w
R
w
w
d
V
V
V
V
V
V
V
V
V
V
V
v
a
a
a
"}
(40,1,1) = {"
V
V
w
w
w
w
w
w
w
w
w
w
w
w
w
w
w
w
w
w
w
w
w
w
w
w
w
w
w
w
w
w
w
w
w
w
w
w
w
w
j
w
w
T
T
w
o
w
w
w
w
d
V
V
V
V
V
V
V
V
V
V
V
v
a
a
a
"}
(41,1,1) = {"
w
w
w
w
w
w
w
w
w
w
o
w
w
w
w
w
o
w
w
w
w
w
w
w
w
w
w
w
w
w
o
w
w
w
w
w
w
w
w
w
j
w
V
T
w
w
w
w
w
o
w
d
V
V
V
V
V
V
V
V
V
V
V
v
a
a
a
"}
(42,1,1) = {"
w
w
w
w
w
w
w
w
w
w
w
w
w
w
w
w
w
w
w
w
w
w
w
O
w
w
w
w
w
w
w
w
w
w
w
w
o
w
w
w
d
V
V
V
w
o
F
w
Y
w
w
d
V
V
V
V
V
V
V
V
V
V
V
v
a
a
a
"}
(43,1,1) = {"
w
w
w
o
w
w
w
w
w
w
w
w
w
w
w
e
w
w
w
w
w
o
w
w
w
w
w
w
w
w
w
w
w
o
w
w
w
w
V
V
d
V
V
V
w
w
w
w
o
w
V
d
V
V
V
V
V
V
V
V
V
V
V
v
a
a
a
"}
(44,1,1) = {"
w
w
w
w
w
w
w
o
w
w
w
w
o
w
w
w
w
w
w
w
w
w
w
w
w
w
o
w
w
w
w
w
w
w
H
w
V
V
V
V
d
V
V
V
w
o
w
w
w
V
V
d
V
V
V
V
V
V
V
V
V
V
V
v
a
a
a
"}
(45,1,1) = {"
w
F
w
w
w
w
O
F
w
w
w
w
w
w
Y
w
w
w
w
w
w
w
w
w
w
w
w
w
w
w
w
w
w
w
V
V
V
V
V
V
d
V
V
V
V
g
w
w
V
V
V
d
V
V
V
V
V
V
V
V
V
V
V
v
a
a
a
"}
(46,1,1) = {"
w
w
w
w
w
w
w
w
w
w
w
w
w
w
w
w
w
w
w
o
w
w
w
w
w
w
w
w
w
w
o
w
w
w
V
V
V
V
V
V
d
V
V
V
V
V
V
V
V
V
V
d
V
V
V
V
V
V
V
V
V
V
V
v
a
a
a
"}
(47,1,1) = {"
w
w
o
w
w
o
w
o
w
w
w
w
w
w
w
w
w
w
o
w
w
w
w
w
w
w
w
w
w
w
w
w
w
w
V
V
V
V
V
V
d
V
V
V
V
V
V
V
V
V
V
d
V
V
V
V
V
V
V
V
V
V
V
v
a
a
a
"}
(48,1,1) = {"
w
w
w
w
w
w
w
w
w
w
w
w
w
w
w
w
w
w
w
w
w
w
w
w
w
w
w
w
w
w
w
w
w
V
V
V
V
V
V
V
d
d
d
d
d
d
d
d
d
d
d
d
V
V
V
V
V
V
V
V
V
V
V
v
a
a
a
"}
(49,1,1) = {"
w
F
w
w
w
w
w
w
V
V
V
V
V
V
V
w
w
w
w
w
w
w
w
w
o
w
w
w
w
w
w
w
w
V
V
V
V
V
V
V
V
V
V
V
V
V
V
V
V
V
V
V
V
V
V
V
V
V
V
V
V
V
V
v
a
a
a
"}
(50,1,1) = {"
w
w
w
V
V
V
V
V
V
V
V
V
V
V
V
V
V
w
w
w
o
w
w
w
w
w
w
w
o
w
w
V
V
V
V
V
V
V
V
V
V
V
V
V
V
V
V
V
V
V
V
V
V
V
V
V
V
V
V
V
V
V
V
v
a
a
a
"}
(51,1,1) = {"
w
w
w
V
V
V
V
V
V
V
V
V
V
V
V
V
V
V
V
w
w
w
w
w
w
w
w
w
w
w
V
V
V
V
V
V
V
V
V
V
V
V
V
V
V
V
V
V
V
V
V
V
V
V
V
V
V
V
V
V
V
V
V
v
a
a
a
"}
(52,1,1) = {"
V
V
V
V
V
V
V
V
V
V
V
V
V
V
V
V
V
V
V
V
V
V
V
V
V
V
V
V
V
V
V
V
V
V
V
V
V
V
V
V
V
V
V
V
V
V
V
V
V
V
V
V
V
V
V
V
V
V
V
V
V
V
V
v
a
a
a
"}
(53,1,1) = {"
V
V
V
V
V
V
V
V
V
V
V
V
V
V
V
V
V
V
V
V
V
V
V
V
V
V
V
V
V
V
V
V
V
V
V
V
V
V
V
V
V
V
V
V
V
V
V
V
V
V
V
V
V
V
V
V
V
V
V
V
V
V
V
v
a
a
a
"}
(54,1,1) = {"
V
V
V
V
V
V
V
V
V
V
V
V
V
V
V
V
V
V
V
V
V
V
V
V
V
V
V
V
V
V
V
V
V
V
V
V
V
V
V
V
V
V
V
V
V
V
V
V
V
V
V
V
V
V
V
V
V
V
V
V
V
V
V
v
a
a
a
"}
(55,1,1) = {"
V
V
V
V
V
V
V
V
V
V
V
V
V
V
V
V
V
V
V
V
V
V
V
V
V
V
V
V
V
V
V
V
V
V
V
V
V
V
V
V
V
V
V
V
V
V
V
V
V
V
V
V
V
V
V
V
V
V
V
V
V
V
V
v
a
a
a
"}
(56,1,1) = {"
V
V
V
V
V
V
V
V
V
V
V
V
V
V
V
V
V
V
V
V
V
V
V
V
V
V
V
V
V
V
V
V
V
V
V
V
V
V
V
V
V
V
V
V
V
V
V
V
V
V
V
V
V
V
V
V
V
V
V
V
V
V
V
v
a
a
a
"}
(57,1,1) = {"
V
V
V
V
V
V
V
V
V
V
V
V
V
V
V
V
V
V
V
V
V
V
V
V
V
V
V
V
V
V
V
V
V
V
V
V
V
V
V
V
V
V
V
V
V
V
V
V
V
V
V
V
V
V
V
V
V
V
V
V
V
V
V
v
a
a
a
"}
(58,1,1) = {"
V
V
V
V
V
V
V
V
V
V
V
V
V
V
V
V
V
V
V
V
V
V
V
V
V
V
V
V
V
V
V
V
V
V
V
V
V
V
V
V
V
V
V
V
V
V
V
V
V
V
V
V
V
V
V
V
V
V
V
V
V
V
V
v
a
a
a
"}
(59,1,1) = {"
V
V
V
V
V
V
V
V
V
V
V
V
V
V
V
V
V
V
V
V
V
V
V
V
V
V
V
V
V
V
V
V
V
V
V
V
V
V
V
V
V
V
V
V
V
V
V
V
V
V
V
V
V
V
V
V
V
V
V
V
V
V
V
v
a
a
a
"}
(60,1,1) = {"
V
V
V
V
V
V
V
V
V
V
V
V
V
V
V
V
V
V
V
V
V
V
V
V
V
V
V
V
V
V
V
V
V
V
V
V
V
V
V
V
V
V
V
V
V
V
V
V
V
V
V
V
V
V
V
V
V
V
V
V
V
V
V
v
a
a
a
"}
(61,1,1) = {"
V
V
V
V
V
V
V
V
V
V
V
V
V
V
V
V
V
V
V
V
V
V
V
V
V
V
V
V
V
V
V
V
V
V
V
V
V
V
V
V
V
V
V
V
V
V
V
V
V
V
V
V
V
V
V
V
V
V
V
V
V
V
V
v
a
a
a
"}
(62,1,1) = {"
V
V
V
V
V
V
V
V
V
V
V
V
V
V
V
V
V
V
V
V
V
V
V
V
V
V
V
V
V
V
V
V
V
V
V
V
V
V
V
V
V
V
V
V
V
V
V
V
V
V
V
V
V
V
V
V
V
V
V
V
V
V
V
v
a
a
a
"}
(63,1,1) = {"
v
v
v
v
v
v
v
v
v
v
v
v
v
v
v
v
v
v
v
v
v
v
v
v
v
v
v
v
v
v
v
v
v
v
v
v
v
v
v
v
v
v
v
v
v
v
v
v
v
v
v
v
v
v
v
v
v
v
v
v
v
v
v
v
a
a
a
"}
(64,1,1) = {"
a
a
a
a
a
a
a
a
a
a
a
a
a
a
a
a
a
a
a
a
a
a
a
a
a
a
a
a
a
a
a
a
a
a
a
a
a
a
a
a
a
a
a
a
a
a
a
a
a
a
a
a
a
a
a
a
a
a
a
a
a
a
a
a
a
a
a
"}
(65,1,1) = {"
a
a
a
a
a
a
a
a
a
a
a
a
a
a
a
a
a
a
a
a
a
a
a
a
a
a
a
a
a
a
a
a
a
a
a
a
a
a
a
a
a
a
a
a
a
a
a
a
a
a
a
a
a
a
a
a
a
a
a
a
a
a
a
a
a
a
a
"}
(66,1,1) = {"
a
a
a
a
a
a
a
a
a
a
a
a
a
a
a
a
a
a
a
a
a
a
a
a
a
a
a
a
a
a
a
a
a
a
a
a
a
a
a
a
a
a
a
a
a
a
a
a
a
a
a
a
a
a
a
a
a
a
a
a
a
a
a
a
a
a
a
"}
(67,1,1) = {"
a
a
a
a
a
a
a
a
a
a
a
a
a
a
a
a
a
a
a
a
a
a
a
a
a
a
a
a
a
a
a
a
a
a
a
a
a
a
a
a
a
a
a
a
a
a
a
a
a
a
a
a
a
a
a
a
a
a
a
a
a
a
a
a
a
a
a
"}
(68,1,1) = {"
a
a
a
a
a
a
a
a
a
a
a
a
a
a
a
a
a
a
a
a
a
a
a
a
a
a
a
a
a
a
a
a
a
a
a
a
a
a
a
a
a
a
a
a
a
a
a
a
a
a
a
a
a
a
a
a
a
a
a
a
a
a
a
a
a
a
a
"}
(69,1,1) = {"
a
a
a
a
a
a
a
a
a
a
a
a
a
a
a
a
a
a
a
a
a
a
a
a
a
a
a
a
a
a
a
a
a
a
a
a
a
a
a
a
a
a
a
a
a
a
a
a
a
a
a
a
a
a
a
a
a
a
a
a
a
a
a
a
a
a
a
"}
(70,1,1) = {"
a
a
a
a
a
a
a
a
a
a
a
a
a
a
a
a
a
a
a
a
a
a
a
a
a
a
a
a
a
a
a
a
a
a
a
a
a
a
a
a
a
a
a
a
a
a
a
a
a
a
a
a
a
a
a
a
a
a
a
a
a
a
a
a
a
a
a
"}
(71,1,1) = {"
a
a
a
a
a
a
a
a
a
a
a
a
a
a
a
a
a
a
a
a
a
a
a
a
a
a
a
a
a
a
a
a
a
a
a
a
a
a
a
a
a
a
a
a
a
a
a
a
a
a
a
a
a
a
a
a
a
a
a
a
a
a
a
a
a
a
a
"}
