//MAP CONVERTED BY dmm2tgm.py THIS HEADER COMMENT PREVENTS RECONVERSION, DO NOT REMOVE
"a" = (
/turf/open/space/basic,
/area/space)
"e" = (
/atom/movable/effect/landmark/patrol_point{
	id = "SOM_14";
	name = "SOM exit point 14"
	},
/turf/open/floor/plating/ground/mars/random/cave,
/area/bigredv2/caves/southwest)
"f" = (
/atom/movable/effect/landmark/lv624/fog_blocker/xeno_spawn,
/turf/open/floor/plating/ground/mars/random/cave/rock,
/area/bigredv2/caves/southwest)
"i" = (
/atom/movable/effect/landmark/lv624/fog_blocker,
/turf/closed/mineral/bigred,
/area/bigredv2/caves/rock)
"n" = (
/atom/movable/effect/landmark/patrol_point{
	id = "SOM_11";
	name = "SOM exit point 11"
	},
/turf/open/floor/plating/ground/mars/random/cave,
/area/bigredv2/caves/southwest)
"o" = (
/atom/movable/effect/landmark/lv624/fog_blocker/xeno_spawn,
/turf/open/floor/plating/ground/mars/random/cave,
/area/bigredv2/caves/southwest)
"p" = (
/atom/movable/effect/landmark/weed_node,
/turf/open/floor/plating/ground/mars/random/cave/rock,
/area/bigredv2/caves/southwest)
"r" = (
/atom/movable/effect/landmark/xeno_silo_spawn,
/turf/open/floor/plating/ground/mars/random/cave,
/area/bigredv2/caves/southwest)
"s" = (
/atom/movable/effect/landmark/weed_node,
/atom/movable/effect/landmark/weed_node,
/turf/open/floor/plating/ground/mars/random/cave,
/area/bigredv2/caves/southwest)
"v" = (
/atom/movable/effect/landmark/weed_node,
/atom/movable/effect/landmark/xeno_resin_wall,
/turf/open/floor/plating/ground/mars/random/cave,
/area/bigredv2/caves/southwest)
"y" = (
/atom/movable/effect/ai_node,
/turf/open/floor/plating/ground/mars/random/cave/rock,
/area/bigredv2/caves/southwest)
"A" = (
/atom/movable/effect/landmark/xeno_resin_wall,
/turf/open/floor/plating/ground/mars/random/cave,
/area/bigredv2/caves/southwest)
"B" = (
/atom/movable/effect/landmark/excavation_site_spawner,
/atom/movable/effect/ai_node,
/turf/open/floor/plating/ground/mars/random/cave,
/area/bigredv2/caves/southwest)
"C" = (
/atom/movable/effect/landmark/lv624/fog_blocker,
/turf/open/floor/plating/ground/mars/random/cave,
/area/bigredv2/caves/southwest)
"D" = (
/turf/open/floor/plating/ground/mars/random/cave/rock,
/area/bigredv2/caves/southwest)
"E" = (
/atom/movable/effect/landmark/weed_node,
/turf/open/floor/plating/ground/mars/random/cave,
/area/bigredv2/caves/southwest)
"G" = (
/atom/movable/effect/landmark/patrol_point{
	id = "SOM_13";
	name = "SOM exit point 13"
	},
/turf/open/floor/plating/ground/mars/random/cave/rock,
/area/bigredv2/caves/southwest)
"I" = (
/atom/movable/effect/landmark/excavation_site_spawner,
/turf/open/floor/plating/ground/mars/random/cave,
/area/bigredv2/caves/southwest)
"K" = (
/turf/closed/mineral/bigred,
/area/bigredv2/caves/rock)
"L" = (
/atom/movable/effect/landmark/xeno_resin_wall,
/turf/open/floor/plating/ground/mars/random/cave/rock,
/area/bigredv2/caves/southwest)
"P" = (
/atom/movable/effect/landmark/patrol_point{
	id = "SOM_12";
	name = "SOM exit point 12"
	},
/turf/open/floor/plating/ground/mars/random/cave,
/area/bigredv2/caves/southwest)
"S" = (
/turf/open/floor/plating/ground/mars/random/cave,
/area/bigredv2/caves/southwest)
"T" = (
/atom/movable/effect/landmark/weed_node,
/atom/movable/effect/ai_node,
/turf/open/floor/plating/ground/mars/random/cave,
/area/bigredv2/caves/southwest)
"U" = (
/turf/closed/wall/indestructible/mineral,
/area/space)
"V" = (
/atom/movable/effect/ai_node,
/turf/open/floor/plating/ground/mars/random/cave,
/area/bigredv2/caves/southwest)
"X" = (
/atom/movable/effect/landmark/lv624/fog_blocker/xeno_spawn,
/turf/closed/mineral/bigred,
/area/bigredv2/caves/rock)
"Z" = (
/atom/movable/effect/landmark/xeno_resin_door,
/turf/open/floor/plating/ground/mars/random/cave,
/area/bigredv2/caves/southwest)

(1,1,1) = {"
U
U
U
U
U
U
U
U
U
U
U
U
U
U
U
U
U
U
U
U
U
U
U
U
U
U
U
U
U
U
U
U
U
U
U
U
a
a
a
a
a
a
a
"}
(2,1,1) = {"
K
K
K
K
K
K
K
K
K
K
K
K
K
K
K
K
K
K
K
K
K
K
K
K
K
K
K
K
K
K
K
K
K
K
K
U
a
a
a
a
a
a
a
"}
(3,1,1) = {"
K
K
K
K
K
K
K
K
K
K
K
K
K
K
K
K
K
K
K
K
K
K
K
K
K
K
K
K
K
K
K
K
K
K
K
U
a
a
a
a
a
a
a
"}
(4,1,1) = {"
K
K
K
K
K
K
K
K
K
K
K
K
K
K
K
K
K
K
K
K
K
K
K
K
K
K
K
K
K
K
K
K
K
K
K
U
a
a
a
a
a
a
a
"}
(5,1,1) = {"
K
K
K
K
K
K
K
K
K
K
K
K
K
K
K
K
K
K
K
K
K
K
K
K
K
K
K
K
K
K
K
K
K
K
K
U
a
a
a
a
a
a
a
"}
(6,1,1) = {"
K
K
K
K
K
K
K
K
K
K
K
K
K
K
K
K
K
K
K
K
K
K
K
K
K
K
K
K
K
K
K
K
K
K
K
U
a
a
a
a
a
a
a
"}
(7,1,1) = {"
K
K
K
K
K
K
K
K
K
K
K
K
K
K
K
K
K
K
K
K
K
K
K
K
K
K
K
K
K
K
K
K
K
K
K
U
a
a
a
a
a
a
a
"}
(8,1,1) = {"
K
K
K
K
K
K
K
K
K
K
K
K
K
K
K
K
K
K
K
K
K
K
K
K
K
K
K
K
K
K
K
K
K
K
K
U
a
a
a
a
a
a
a
"}
(9,1,1) = {"
K
K
K
K
K
K
K
K
K
K
K
K
K
K
K
K
K
K
K
K
K
n
S
K
K
K
K
K
K
K
K
K
K
K
K
U
a
a
a
a
a
a
a
"}
(10,1,1) = {"
S
S
K
K
K
K
K
K
K
K
K
K
K
K
K
K
K
S
S
E
S
S
S
K
K
K
K
K
K
K
K
K
K
K
K
U
a
a
a
a
a
a
a
"}
(11,1,1) = {"
E
S
S
K
K
K
K
K
K
K
K
K
K
K
K
K
S
S
S
S
S
S
S
S
K
K
K
K
K
K
K
K
K
K
K
U
a
a
a
a
a
a
a
"}
(12,1,1) = {"
S
S
S
D
D
K
K
K
K
K
K
K
K
K
K
K
S
S
K
K
S
S
S
S
K
K
K
K
K
K
K
K
K
K
K
U
a
a
a
a
a
a
a
"}
(13,1,1) = {"
S
D
y
S
D
K
K
K
K
K
K
K
K
K
K
E
S
S
K
K
K
K
S
S
E
K
K
K
K
K
K
K
K
K
K
U
a
a
a
a
a
a
a
"}
(14,1,1) = {"
S
S
D
S
D
K
K
K
K
K
K
K
K
K
K
S
S
S
S
K
K
K
S
S
S
K
K
K
K
K
K
K
K
K
K
U
a
a
a
a
a
a
a
"}
(15,1,1) = {"
S
S
S
S
D
K
K
K
K
K
K
K
K
K
K
S
S
S
S
E
K
K
K
S
S
K
K
K
K
K
K
K
K
K
K
U
a
a
a
a
a
a
a
"}
(16,1,1) = {"
S
S
s
S
y
K
K
K
K
K
K
K
K
K
K
S
E
S
S
S
S
K
K
S
P
K
K
K
K
K
K
K
K
K
K
U
a
a
a
a
a
a
a
"}
(17,1,1) = {"
S
E
S
S
E
y
K
K
K
K
K
D
D
D
S
S
S
S
S
I
S
S
S
S
S
K
K
K
K
K
K
K
K
K
K
U
a
a
a
a
a
a
a
"}
(18,1,1) = {"
S
S
S
S
S
D
K
K
K
K
K
D
S
S
S
S
S
S
S
S
E
S
S
s
S
K
K
K
K
K
K
K
K
K
K
U
a
a
a
a
a
a
a
"}
(19,1,1) = {"
S
E
V
E
S
S
D
S
K
K
K
S
V
S
S
S
S
S
S
S
S
E
S
D
S
S
K
K
K
K
K
K
K
K
K
U
a
a
a
a
a
a
a
"}
(20,1,1) = {"
K
S
S
S
S
S
S
S
S
K
S
S
S
S
S
S
S
S
S
S
S
S
S
D
S
S
S
K
K
K
K
K
K
K
K
U
a
a
a
a
a
a
a
"}
(21,1,1) = {"
K
K
K
S
S
S
S
S
S
S
S
S
S
S
S
E
S
S
S
S
S
S
D
S
S
E
S
K
K
K
K
K
K
K
K
U
a
a
a
a
a
a
a
"}
(22,1,1) = {"
K
K
K
S
S
V
S
S
S
S
S
S
V
S
S
V
D
K
G
S
S
S
D
K
K
S
S
K
K
K
K
K
K
K
K
U
a
a
a
a
a
a
a
"}
(23,1,1) = {"
K
K
K
S
S
S
S
S
S
S
S
S
S
S
S
D
K
K
K
K
K
K
K
K
K
S
S
S
K
K
K
K
K
K
K
U
a
a
a
a
a
a
a
"}
(24,1,1) = {"
K
K
K
S
S
E
S
S
D
S
S
D
S
E
S
D
K
K
K
K
K
K
K
K
e
S
S
S
K
K
K
K
K
K
K
U
a
a
a
a
a
a
a
"}
(25,1,1) = {"
K
K
K
D
S
S
S
E
S
S
p
S
S
S
S
K
K
K
K
K
K
K
K
K
S
T
S
S
K
K
K
K
K
K
K
U
a
a
a
a
a
a
a
"}
(26,1,1) = {"
K
K
K
K
V
S
S
S
S
S
S
E
D
S
S
X
X
X
X
X
X
X
X
X
X
S
V
S
K
K
K
K
K
K
K
U
a
a
a
a
a
a
a
"}
(27,1,1) = {"
K
K
K
S
E
V
S
S
S
S
S
S
V
S
S
X
K
K
K
K
K
K
K
K
X
S
S
E
S
K
K
K
K
K
K
U
a
a
a
a
a
a
a
"}
(28,1,1) = {"
K
K
S
S
S
S
S
S
S
S
S
S
E
S
D
X
K
K
K
S
E
S
K
K
X
K
S
S
S
K
K
K
K
K
K
U
a
a
a
a
a
a
a
"}
(29,1,1) = {"
K
K
S
S
S
S
S
E
S
S
S
S
S
E
S
X
K
K
S
S
S
r
S
K
X
K
S
E
S
K
K
K
K
K
K
U
a
a
a
a
a
a
a
"}
(30,1,1) = {"
K
K
S
E
S
S
S
S
E
D
K
D
V
S
T
o
K
K
S
E
S
S
E
K
X
K
S
E
S
S
K
K
K
K
K
U
a
a
a
a
a
a
a
"}
(31,1,1) = {"
K
S
S
S
S
S
S
S
S
D
K
K
D
V
E
o
A
K
V
S
S
S
S
K
X
K
y
S
S
S
K
K
K
K
K
U
a
a
a
a
a
a
a
"}
(32,1,1) = {"
K
S
V
S
S
V
K
S
S
D
K
K
K
S
S
o
A
V
S
S
S
S
K
K
X
K
D
y
E
S
K
K
K
K
K
U
a
a
a
a
a
a
a
"}
(33,1,1) = {"
K
S
S
S
K
K
K
D
D
K
K
K
K
S
S
o
v
S
E
S
D
E
K
K
X
K
K
D
V
S
S
K
K
K
K
U
a
a
a
a
a
a
a
"}
(34,1,1) = {"
K
S
S
S
K
K
K
K
K
K
K
K
K
K
S
o
A
Z
Z
Z
A
L
K
K
X
K
K
K
S
S
S
S
K
K
K
U
a
a
a
a
a
a
a
"}
(35,1,1) = {"
K
S
S
K
K
K
K
K
K
K
K
K
K
S
S
o
o
o
o
o
f
X
X
X
X
K
K
K
S
S
S
K
K
K
K
U
a
a
a
a
a
a
a
"}
(36,1,1) = {"
K
S
S
K
K
K
K
K
K
K
K
K
K
D
T
S
S
E
T
S
D
K
K
K
K
K
K
K
S
E
S
K
K
K
K
U
a
a
a
a
a
a
a
"}
(37,1,1) = {"
S
S
S
K
K
K
K
K
K
K
K
K
K
K
K
K
S
B
S
V
S
y
K
K
K
K
K
K
S
I
S
K
K
K
K
U
a
a
a
a
a
a
a
"}
(38,1,1) = {"
S
S
S
K
K
K
K
K
K
K
K
K
K
K
K
K
S
S
S
S
S
D
K
K
K
K
D
p
S
E
S
K
K
K
K
U
a
a
a
a
a
a
a
"}
(39,1,1) = {"
S
S
S
K
K
K
K
K
K
K
K
K
K
K
K
K
D
S
S
S
S
D
K
K
K
K
D
D
S
S
K
K
K
K
K
U
a
a
a
a
a
a
a
"}
(40,1,1) = {"
S
E
S
K
K
K
K
K
K
K
K
K
K
K
K
K
K
K
K
E
E
S
D
D
K
K
K
K
S
S
K
K
K
K
K
U
a
a
a
a
a
a
a
"}
(41,1,1) = {"
C
C
C
i
i
i
i
i
i
i
i
i
i
i
K
K
K
K
K
S
S
S
S
D
K
K
K
K
S
E
K
K
K
K
K
U
a
a
a
a
a
a
a
"}
