//MAP CONVERTED BY dmm2tgm.py THIS HEADER COMMENT PREVENTS RECONVERSION, DO NOT REMOVE
"aa" = (
/turf/open/floor/plating/ground/mars/random/cave/rock,
/area/bigredv2/caves/east/garbledradio)
"ab" = (
/obj/effect/ai_node,
/turf/open/floor/plating/ground/mars/random/cave,
/area/bigredv2/caves/east/garbledradio)
"ac" = (
/obj/effect/landmark/weed_node,
/turf/open/floor/plating/ground/mars/random/cave,
/area/bigredv2/caves/east)
"ad" = (
/turf/open/floor/plating/ground/mars/random/cave,
/area/bigredv2/caves/east/garbledradio)
"ae" = (
/obj/machinery/miner/damaged/platinum,
/turf/open/floor/plating/ground/mars/random/cave,
/area/bigredv2/caves/east)
"af" = (
/obj/effect/landmark/weed_node,
/turf/open/floor/plating/ground/mars/random/cave,
/area/bigredv2/caves/east/garbledradio)
"ag" = (
/obj/machinery/miner/damaged/platinum,
/turf/open/floor/plating/ground/mars/random/cave,
/area/bigredv2/caves/east/garbledradio)
"ah" = (
/obj/effect/landmark/excavation_site_spawner,
/turf/open/floor/plating/ground/mars/random/cave,
/area/bigredv2/caves/east/garbledradio)
"ai" = (
/obj/effect/landmark/xeno_resin_door,
/turf/open/floor/plating/ground/mars/random/cave,
/area/bigredv2/caves/east/garbledradio)
"aj" = (
/turf/open/floor/plating/ground/mars/random/cave,
/area/bigredv2/caves/east)
"ak" = (
/obj/docking_port/stationary/crashmode,
/turf/closed/mineral/smooth/bigred,
/area/bigredv2/caves/rock)
"al" = (
/obj/effect/landmark/lv624/fog_blocker/xeno_spawn,
/obj/effect/landmark/lv624/fog_blocker/xeno_spawn,
/turf/closed/mineral/smooth/bigred,
/area/bigredv2/caves/rock)
"am" = (
/turf/closed/mineral/smooth/bigred/indestructible,
/area/space)
"an" = (
/obj/docking_port/stationary/crashmode,
/turf/open/floor/plating/ground/mars/random/cave,
/area/bigredv2/caves/east)
"ao" = (
/obj/effect/landmark/xeno_resin_door,
/turf/open/floor/plating/ground/mars/random/cave/rock,
/area/bigredv2/caves/east/garbledradio)
"ap" = (
/obj/effect/landmark/lv624/fog_blocker/xeno_spawn,
/turf/open/floor/plating/ground/mars/random/cave,
/area/bigredv2/caves/east/garbledradio)
"aq" = (
/obj/effect/landmark/xeno_resin_wall,
/turf/open/floor/plating/ground/mars/random/cave,
/area/bigredv2/caves/east/garbledradio)
"ar" = (
/obj/effect/landmark/xeno_silo_spawn,
/turf/open/floor/plating/ground/mars/random/cave,
/area/bigredv2/caves/east/garbledradio)
"at" = (
/obj/effect/landmark/xeno_resin_wall,
/turf/open/floor/plating/ground/mars/random/cave,
/area/bigredv2/caves/east)
"au" = (
/turf/open/floor/plating/ground/mars/random/cave/rock,
/area/bigredv2/caves/east)
"az" = (
/obj/effect/landmark/lv624/fog_blocker/xeno_spawn,
/obj/effect/landmark/lv624/fog_blocker/xeno_spawn,
/turf/open/floor/plating/ground/mars/random/cave,
/area/bigredv2/caves/east/garbledradio)
"aA" = (
/obj/effect/landmark/xeno_resin_door,
/obj/effect/ai_node,
/turf/open/floor/plating/ground/mars/random/cave,
/area/bigredv2/caves/east/garbledradio)
"aF" = (
/obj/effect/landmark/xeno_silo_spawn,
/turf/open/floor/plating/ground/mars/random/cave,
/area/bigredv2/caves/east)
"aI" = (
/obj/effect/landmark/weed_node,
/obj/effect/ai_node,
/turf/open/floor/plating/ground/mars/random/cave,
/area/bigredv2/caves/east/garbledradio)
"aK" = (
/obj/effect/ai_node,
/turf/open/floor/plating/ground/mars/random/cave,
/area/bigredv2/caves/east)
"aM" = (
/obj/effect/landmark/lv624/fog_blocker/xeno_spawn,
/turf/closed/mineral/smooth/bigred,
/area/bigredv2/caves/rock)
"aN" = (
/obj/effect/landmark/lv624/fog_blocker/xeno_spawn,
/turf/open/floor/plating/ground/mars/random/cave,
/area/bigredv2/caves/east)
"aP" = (
/obj/effect/landmark/lv624/fog_blocker/xeno_spawn,
/obj/effect/landmark/xeno_resin_wall,
/turf/open/floor/plating/ground/mars/random/cave,
/area/bigredv2/caves/east/garbledradio)
"aQ" = (
/obj/effect/ai_node,
/turf/open/floor/plating/ground/mars/random/cave/rock,
/area/bigredv2/caves/east/garbledradio)
"aR" = (
/turf/closed/mineral/smooth/bigred,
/area/bigredv2/caves/rock)
"aS" = (
/obj/effect/landmark/lv624/fog_blocker/xeno_spawn,
/turf/open/floor/plating/ground/mars/random/cave/rock,
/area/bigredv2/caves/east/garbledradio)
"aT" = (
/turf/open/floor/plating/ground/mars/random/sand,
/area/bigredv2/outside/se)
"aV" = (
/obj/effect/landmark/weed_node,
/turf/open/floor/plating/ground/mars/random/cave/rock,
/area/bigredv2/caves/east/garbledradio)
"aW" = (
/obj/structure/fence,
/obj/effect/landmark/lv624/fog_blocker,
/turf/open/floor/plating/ground/mars/random/cave,
/area/bigredv2/caves/east/garbledradio)
"aX" = (
/obj/effect/landmark/excavation_site_spawner,
/turf/open/floor/plating/ground/mars/random/cave,
/area/bigredv2/caves/east)
"aY" = (
/obj/effect/landmark/xeno_resin_door,
/turf/open/floor/plating/ground/mars/random/cave,
/area/bigredv2/caves/east)
"aZ" = (
/obj/effect/landmark/weed_node,
/obj/effect/landmark/lv624/fog_blocker/xeno_spawn,
/turf/open/floor/plating/ground/mars/random/cave,
/area/bigredv2/caves/east)
"kb" = (
/obj/effect/landmark/lv624/fog_blocker,
/turf/closed/mineral/smooth/bigred,
/area/bigredv2/caves/rock)
"rp" = (
/obj/effect/landmark/weed_node,
/obj/effect/landmark/xeno_tunnel_spawn,
/turf/open/floor/plating/ground/mars/random/cave,
/area/bigredv2/caves/east)
"sT" = (
/obj/effect/landmark/xeno_resin_door,
/turf/open/floor/plating/ground/mars/random/cave/rock,
/area/bigredv2/caves/east)
"zN" = (
/obj/effect/ai_node,
/turf/open/floor/plating/ground/mars/random/sand,
/area/bigredv2/outside/se)
"DH" = (
/obj/effect/landmark/xeno_tunnel_spawn,
/turf/open/floor/plating/ground/mars/random/cave,
/area/bigredv2/caves/east/garbledradio)
"PO" = (
/obj/effect/landmark/weed_node,
/obj/effect/landmark/xeno_resin_door,
/turf/open/floor/plating/ground/mars/random/cave,
/area/bigredv2/caves/east)
"SF" = (
/obj/effect/landmark/weed_node,
/turf/open/floor/plating/ground/mars/random/sand,
/area/bigredv2/outside/se)

(1,1,1) = {"
aT
aT
aT
aT
aT
aT
aT
aT
aT
aT
aT
aR
aR
aR
aW
ad
af
ad
ad
af
ad
ad
ad
ad
ad
af
ad
ad
aR
aR
aR
aR
aR
aR
aR
aR
aR
ad
af
ad
ad
af
"}
(2,1,1) = {"
aT
aT
SF
aT
aT
aT
SF
aT
aT
aT
aT
aR
aR
aR
kb
ad
ad
ad
ad
ad
ad
ad
ad
ad
ad
ad
ad
ad
aR
aR
aR
aR
aR
aR
aR
aR
aR
aR
ad
ad
ab
ad
"}
(3,1,1) = {"
aT
aT
aT
aT
aT
aT
aT
aT
aT
aT
aT
aR
aR
aR
kb
ad
ad
ad
ad
ad
ad
aR
aR
aR
aR
aR
ad
ad
ad
aR
aR
aR
aR
aR
aR
aR
aR
aR
ad
ad
ad
ad
"}
(4,1,1) = {"
aT
aR
aR
aR
aR
aT
aT
aT
SF
aT
aT
SF
aR
aR
kb
ad
ad
ad
af
ad
ad
aR
aR
aR
aR
aR
aa
ad
ad
ad
ad
af
ad
ad
ad
aR
aa
aa
ad
ad
ad
ad
"}
(5,1,1) = {"
aT
aR
aR
aR
aR
aR
aR
aT
aT
aT
aT
aT
aT
aR
kb
aR
ad
az
ap
ap
aM
aM
aM
aM
aM
aM
ap
aS
az
ad
ad
ad
ad
ad
af
aa
ad
ad
af
ad
ad
af
"}
(6,1,1) = {"
aT
aT
aR
aR
aR
aR
aR
aR
aT
aT
aT
aT
aT
aR
kb
aR
aR
ap
ad
aR
aR
aR
aR
aR
aR
ad
ad
ad
aS
aV
ab
ad
ad
ad
ad
ad
ad
ad
ad
ad
ab
aa
"}
(7,1,1) = {"
aT
aT
aT
aT
aT
aT
aT
aT
aT
aT
aT
aT
aT
aR
kb
aR
aR
aP
aq
aq
ad
aR
ad
aR
aR
ad
ab
ad
ap
ab
ad
ad
af
ad
ad
ad
ad
af
ad
ag
ad
aa
"}
(8,1,1) = {"
aT
SF
aT
aT
SF
aT
aT
aT
SF
aT
aT
SF
aT
aR
kb
aR
aR
aM
DH
ad
ad
aI
ad
ad
aA
ab
ad
ad
ap
ad
ad
ad
ad
ad
ad
ad
aa
ad
ad
ad
aa
aR
"}
(9,1,1) = {"
aT
aT
aT
aT
aT
zN
aT
aT
aT
zN
aT
aT
aT
aR
kb
aR
aR
aM
ad
ad
ad
ad
ad
ad
ai
ad
ad
aR
aM
aR
aR
aR
ad
ad
ad
ad
af
aa
ad
ad
ad
aa
"}
(10,1,1) = {"
aT
aT
aT
aT
aT
aT
aT
aT
aT
aT
aT
aT
aR
aR
kb
aR
aR
aM
aR
aR
ad
ad
ad
ad
aq
aR
aR
aR
aM
aR
aR
aR
aR
aR
aR
aR
ad
ad
ad
af
af
aa
"}
(11,1,1) = {"
aT
aT
aR
aT
aT
aT
aT
aT
aT
aT
aT
aR
aR
aR
kb
aR
aR
aM
aR
ad
ad
ad
ad
ad
aq
aq
aR
aR
aM
aR
aR
aR
aR
aR
aR
aR
ad
ad
ad
ad
ad
aa
"}
(12,1,1) = {"
aT
aR
aR
aT
SF
aT
aT
aT
SF
aR
aR
aR
aR
aR
kb
aR
aR
aM
ad
aa
ad
ad
aV
af
ad
ad
aR
aR
aM
aR
aR
aR
aR
aR
aR
aR
ad
ad
ad
af
ad
aa
"}
(13,1,1) = {"
aR
aR
aR
aT
aT
aT
aT
aT
aT
aR
aR
aR
aR
aR
kb
aR
aR
aM
ad
af
ad
ad
ad
ad
ad
ad
aR
aR
aM
aR
aR
aR
aR
aR
aR
aR
aa
ad
af
ad
aa
aR
"}
(14,1,1) = {"
aR
aR
aT
aT
aT
aT
aT
aT
aT
aR
aR
aR
aR
aR
kb
aR
aR
aM
ad
ad
ad
ab
ar
ad
ad
af
ad
aR
aM
aR
aR
aR
aR
aR
aR
aR
ad
ad
af
ad
ab
aa
"}
(15,1,1) = {"
aR
aT
aT
aT
aT
aT
aR
aR
aR
aR
aR
aR
aR
aR
kb
aR
aR
aM
ad
ad
ad
ad
ad
ad
af
ad
aR
aR
aM
aR
aR
aR
aR
aR
aR
aR
aR
aa
ad
ad
ad
aa
"}
(16,1,1) = {"
SF
aT
aT
aT
SF
zN
aR
aR
aR
aR
aR
aR
aR
aR
kb
aR
aR
aM
aR
ad
ad
ad
ad
ad
ad
aR
aR
aR
aM
aR
aR
aR
aR
aR
aR
aR
aR
aR
ai
ai
ai
ai
"}
(17,1,1) = {"
aT
aT
aT
aT
aT
aT
aR
aR
aR
aR
aR
aR
aR
aR
kb
aR
aR
aM
aR
ad
ad
ad
ad
ad
aR
aR
aR
aR
aM
aR
aR
aR
aR
aR
aR
aR
aR
aR
ad
ad
ad
ad
"}
(18,1,1) = {"
aR
aR
aR
aR
aR
aR
aR
aR
aR
aR
aR
aR
aR
aR
kb
aR
aR
al
aM
ap
ap
ap
ap
ap
aM
aM
aM
aM
al
aR
aR
aR
aR
aR
aR
aR
ad
ad
ad
ad
ad
af
"}
(19,1,1) = {"
kb
kb
kb
kb
kb
kb
kb
kb
kb
kb
kb
kb
kb
kb
kb
aR
aR
aR
aR
ad
ad
ad
ad
ad
aR
aR
aR
aR
aR
aR
aR
aR
aR
aR
aR
ad
ad
af
ad
ad
ad
ad
"}
(20,1,1) = {"
aR
aR
aR
aR
aR
aR
aR
aR
aR
aR
aR
aR
aR
aR
aR
aR
aR
aR
aR
aR
ad
ad
ad
ad
aR
ak
aR
aR
aR
aR
aR
aR
aR
aR
ad
ad
ad
ad
ad
ad
ad
ad
"}
(21,1,1) = {"
aR
aR
aR
aR
aR
aR
aR
aR
aR
aR
aR
aR
aR
aR
aR
aR
aR
aR
aR
aR
ad
ab
ad
ad
ad
aR
aR
aR
aR
aR
aR
aR
aR
aR
ad
ad
ad
ad
af
aa
ad
ad
"}
(22,1,1) = {"
aR
aa
aa
aQ
aa
aV
aR
aR
aR
aR
aR
aR
aR
aR
aR
aR
aR
aR
aR
aR
ad
ad
ad
ad
ad
aR
aR
aR
aR
aR
aR
aR
aR
aR
ab
ad
ad
ad
ad
ad
ab
ad
"}
(23,1,1) = {"
aR
af
ad
ad
ad
ad
aa
aR
aR
aR
aR
aR
aR
aR
aR
aR
aR
aR
aR
aR
ad
ad
ad
ad
ad
aR
aR
aR
aR
aR
aR
aR
aR
aR
ad
af
aa
aR
aR
ad
ad
ad
"}
(24,1,1) = {"
aR
aa
ad
ad
ad
af
aa
aR
aR
aR
aR
aR
aR
aR
aR
aR
aR
aR
aR
aR
ad
ad
ad
ad
ad
aR
aR
aR
aR
aR
aR
aR
aR
aa
ad
ad
aa
aR
aR
ad
ad
af
"}
(25,1,1) = {"
aR
aR
aR
aQ
ad
ad
aa
ad
ab
ad
ad
aR
aR
aR
aR
aR
aR
aR
aR
aR
ad
ad
ad
ad
ad
aR
aR
aR
aR
aR
aR
aR
aR
ad
ad
aa
aR
aR
aR
ad
ad
ad
"}
(26,1,1) = {"
aR
aR
aR
aR
aR
ad
aa
ad
ad
ad
ad
aR
aR
aR
aR
aa
aa
ad
af
ad
ad
ad
ah
ad
ad
aR
aR
aR
aR
aR
aR
aR
aR
ad
aa
aR
aR
aR
aR
ad
ab
ad
"}
(27,1,1) = {"
aa
aa
aa
aa
aV
ad
aa
af
ad
ad
ad
af
ai
ad
ad
ad
ad
ad
ad
ad
ad
ad
ad
ad
ad
ad
aR
aR
aR
aR
aR
aR
aR
ad
ab
aa
aR
aa
aa
ad
af
ad
"}
(28,1,1) = {"
ab
ad
ad
ad
af
ab
ad
aa
aQ
aa
aa
aa
ao
aa
ad
af
aQ
ad
ad
ad
af
ab
ad
ab
ad
af
aR
aR
aR
aR
aR
aR
aR
ab
ad
ad
aa
ad
ad
ad
ad
ad
"}
(29,1,1) = {"
ad
ad
ad
ad
ad
ad
ah
ad
ad
ad
ad
ad
ai
ad
ad
ad
aa
ad
ad
aa
ad
af
ad
ad
ad
ad
aR
aR
aR
aR
aR
aR
aR
ad
ad
ad
af
ad
ad
ad
ad
ad
"}
(30,1,1) = {"
ad
ad
af
ad
ad
ad
ad
ad
ad
ad
af
ad
ai
ad
af
ad
aa
ad
af
ad
ad
ad
ad
af
ad
aR
aR
aR
aR
aR
aR
aR
aR
aR
ad
ad
ad
ad
ad
ad
aQ
aR
"}
(31,1,1) = {"
af
ad
ad
ad
ad
ad
af
ad
ad
af
ad
aa
aR
aR
ad
ad
aV
ad
ad
ad
ad
ad
ad
ad
aR
aR
aR
aR
aR
aR
aR
aR
aR
aR
aR
aR
ad
ad
ad
ad
aa
aR
"}
(32,1,1) = {"
aa
ad
ad
ad
ad
ad
ad
aR
aR
aR
aR
aR
aR
aR
aR
ad
aa
ad
ad
ad
af
ad
af
aR
aR
aR
aR
aR
aR
aR
aR
aR
aR
aR
aR
aR
ad
ad
af
aa
ad
aR
"}
(33,1,1) = {"
ad
ad
ad
ad
ag
ad
ad
aR
aR
aR
aR
aR
aR
aR
aR
ad
aa
ad
ad
ad
ad
ad
aR
aR
aR
aR
aR
aR
aR
aR
aR
aR
aR
aR
aR
aR
ad
ad
aa
ad
ad
ad
"}
(34,1,1) = {"
aa
ad
af
aa
ad
ad
af
aR
aR
aR
aR
aR
aR
aR
aa
af
ad
ad
af
ad
aR
aR
aR
aR
aR
aR
aR
aR
aR
aR
aR
aR
aR
aR
aR
aR
aR
aR
aa
ad
ab
ad
"}
(35,1,1) = {"
aR
aa
ad
aj
aj
aj
ad
ad
aR
aR
aR
aR
aR
aa
ad
aj
aj
ad
ad
aR
aR
aR
aR
aR
aR
aR
aM
aM
aM
aM
aM
aM
aM
aM
aM
aM
aM
aR
aR
ai
ai
ai
"}
(36,1,1) = {"
aR
aR
aR
aj
aj
au
ac
aj
aj
aR
aR
aR
sT
aj
aj
aj
aj
ac
aj
aR
aR
aR
aR
aR
aR
aR
aM
aR
aR
aR
aR
aR
aR
aR
aR
aR
aM
aR
aR
aR
ab
aj
"}
(37,1,1) = {"
aR
aR
aR
ac
aj
au
aj
aj
an
au
aj
aj
PO
aj
aj
aj
aj
aj
aR
aR
aR
aR
aR
aR
aR
aR
aM
aR
rp
aj
ac
aj
aR
aR
aR
aR
aM
aR
aR
aR
aj
aj
"}
(38,1,1) = {"
aR
aR
aR
aj
aj
aK
aj
ac
aj
aj
aj
aj
aY
aj
ac
aj
aK
aR
aR
aR
aR
aR
aR
aR
aR
aR
aM
aR
aj
aj
aF
aj
aj
aj
aR
aR
aM
aR
aR
aR
aR
aj
"}
(39,1,1) = {"
aR
aR
aR
aR
aj
aj
aj
aj
aj
ac
aj
aj
aY
aj
aj
aR
aR
aR
aR
aR
aR
aR
aR
aR
aR
aR
aM
aR
aj
aj
aj
aj
ac
aj
aj
aR
aM
aR
aR
aR
aR
aR
"}
(40,1,1) = {"
aR
aR
aR
aR
aj
aj
aj
aj
aj
aX
aj
aj
aY
aj
aR
aR
aR
aR
aR
aR
aR
aR
aR
aR
aR
aR
aM
aR
ac
aj
aj
aj
aj
ac
aj
aR
aM
aR
aR
aR
aR
aR
"}
(41,1,1) = {"
aR
aR
aR
aj
aj
aj
ac
aj
aj
aj
aj
aj
aR
aR
aR
aR
aR
aR
aR
aR
aR
aR
aR
aR
aR
aR
aM
aR
aY
aY
aY
at
at
at
at
aR
aM
aR
aR
aR
aR
aR
"}
(42,1,1) = {"
aR
aR
aR
aj
aj
aj
aj
aj
aj
aj
ac
aj
aR
aR
aR
aR
aR
aR
aR
aR
aj
aR
aR
aR
aj
aj
aN
aj
aj
aj
aj
aK
aj
ac
aj
aR
aM
aR
aR
aR
aR
aR
"}
(43,1,1) = {"
aR
aR
aj
aj
aj
aj
aj
aj
aj
ac
aj
aj
aY
aR
aR
aR
aR
aR
aR
aj
aj
aj
aR
aR
aj
aj
aN
aN
aN
aN
aZ
aN
aN
aN
aN
aM
aM
aR
aR
aR
aR
aR
"}
(44,1,1) = {"
aR
aR
aj
aj
ac
aj
aX
aj
aj
aj
aj
aj
aY
aj
aj
aR
aR
aR
aj
aj
aj
aj
aj
aj
aj
aj
ac
aj
aj
aj
aj
aj
aj
aj
aj
aj
aR
aR
aR
aR
aR
aR
"}
(45,1,1) = {"
aR
aR
ac
aj
aj
ac
aj
aj
aj
aj
aj
aj
PO
aj
aj
aj
aj
aj
aj
aj
aj
aj
aj
aj
aj
aj
aj
aj
aj
aj
aj
aj
aj
aj
aj
aj
aj
aR
aR
aR
aR
aR
"}
(46,1,1) = {"
aj
aj
aj
aj
aj
aj
aj
aj
aj
ac
aj
aj
aY
aj
aj
aj
aj
aj
aj
aj
aj
ac
aj
aj
aj
aj
aj
aj
aj
aj
ac
aj
aj
aj
ac
aj
aj
aj
aj
aj
aj
aj
"}
(47,1,1) = {"
aj
aj
aj
aj
aj
aj
aj
aj
aj
aj
aj
aj
aY
aj
ac
aj
ac
aj
aj
aj
aj
aj
aj
aj
aj
ac
aj
aX
aj
aj
aj
aj
aj
aj
aj
aj
aj
aj
aj
ac
aj
aj
"}
(48,1,1) = {"
aK
aj
aj
aj
aj
aK
aj
aj
aj
aj
ac
aj
aY
aj
aK
aj
aj
aj
aj
ae
aj
aj
aj
aK
aj
aj
aj
aj
aj
aj
aj
aK
aj
aj
aj
aj
aj
aj
aj
aK
aj
aj
"}
(49,1,1) = {"
aj
aj
ac
aj
aj
aj
aj
aj
aj
aj
aj
aj
aY
aj
aj
aj
aj
aj
aj
aj
aj
aj
aj
aj
aj
aj
aj
ac
aj
aj
aj
aj
aj
aj
aj
aj
aj
aj
aj
aj
aj
aj
"}
(50,1,1) = {"
ac
aj
aj
aj
aj
aj
aj
ac
aj
aR
aR
aR
aR
aj
aj
ac
aj
aj
aj
aj
aj
aj
ac
aj
aj
aj
aj
aj
aj
aj
aj
ac
aj
aj
aj
aj
ac
aj
aj
aj
ac
aj
"}
(51,1,1) = {"
aj
aj
aj
aj
aj
ac
aj
aj
aj
aR
aR
aR
aR
aR
aj
aj
aj
ac
aj
aj
aj
aj
aj
aj
aj
ac
aj
aj
aj
aj
aR
aR
aR
aj
aj
aj
aj
aj
aj
aj
aj
aj
"}
(52,1,1) = {"
aj
au
aj
aj
aj
aj
aj
aR
aR
aR
aR
aR
aR
aR
aR
aR
aR
aR
aR
aR
aR
aR
aj
aj
aj
aj
aj
aj
aj
aR
aR
aR
aR
aR
aj
aj
aX
aj
aj
aK
aj
aj
"}
(53,1,1) = {"
aK
aj
aj
ac
aR
aR
aR
aR
aR
aR
aR
aR
aR
aR
aR
aR
aR
aR
aR
aR
aR
aR
aR
au
aj
aj
aj
aj
aR
aR
aR
aR
aR
aR
au
aj
aj
ac
aj
aj
aj
aj
"}
(54,1,1) = {"
aj
aj
aj
aj
aR
aR
aR
aR
aR
aR
aR
aR
aR
aR
aR
aR
aR
aR
aR
aR
aR
aR
aR
aR
aY
aY
aY
aY
at
aR
aR
aR
aR
aR
aR
aR
aj
aj
aj
aj
ac
aj
"}
(55,1,1) = {"
aj
ac
aj
aR
aR
aR
aR
aR
aR
aR
aR
aR
aR
aR
aR
aR
aR
aR
aR
aR
aR
aR
aR
aR
aj
aj
aj
aj
aj
aj
aR
aR
aR
aR
aR
aR
aR
aR
aR
aj
aj
aj
"}
(56,1,1) = {"
aj
aj
aj
aR
aR
aR
aR
aR
aR
aR
aR
aR
aR
aR
aR
aR
aR
aR
aR
aR
aR
aR
aR
aR
aj
aj
aj
aj
aj
aj
aR
aR
aR
aR
aR
aR
aR
aR
aR
aR
aR
aR
"}
(57,1,1) = {"
aj
aj
aj
aR
aR
aR
aR
aR
aR
aR
aR
aR
aR
aR
aR
aR
aR
aR
aR
aR
aR
aR
aR
aR
aj
aj
aj
aj
aj
aj
aR
aR
aR
aR
aR
aR
aR
aR
aR
aR
aR
aR
"}
(58,1,1) = {"
aj
aj
aj
aR
aR
aR
aR
aR
aR
aR
aR
aR
aR
aR
aR
aR
aR
aR
aR
aR
aR
aR
aR
aR
aj
aj
aj
aj
aj
aR
aR
aR
aR
aR
aR
aR
aR
aR
aR
aR
aR
aR
"}
(59,1,1) = {"
aK
ac
aR
aR
aR
aR
aR
aR
aR
aR
aR
aR
aR
aR
aR
aR
aR
aR
aR
aR
aR
aR
aR
aR
aR
aj
aj
aj
aR
aR
aR
aR
aR
aR
aR
aR
aR
aR
aR
aR
aR
aR
"}
(60,1,1) = {"
aR
aR
aR
aR
aR
aR
aR
aR
aR
aR
aR
aR
aR
aR
aR
aR
aR
aR
aR
aR
aR
aR
aR
aR
aR
aR
aR
aR
aR
aR
aR
aR
aR
aR
aR
aR
aR
aR
aR
aR
aR
aR
"}
(61,1,1) = {"
aR
aR
aR
aR
aR
aR
aR
aR
aR
aR
aR
aR
aR
aR
aR
aR
aR
aR
aR
aR
aR
aR
aR
aR
aR
aR
aR
aR
aR
aR
aR
aR
aR
aR
aR
aR
aR
aR
aR
aR
aR
aR
"}
(62,1,1) = {"
aM
aM
aR
aR
aR
aR
aR
aR
aR
aR
aR
aR
aR
aR
aR
aR
aR
aR
aR
aR
aR
aR
aR
aR
aR
aR
aR
aR
aR
aR
aR
aR
aR
aR
aR
aR
aR
aR
aR
aR
aR
aR
"}
(63,1,1) = {"
aR
aM
aM
aR
aR
aR
aR
aR
aR
aR
aR
aR
aR
aR
aR
aR
aR
aR
aR
aR
aR
aR
aR
aR
aR
aR
aR
aR
aR
aR
aR
aR
aR
aR
aR
aR
aR
aR
aR
aR
aR
aR
"}
(64,1,1) = {"
aR
aR
aM
aR
aR
aR
aR
aR
aR
aR
aR
aR
aR
aR
aR
aR
aR
aR
aR
aR
aR
aR
aR
aR
aR
aR
aR
aR
aR
aR
aR
aR
aR
aR
aR
aR
aR
aR
aR
aR
aR
aR
"}
(65,1,1) = {"
aR
aR
aM
aR
aR
aR
aR
aR
aR
aR
aR
aR
aR
aR
aR
aR
aR
aR
aR
aR
aR
aR
aR
aR
aR
aR
aR
aR
aR
aR
aR
aR
aR
aR
aR
aR
aR
aR
aR
aR
aR
aR
"}
(66,1,1) = {"
aj
aR
am
am
am
am
am
am
am
am
am
am
am
am
am
am
am
am
am
am
am
am
am
am
am
am
am
am
am
am
am
am
am
am
am
am
am
am
am
am
am
am
"}
