//MAP CONVERTED BY dmm2tgm.py THIS HEADER COMMENT PREVENTS RECONVERSION, DO NOT REMOVE
"a" = (
/obj/effect/landmark/weed_node,
/turf/open/floor/plating/ground/mars/random/cave,
/area/bigredv2/caves/east)
"f" = (
/obj/effect/landmark/lv624/fog_blocker/xeno_spawn,
/obj/effect/landmark/xeno_resin_wall,
/turf/open/floor/plating/ground/mars/random/cave,
/area/bigredv2/caves/east)
"g" = (
/obj/effect/landmark/xeno_resin_door,
/turf/open/floor/plating/ground/mars/random/cave/rock,
/area/bigredv2/caves/east)
"h" = (
/obj/effect/landmark/lv624/fog_blocker/xeno_spawn,
/turf/closed/mineral/bigred,
/area/bigredv2/caves/rock)
"m" = (
/obj/effect/landmark/lv624/fog_blocker/xeno_spawn,
/turf/open/floor/plating/ground/mars/random/cave,
/area/bigredv2/caves/east)
"p" = (
/obj/effect/landmark/xeno_resin_door,
/turf/open/floor/plating/ground/mars/random/cave,
/area/bigredv2/caves/east)
"s" = (
/obj/effect/ai_node,
/turf/open/floor/plating/ground/mars/random/sand,
/area/bigredv2/outside/se)
"u" = (
/obj/effect/landmark/lv624/fog_blocker,
/turf/closed/mineral/bigred,
/area/bigredv2/caves/rock)
"x" = (
/obj/effect/landmark/xeno_silo_spawn,
/turf/open/floor/plating/ground/mars/random/cave,
/area/bigredv2/caves/east)
"y" = (
/turf/closed/mineral/bigred,
/area/bigredv2/caves/rock)
"z" = (
/obj/effect/landmark/weed_node,
/turf/open/floor/plating/ground/mars/random/sand,
/area/bigredv2/outside/se)
"E" = (
/obj/effect/landmark/weed_node,
/obj/effect/ai_node,
/turf/open/floor/plating/ground/mars/random/cave,
/area/bigredv2/caves/east)
"F" = (
/turf/open/floor/plating/ground/mars/random/cave,
/area/bigredv2/caves/east)
"G" = (
/obj/effect/landmark/excavation_site_spawner,
/turf/open/floor/plating/ground/mars/random/cave,
/area/bigredv2/caves/east)
"H" = (
/obj/effect/landmark/lv624/fog_blocker/xeno_spawn,
/obj/effect/landmark/lv624/fog_blocker/xeno_spawn,
/turf/closed/mineral/bigred,
/area/bigredv2/caves/rock)
"I" = (
/obj/effect/landmark/xeno_resin_door,
/obj/effect/ai_node,
/turf/open/floor/plating/ground/mars/random/cave,
/area/bigredv2/caves/east)
"J" = (
/obj/effect/landmark/weed_node,
/turf/open/floor/plating/ground/mars/random/cave/rock,
/area/bigredv2/caves/east)
"K" = (
/obj/effect/ai_node,
/turf/open/floor/plating/ground/mars/random/cave/rock,
/area/bigredv2/caves/east)
"L" = (
/obj/machinery/miner/damaged/platinum,
/turf/open/floor/plating/ground/mars/random/cave,
/area/bigredv2/caves/east)
"M" = (
/obj/effect/landmark/weed_node,
/obj/effect/landmark/xeno_resin_door,
/turf/open/floor/plating/ground/mars/random/cave,
/area/bigredv2/caves/east)
"O" = (
/obj/effect/landmark/lv624/fog_blocker/xeno_spawn,
/turf/open/floor/plating/ground/mars/random/cave/rock,
/area/bigredv2/caves/east)
"P" = (
/turf/open/floor/plating/ground/mars/random/cave/rock,
/area/bigredv2/caves/east)
"S" = (
/turf/open/floor/plating/ground/mars/random/sand,
/area/bigredv2/outside/se)
"T" = (
/turf/closed/wall/indestructible/mineral,
/area/space)
"U" = (
/obj/structure/fence,
/obj/effect/landmark/lv624/fog_blocker,
/turf/open/floor/plating/ground/mars/random/cave,
/area/bigredv2/caves/east)
"V" = (
/obj/effect/landmark/lv624/fog_blocker/xeno_spawn,
/obj/effect/landmark/lv624/fog_blocker/xeno_spawn,
/turf/open/floor/plating/ground/mars/random/cave,
/area/bigredv2/caves/east)
"W" = (
/obj/effect/ai_node,
/turf/open/floor/plating/ground/mars/random/cave,
/area/bigredv2/caves/east)
"Z" = (
/obj/effect/landmark/xeno_resin_wall,
/turf/open/floor/plating/ground/mars/random/cave,
/area/bigredv2/caves/east)

(1,1,1) = {"
S
S
S
S
S
S
S
S
S
S
S
y
y
y
U
F
a
F
F
a
F
F
F
F
F
a
F
F
y
y
y
y
y
y
y
y
y
F
a
F
F
a
"}
(2,1,1) = {"
S
S
z
S
S
S
z
S
S
S
S
y
y
y
u
F
F
F
F
F
F
F
F
F
F
F
F
F
y
y
y
y
y
y
y
y
y
y
F
F
W
F
"}
(3,1,1) = {"
S
S
S
S
S
S
S
S
S
S
S
y
y
y
u
F
F
F
F
F
F
y
y
y
y
y
F
F
F
y
y
y
y
y
y
y
y
y
F
F
F
F
"}
(4,1,1) = {"
S
y
y
y
y
S
S
S
z
S
S
z
y
y
u
F
F
F
a
F
F
y
y
y
y
y
P
F
F
F
F
a
F
F
F
y
P
P
F
F
F
F
"}
(5,1,1) = {"
S
y
y
y
y
y
y
S
S
S
S
S
S
y
u
y
F
V
m
m
h
h
h
h
h
h
m
O
V
F
F
F
F
F
a
P
F
F
a
F
F
a
"}
(6,1,1) = {"
S
S
y
y
y
y
y
y
S
S
S
S
S
y
u
y
y
m
F
y
y
y
y
y
y
F
F
F
O
J
W
F
F
F
F
F
F
F
F
F
W
P
"}
(7,1,1) = {"
S
S
S
S
S
S
S
S
S
S
S
S
S
y
u
y
y
f
Z
Z
F
y
F
y
y
F
W
F
m
W
F
F
a
F
F
F
F
a
F
L
F
P
"}
(8,1,1) = {"
S
z
S
S
z
S
S
S
z
S
S
z
S
y
u
y
y
h
F
F
F
E
F
F
I
W
F
F
m
F
F
F
F
F
F
F
P
F
F
F
P
y
"}
(9,1,1) = {"
S
S
S
S
S
s
S
S
S
s
S
S
S
y
u
y
y
h
F
F
F
F
F
F
p
F
F
y
h
y
y
y
F
F
F
F
a
P
F
F
F
P
"}
(10,1,1) = {"
S
S
S
S
S
S
S
S
S
S
S
S
y
y
u
y
y
h
y
y
F
F
F
F
Z
y
y
y
h
y
y
y
y
y
y
y
F
F
F
a
a
P
"}
(11,1,1) = {"
S
S
y
S
S
S
S
S
S
S
S
y
y
y
u
y
y
h
y
F
F
F
F
F
Z
Z
y
y
h
y
y
y
y
y
y
y
F
F
F
F
F
P
"}
(12,1,1) = {"
S
y
y
S
z
S
S
S
z
y
y
y
y
y
u
y
y
h
F
P
F
F
J
a
F
F
y
y
h
y
y
y
y
y
y
y
F
F
F
a
F
P
"}
(13,1,1) = {"
y
y
y
S
S
S
S
S
S
y
y
y
y
y
u
y
y
h
F
a
F
F
F
F
F
F
y
y
h
y
y
y
y
y
y
y
P
F
a
F
P
y
"}
(14,1,1) = {"
y
y
S
S
S
S
S
S
S
y
y
y
y
y
u
y
y
h
F
F
F
W
x
F
F
a
F
y
h
y
y
y
y
y
y
y
F
F
a
F
W
P
"}
(15,1,1) = {"
y
S
S
S
S
S
y
y
y
y
y
y
y
y
u
y
y
h
F
F
F
F
F
F
a
F
y
y
h
y
y
y
y
y
y
y
y
P
F
F
F
P
"}
(16,1,1) = {"
z
S
S
S
z
s
y
y
y
y
y
y
y
y
u
y
y
h
y
y
y
F
F
F
F
y
y
y
h
y
y
y
y
y
y
y
y
y
p
p
p
p
"}
(17,1,1) = {"
S
S
S
S
S
S
y
y
y
y
y
y
y
y
u
y
y
h
y
y
y
y
y
y
y
y
y
y
h
y
y
y
y
y
y
y
y
y
F
F
F
F
"}
(18,1,1) = {"
y
y
y
y
y
y
y
y
y
y
y
y
y
y
u
y
y
H
h
h
h
h
h
h
h
h
h
h
H
y
y
y
y
y
y
y
F
F
F
F
F
a
"}
(19,1,1) = {"
u
u
u
u
u
u
u
u
u
u
u
u
u
u
u
y
y
y
y
y
y
y
y
y
y
y
y
y
y
y
y
y
y
y
y
F
F
a
F
F
F
F
"}
(20,1,1) = {"
y
y
y
y
y
y
y
y
y
y
y
y
y
y
y
y
y
y
y
y
y
y
y
y
y
y
y
y
y
y
y
y
y
y
F
F
F
F
F
F
F
F
"}
(21,1,1) = {"
y
y
y
y
y
y
y
y
y
y
y
y
y
y
y
y
y
y
y
y
y
y
y
y
y
y
y
y
y
y
y
y
y
y
F
F
F
F
a
P
F
F
"}
(22,1,1) = {"
y
P
P
K
P
J
y
y
y
y
y
y
y
y
y
y
y
y
y
y
y
y
y
y
y
y
y
y
y
y
y
y
y
y
F
F
F
F
F
F
W
F
"}
(23,1,1) = {"
y
a
F
F
F
F
P
y
y
y
y
y
y
y
y
y
y
y
y
y
y
y
y
y
y
y
y
y
y
y
y
y
y
y
F
a
P
y
y
F
F
F
"}
(24,1,1) = {"
y
P
F
F
F
a
P
y
y
y
y
y
y
y
y
y
y
y
y
y
y
y
y
y
y
y
y
y
y
y
y
y
F
P
F
F
P
y
y
F
F
a
"}
(25,1,1) = {"
y
y
y
K
F
F
P
F
W
F
F
y
y
y
y
y
y
y
y
y
y
y
y
y
y
y
y
y
y
y
F
F
P
F
F
P
y
y
y
F
F
F
"}
(26,1,1) = {"
y
y
y
y
y
F
P
F
F
F
F
y
y
y
y
P
P
F
a
F
F
F
y
y
y
y
y
F
F
F
F
F
F
F
P
y
y
y
y
F
W
F
"}
(27,1,1) = {"
P
P
P
P
J
F
P
a
F
F
F
a
p
F
F
F
F
F
F
F
F
F
F
F
F
F
F
F
a
F
F
F
F
F
F
P
y
P
P
F
a
F
"}
(28,1,1) = {"
W
F
F
F
a
W
F
P
K
P
P
P
g
P
F
a
K
F
F
F
a
F
F
W
F
a
F
F
F
F
F
a
F
W
F
F
P
F
F
F
F
F
"}
(29,1,1) = {"
F
F
F
F
F
F
F
F
F
F
F
F
p
F
F
F
P
F
F
P
F
a
F
F
F
F
F
F
F
a
F
F
F
F
F
F
a
F
F
F
F
F
"}
(30,1,1) = {"
F
F
a
F
F
F
F
F
F
F
a
F
p
F
a
F
P
F
a
G
F
F
F
a
F
P
a
F
F
F
F
F
F
F
F
F
F
F
F
F
K
y
"}
(31,1,1) = {"
a
F
F
F
F
F
a
F
F
a
F
P
y
y
F
F
J
F
F
F
F
F
F
F
F
F
F
F
F
y
y
y
y
F
F
F
F
F
F
F
P
y
"}
(32,1,1) = {"
P
F
F
F
F
F
F
y
y
y
y
y
y
y
y
F
P
F
F
F
a
F
a
F
F
F
y
y
y
y
y
y
y
F
F
a
F
F
a
P
F
y
"}
(33,1,1) = {"
F
F
F
F
L
F
F
y
y
y
y
y
y
y
y
F
P
F
F
F
F
F
y
y
y
y
y
y
y
y
y
y
F
W
F
F
F
F
P
F
F
F
"}
(34,1,1) = {"
P
F
a
P
F
F
a
y
y
y
y
y
y
y
P
a
F
F
a
F
y
y
y
y
y
y
y
y
y
y
y
y
W
F
F
F
F
F
P
F
W
F
"}
(35,1,1) = {"
y
P
F
F
F
F
F
F
y
y
y
y
y
P
F
F
F
F
F
y
y
y
y
y
y
y
y
y
y
y
F
W
F
F
F
a
F
y
y
p
p
p
"}
(36,1,1) = {"
y
y
y
F
F
P
a
F
F
y
y
y
g
F
F
F
F
a
F
y
y
y
y
y
y
y
y
y
y
F
a
F
F
F
F
F
y
y
y
y
W
F
"}
(37,1,1) = {"
y
y
y
a
F
P
F
F
F
P
F
F
M
F
F
F
F
F
y
y
y
y
y
y
y
y
y
y
F
F
F
F
F
F
F
F
y
y
y
y
F
F
"}
(38,1,1) = {"
y
y
y
F
F
W
F
a
F
F
F
F
p
F
a
F
W
y
y
y
y
y
y
y
y
y
y
y
a
F
F
F
F
F
a
y
y
y
y
y
y
F
"}
(39,1,1) = {"
y
y
y
y
F
F
F
F
F
a
F
F
p
F
F
y
y
y
y
y
y
y
y
y
y
y
y
y
F
F
a
F
F
a
F
y
y
y
y
y
y
y
"}
(40,1,1) = {"
y
y
y
y
F
F
F
F
F
F
F
F
p
F
y
y
y
y
y
y
y
y
y
y
y
y
F
F
F
F
F
F
F
F
F
y
y
y
y
y
y
y
"}
(41,1,1) = {"
y
y
y
F
F
F
a
F
F
F
F
F
y
y
y
y
y
y
y
y
y
y
y
y
y
F
F
a
F
F
F
F
F
F
F
y
y
y
y
y
y
y
"}
(42,1,1) = {"
y
y
y
F
F
F
F
F
F
F
a
F
y
y
y
y
y
y
y
y
F
y
y
y
F
F
F
F
F
F
F
W
F
a
F
y
y
y
y
y
y
y
"}
(43,1,1) = {"
y
y
F
F
F
F
F
F
F
a
F
F
p
y
y
y
y
y
y
F
F
F
y
y
F
F
F
F
F
F
a
F
F
F
F
y
y
y
y
y
y
y
"}
(44,1,1) = {"
y
y
F
F
a
F
F
F
F
F
F
F
p
F
F
y
y
y
F
F
F
F
F
F
F
F
a
F
F
F
F
F
F
F
F
F
y
y
y
y
y
y
"}
(45,1,1) = {"
y
y
a
F
F
a
F
G
F
F
F
F
M
F
F
F
F
F
F
F
F
F
F
G
F
F
F
F
F
F
F
F
F
F
F
F
F
y
y
y
y
y
"}
(46,1,1) = {"
F
F
F
F
F
F
F
F
F
a
F
F
p
F
F
F
F
F
F
F
F
a
F
F
F
F
F
F
F
F
a
F
F
F
a
F
F
F
F
F
F
F
"}
(47,1,1) = {"
F
F
F
F
F
F
F
F
F
F
F
F
p
F
a
F
a
F
F
F
F
F
F
F
F
a
F
F
F
F
F
F
F
F
F
F
F
F
F
a
F
F
"}
(48,1,1) = {"
W
F
F
F
F
W
F
F
F
F
a
F
p
F
W
F
F
F
F
L
F
F
F
W
F
F
F
F
F
F
F
W
F
F
F
F
F
F
F
W
F
F
"}
(49,1,1) = {"
F
F
a
F
F
F
F
F
F
F
F
F
p
F
F
F
F
F
F
F
F
F
F
F
F
F
F
a
F
F
F
F
F
F
F
F
F
F
F
F
F
F
"}
(50,1,1) = {"
a
F
F
F
F
F
F
a
F
y
y
y
y
F
F
a
F
F
F
F
F
F
a
F
F
F
F
F
F
F
F
a
F
F
F
F
a
F
F
F
a
F
"}
(51,1,1) = {"
F
F
F
F
F
a
F
F
F
y
y
y
y
y
F
F
F
a
F
F
F
F
F
F
F
a
F
F
F
y
y
y
y
F
F
F
F
F
F
F
F
F
"}
(52,1,1) = {"
F
P
F
F
F
F
F
y
y
y
y
y
h
h
m
m
m
m
m
m
m
m
m
F
F
F
F
F
y
y
y
y
y
y
F
F
G
F
F
W
F
F
"}
(53,1,1) = {"
W
F
F
a
y
y
y
y
y
y
y
y
h
y
y
Z
Z
p
p
p
Z
Z
h
P
F
F
F
y
y
y
y
y
y
y
P
F
F
a
F
F
F
F
"}
(54,1,1) = {"
F
F
F
F
y
y
y
y
y
y
y
y
h
y
y
F
a
F
F
F
F
y
h
y
F
y
y
y
y
y
y
y
y
y
y
y
F
F
F
F
a
F
"}
(55,1,1) = {"
F
a
F
y
y
y
y
y
y
y
y
y
h
y
a
F
F
F
F
a
F
y
h
y
y
y
y
y
y
y
y
y
y
y
y
y
y
y
y
F
F
F
"}
(56,1,1) = {"
F
F
F
y
y
y
y
y
y
y
y
y
h
y
F
F
a
F
F
x
F
y
h
y
y
y
y
y
y
y
y
y
y
y
y
y
y
y
y
y
y
y
"}
(57,1,1) = {"
F
F
F
y
y
y
y
y
y
y
y
y
h
y
y
F
F
F
F
F
F
F
h
y
y
y
y
y
y
y
y
y
y
y
y
y
y
y
y
y
y
y
"}
(58,1,1) = {"
F
F
F
y
y
y
y
y
y
y
y
y
h
y
y
y
F
F
a
F
F
a
h
y
y
y
y
y
y
y
y
y
y
y
y
y
y
y
y
y
y
y
"}
(59,1,1) = {"
W
a
y
y
y
y
y
y
y
y
y
y
h
h
h
h
h
h
h
h
h
h
h
y
y
y
y
y
y
y
y
y
y
y
y
y
y
y
y
y
y
y
"}
(60,1,1) = {"
y
y
y
y
y
y
y
y
y
y
y
y
y
y
y
y
y
y
y
y
y
y
y
y
y
y
y
y
y
y
y
y
y
y
y
y
y
y
y
y
y
y
"}
(61,1,1) = {"
y
y
y
y
y
y
y
y
y
y
y
y
y
y
y
y
y
y
y
y
y
y
y
y
y
y
y
y
y
y
y
y
y
y
y
y
y
y
y
y
y
y
"}
(62,1,1) = {"
h
h
y
y
y
y
y
y
y
y
y
y
y
y
y
y
y
y
y
y
y
y
y
y
y
y
y
y
y
y
y
y
y
y
y
y
y
y
y
y
y
y
"}
(63,1,1) = {"
y
h
h
y
y
y
y
y
y
y
y
y
y
y
y
y
y
y
y
y
y
y
y
y
y
y
y
y
y
y
y
y
y
y
y
y
y
y
y
y
y
y
"}
(64,1,1) = {"
y
y
h
y
y
y
y
y
y
y
y
y
y
y
y
y
y
y
y
y
y
y
y
y
y
y
y
y
y
y
y
y
y
y
y
y
y
y
y
y
y
y
"}
(65,1,1) = {"
y
y
h
y
y
y
y
y
y
y
y
y
y
y
y
y
y
y
y
y
y
y
y
y
y
y
y
y
y
y
y
y
y
y
y
y
y
y
y
y
y
y
"}
(66,1,1) = {"
F
y
T
T
T
T
T
T
T
T
T
T
T
T
T
T
T
T
T
T
T
T
T
T
T
T
T
T
T
T
T
T
T
T
T
T
T
T
T
T
T
T
"}
