//MAP CONVERTED BY dmm2tgm.py THIS HEADER COMMENT PREVENTS RECONVERSION, DO NOT REMOVE
"aa" = (
/turf/closed/wall/indestructible/mineral,
/area/space)
"ab" = (
/obj/effect/decal/cleanable/dirt,
/turf/open/floor/tile/dark/red2/corner,
/area/bigredv2/caves/south)
"ac" = (
/obj/effect/landmark/corpsespawner/colonist,
/obj/effect/decal/cleanable/blood/oil,
/turf/open/floor/tile/dark/red2/corner,
/area/bigredv2/caves/south)
"ad" = (
/obj/effect/decal/cleanable/dirt,
/obj/effect/decal/sandedge{
	dir = 4
	},
/turf/open/floor/tile/dark/red2/corner{
	dir = 8
	},
/area/bigredv2/caves/south)
"ae" = (
/obj/machinery/door/airlock/multi_tile/mainship/generic,
/obj/effect/ai_node,
/turf/open/floor/tile/dark/yellow2/corner,
/area/bigredv2/outside/nanotrasen_lab/inside)
"af" = (
/turf/open/floor/tile/dark/red2/corner,
/area/bigredv2/caves/south)
"ag" = (
/obj/effect/landmark/weed_node,
/turf/open/floor/plating/ground/mars/random/cave,
/area/bigredv2/caves/south)
"ah" = (
/obj/effect/decal/cleanable/dirt,
/obj/machinery/door/airlock/multi_tile/mainship/generic{
	dir = 2
	},
/obj/effect/decal/sandedge{
	dir = 4
	},
/turf/open/floor/tile/dark/red2/corner{
	dir = 8
	},
/area/bigredv2/caves/south)
"ai" = (
/obj/machinery/door/airlock/multi_tile/mainship/generic{
	dir = 2
	},
/obj/effect/decal/sandedge{
	dir = 8
	},
/turf/open/floor/tile/dark/red2/corner{
	dir = 8
	},
/area/bigredv2/caves/south)
"aj" = (
/obj/effect/landmark/lv624/fog_blocker,
/turf/closed/mineral/bigred,
/area/bigredv2/caves/rock)
"ak" = (
/obj/effect/landmark/weed_node,
/obj/effect/ai_node,
/turf/open/floor/tile/dark/red2/corner{
	dir = 8
	},
/area/bigredv2/caves/south)
"al" = (
/obj/effect/decal/cleanable/dirt,
/turf/closed/wall/r_wall,
/area/bigredv2/caves/south)
"am" = (
/turf/open/floor/plating/ground/mars/random/cave,
/area/bigredv2/caves/south)
"an" = (
/obj/structure/table,
/obj/machinery/computer/security,
/turf/open/floor/tile/dark/red2/corner{
	dir = 8
	},
/area/bigredv2/caves/south)
"ao" = (
/turf/open/floor/tile/dark/yellow2/corner,
/area/bigredv2/outside/nanotrasen_lab/inside)
"ap" = (
/obj/machinery/light,
/obj/effect/landmark/weed_node,
/turf/open/floor/tile/dark/red2/corner,
/area/bigredv2/caves/south)
"aq" = (
/obj/effect/decal/cleanable/dirt,
/obj/effect/decal/sandedge{
	dir = 4
	},
/turf/open/floor/tile/dark/red2/corner{
	dir = 8
	},
/area/bigredv2/caves/south)
"ar" = (
/obj/effect/landmark/weed_node,
/turf/open/floor/tile/dark/yellow2/corner,
/area/bigredv2/caves/south)
"as" = (
/turf/closed/wall/r_wall,
/area/bigredv2/caves/south)
"at" = (
/turf/closed/mineral/bigred,
/area/bigredv2/caves/rock)
"au" = (
/obj/effect/landmark/weed_node,
/turf/open/floor/plating/ground/mars/random/cave,
/area/bigredv2/caves/south)
"av" = (
/turf/open/floor/tile/dark/red2/corner{
	dir = 8
	},
/area/bigredv2/caves/south)
"aw" = (
/obj/machinery/door/airlock/multi_tile/mainship/generic{
	dir = 2
	},
/obj/effect/decal/sandedge{
	dir = 8
	},
/turf/open/floor/tile/dark/red2/corner{
	dir = 8
	},
/area/bigredv2/caves/south)
"ax" = (
/obj/effect/decal/cleanable/dirt,
/obj/structure/rack,
/obj/item/storage/belt/gun/pistol/m4a3/full,
/obj/item/storage/belt/gun/pistol/m4a3/officer,
/turf/open/floor/tile/dark/red2/corner,
/area/bigredv2/caves/south)
"ay" = (
/turf/closed/wall/r_wall,
/area/bigredv2/outside/nanotrasen_lab/inside)
"az" = (
/obj/effect/landmark/lv624/fog_blocker,
/turf/open/floor/tile/dark/yellow2/corner,
/area/bigredv2/caves/south)
"aA" = (
/turf/closed/mineral/smooth/bigred,
/area/bigredv2/caves/rock)
"aB" = (
/obj/machinery/light,
/obj/effect/landmark/weed_node,
/turf/open/floor/tile/dark/red2/corner,
/area/bigredv2/caves/south)
"aC" = (
/obj/effect/landmark/lv624/fog_blocker,
/turf/closed/wall/r_wall,
/area/bigredv2/outside/nanotrasen_lab/inside)
"aD" = (
/obj/effect/landmark/corpsespawner/colonist,
/obj/effect/decal/cleanable/blood/oil,
/turf/open/floor/tile/dark/red2/corner,
/area/bigredv2/caves/south)
"aE" = (
/obj/effect/landmark/corpsespawner/colonist,
/obj/effect/decal/cleanable/blood/oil,
/turf/open/floor/plating/ground/mars/random/cave,
/area/bigredv2/caves/south)
"aF" = (
/obj/structure/rack,
/obj/item/storage/belt/gun/revolver,
/obj/item/storage/belt/gun/pistol/m4a3/officer,
/turf/open/floor/tile/dark/red2/corner{
	dir = 8
	},
/area/bigredv2/caves/south)
"aG" = (
/turf/closed/wall/r_wall/unmeltable,
/area/bigredv2/caves/south)
"aH" = (
/obj/structure/closet/secure_closet/security,
/turf/open/floor/tile/dark/red2/corner{
	dir = 8
	},
/area/bigredv2/caves/south)
"aI" = (
/obj/effect/decal/cleanable/dirt,
/turf/closed/wall/r_wall/unmeltable,
/area/bigredv2/caves/south)
"aJ" = (
/obj/effect/decal/cleanable/dirt,
/turf/open/floor/tile/dark/red2/corner,
/area/bigredv2/caves/south)
"aK" = (
/turf/open/floor/tile/dark/yellow2/corner,
/area/bigredv2/caves/south)
"aL" = (
/obj/effect/decal/sandedge{
	dir = 8
	},
/turf/open/floor/tile/dark/red2/corner{
	dir = 8
	},
/area/bigredv2/caves/south)
"aM" = (
/obj/effect/landmark/corpsespawner/colonist,
/obj/effect/decal/cleanable/blood/oil,
/turf/open/floor/plating/ground/mars/random/cave,
/area/bigredv2/caves/south)
"aN" = (
/obj/effect/ai_node,
/turf/open/floor/plating/ground/mars/random/cave,
/area/bigredv2/caves/south)
"aO" = (
/obj/structure/bed/chair/office/light{
	dir = 1
	},
/turf/open/floor/tile/dark/red2/corner{
	dir = 8
	},
/area/bigredv2/caves/south)
"aP" = (
/obj/structure/table,
/obj/item/storage/belt/gun/pistol,
/turf/open/floor/tile/dark/red2/corner,
/area/bigredv2/caves/south)
"aQ" = (
/obj/effect/decal/cleanable/dirt,
/turf/closed/wall/r_wall/unmeltable,
/area/bigredv2/caves/south)
"aR" = (
/turf/closed/mineral/smooth/bigred/indestructible,
/area/space)
"aS" = (
/obj/effect/landmark/weed_node,
/obj/effect/ai_node,
/turf/open/floor/tile/dark/red2/corner{
	dir = 8
	},
/area/bigredv2/caves/south)
"aT" = (
/obj/effect/landmark/lv624/fog_blocker,
/turf/closed/wall/r_wall,
/area/bigredv2/caves/south)
"aU" = (
/obj/effect/decal/cleanable/dirt,
/obj/machinery/door/airlock/multi_tile/mainship/generic{
	dir = 2
	},
/obj/effect/decal/sandedge{
	dir = 4
	},
/turf/open/floor/tile/dark/red2/corner{
	dir = 8
	},
/area/bigredv2/caves/south)
"aV" = (
/obj/effect/decal/cleanable/dirt,
/turf/closed/wall/r_wall,
/area/bigredv2/caves/south)
"aW" = (
/obj/effect/ai_node,
/turf/open/floor/plating/ground/mars/random/cave,
/area/bigredv2/caves/south)
"aX" = (
/obj/effect/landmark/weed_node,
/turf/open/floor/tile/dark/red2/corner{
	dir = 8
	},
/area/bigredv2/caves/south)
"aY" = (
/obj/machinery/light{
	dir = 8
	},
/turf/open/floor/plating/ground/mars/random/cave,
/area/bigredv2/caves/south)
"aZ" = (
/obj/effect/decal/cleanable/dirt,
/obj/structure/rack,
/obj/item/storage/belt/gun/pistol/m4a3/full,
/obj/item/storage/belt/gun/pistol/m4a3/officer,
/turf/open/floor/tile/dark/red2/corner,
/area/bigredv2/caves/south)
"dW" = (
/obj/effect/landmark/weed_node,
/turf/open/floor/tile/dark/red2/corner{
	dir = 8
	},
/area/bigredv2/caves/south)
"fq" = (
/obj/effect/landmark/lv624/fog_blocker,
/turf/closed/wall/r_wall,
/area/bigredv2/outside/nanotrasen_lab/inside)
"zG" = (
/obj/effect/landmark/weed_node,
/turf/open/floor/tile/dark/yellow2/corner,
/area/bigredv2/caves/south)
"DZ" = (
/obj/machinery/door/airlock/multi_tile/mainship/generic,
/obj/effect/ai_node,
/turf/open/floor/tile/dark/yellow2/corner,
/area/bigredv2/outside/nanotrasen_lab/inside)
"Ji" = (
/obj/effect/landmark/lv624/fog_blocker,
/turf/closed/wall/r_wall,
/area/bigredv2/caves/south)
"PS" = (
/obj/effect/decal/sandedge{
	dir = 8
	},
/turf/open/floor/tile/dark/red2/corner{
	dir = 8
	},
/area/bigredv2/caves/south)
"SE" = (
/obj/effect/landmark/lv624/fog_blocker,
/turf/open/floor/tile/dark/yellow2/corner,
/area/bigredv2/caves/south)
"YJ" = (
/obj/effect/landmark/lv624/fog_blocker,
/turf/closed/mineral/smooth/bigred,
/area/bigredv2/caves/rock)

(1,1,1) = {"
ay
YJ
as
al
ad
aU
al
aI
aA
aR
"}
(2,1,1) = {"
ay
YJ
as
an
aO
av
av
aI
aA
aR
"}
(3,1,1) = {"
ay
Ji
as
aP
af
ac
ap
aI
aA
aR
"}
(4,1,1) = {"
DZ
SE
aK
av
ak
av
as
aI
aA
aR
"}
(5,1,1) = {"
ao
SE
zG
ab
ab
ab
aZ
aI
aA
aR
"}
(6,1,1) = {"
ay
YJ
as
aH
av
av
aF
aG
aA
aR
"}
(7,1,1) = {"
ay
YJ
as
aH
av
av
as
aG
aA
aR
"}
(8,1,1) = {"
ay
YJ
as
av
dW
av
av
aG
aA
aR
"}
(9,1,1) = {"
ay
YJ
as
as
PS
aw
as
aG
aA
aR
"}
(10,1,1) = {"
ay
YJ
aA
aY
am
am
am
am
aA
aR
"}
(11,1,1) = {"
ay
YJ
aA
am
am
am
am
aM
aA
aR
"}
(12,1,1) = {"
ay
YJ
aA
am
aN
au
au
am
aA
aR
"}
(13,1,1) = {"
ay
YJ
aA
aA
am
aN
am
am
aA
aR
"}
(14,1,1) = {"
ay
YJ
aA
aA
aA
am
am
am
aA
aR
"}
(15,1,1) = {"
ay
YJ
aA
aA
aA
am
am
au
aA
aR
"}
(16,1,1) = {"
ay
YJ
aA
aA
aA
au
am
am
aA
aR
"}
(17,1,1) = {"
ay
YJ
aA
aA
am
am
am
am
aA
aR
"}
(18,1,1) = {"
ay
YJ
aA
aA
am
am
am
am
aA
aR
"}
(19,1,1) = {"
ay
YJ
aA
aA
am
am
am
am
aA
aR
"}
(20,1,1) = {"
ay
YJ
aA
aA
am
am
am
am
aA
aR
"}
(21,1,1) = {"
ay
YJ
aA
aA
am
aN
am
aA
aA
aR
"}
(22,1,1) = {"
ay
YJ
aA
aA
am
au
am
aA
aA
aR
"}
(23,1,1) = {"
fq
YJ
aA
aA
am
am
am
aA
aA
aR
"}
