//MAP CONVERTED BY dmm2tgm.py THIS HEADER COMMENT PREVENTS RECONVERSION, DO NOT REMOVE
"a" = (
/turf/closed/mineral/smooth/bigred/indestructible,
/area/space)
"b" = (
/obj/effect/landmark/weed_node,
/turf/open/floor/plating/ground/mars/random/cave,
/area/bigredv2/caves/south)
"c" = (
/obj/effect/landmark/lv624/fog_blocker,
/turf/open/floor/plating/ground/mars/random/cave,
/area/bigredv2/caves/south)
"e" = (
/obj/effect/landmark/lv624/fog_blocker,
/obj/effect/ai_node,
/turf/open/floor/plating/ground/mars/random/cave,
/area/bigredv2/caves/south)
"l" = (
/obj/effect/landmark/lv624/fog_blocker,
/turf/closed/mineral/smooth/bigred,
/area/bigredv2/caves/rock)
"r" = (
/obj/effect/landmark/lv624/fog_blocker,
/turf/closed/wall/r_wall,
/area/bigredv2/outside/nanotrasen_lab/inside)
"x" = (
/turf/open/floor/plating/ground/mars/random/cave,
/area/bigredv2/caves/south)
"I" = (
/obj/effect/landmark/weed_node,
/obj/effect/ai_node,
/turf/open/floor/plating/ground/mars/random/cave,
/area/bigredv2/caves/south)
"M" = (
/obj/effect/ai_node,
/turf/open/floor/plating/ground/mars/random/cave,
/area/bigredv2/caves/south)
"Q" = (
/turf/closed/wall/r_wall,
/area/bigredv2/outside/nanotrasen_lab/inside)
"R" = (
/turf/closed/mineral/smooth/bigred,
/area/bigredv2/caves/rock)

(1,1,1) = {"
Q
l
R
b
x
x
b
R
R
a
"}
(2,1,1) = {"
Q
l
R
x
x
x
x
R
R
a
"}
(3,1,1) = {"
Q
l
x
x
b
x
x
b
R
a
"}
(4,1,1) = {"
Q
e
x
x
M
x
x
M
R
a
"}
(5,1,1) = {"
Q
c
x
x
b
x
b
x
R
a
"}
(6,1,1) = {"
Q
c
x
x
x
x
x
x
R
a
"}
(7,1,1) = {"
Q
l
x
b
x
x
x
b
R
a
"}
(8,1,1) = {"
Q
l
R
x
x
x
x
x
R
a
"}
(9,1,1) = {"
Q
l
R
R
M
b
x
I
R
a
"}
(10,1,1) = {"
Q
l
R
R
x
x
x
x
R
a
"}
(11,1,1) = {"
Q
l
R
R
x
x
x
x
R
a
"}
(12,1,1) = {"
Q
l
R
R
b
x
b
x
R
a
"}
(13,1,1) = {"
Q
l
R
R
x
x
x
x
R
a
"}
(14,1,1) = {"
Q
l
R
x
b
x
b
x
R
a
"}
(15,1,1) = {"
Q
l
x
x
M
x
x
M
R
a
"}
(16,1,1) = {"
Q
e
x
M
b
x
x
x
R
a
"}
(17,1,1) = {"
Q
c
x
x
x
b
x
b
R
a
"}
(18,1,1) = {"
Q
c
x
x
x
x
x
x
R
a
"}
(19,1,1) = {"
Q
e
x
x
I
x
x
I
R
a
"}
(20,1,1) = {"
Q
l
R
R
x
x
x
x
R
a
"}
(21,1,1) = {"
Q
l
R
R
b
x
x
R
R
a
"}
(22,1,1) = {"
Q
l
R
R
x
x
x
R
R
a
"}
(23,1,1) = {"
r
l
R
R
M
x
b
R
R
a
"}
