//MAP CONVERTED BY dmm2tgm.py THIS HEADER COMMENT PREVENTS RECONVERSION, DO NOT REMOVE
"b" = (
/turf/closed/mineral/smooth/bigred,
/area/bigredv2/caves/rock)
"e" = (
/obj/effect/landmark/lv624/fog_blocker,
/turf/closed/mineral/smooth/bigred,
/area/bigredv2/caves/rock)
"h" = (
/turf/open/floor/plating/ground/mars/random/cave,
/area/bigredv2/caves/northeast)
"k" = (
/turf/open/floor/plating/ground/mars/random/cave,
/area/bigredv2/caves/east)
"l" = (
/obj/effect/ai_node,
/turf/open/floor/plating/ground/mars/random/cave,
/area/bigredv2/caves/east)
"p" = (
/obj/effect/landmark/weed_node,
/obj/effect/ai_node,
/turf/open/floor/plating/ground/mars/random/cave,
/area/bigredv2/caves/east)
"r" = (
/obj/effect/landmark/weed_node,
/turf/open/floor/plating/ground/mars/random/cave,
/area/bigredv2/caves/east)
"t" = (
/obj/effect/landmark/lv624/fog_blocker,
/obj/effect/ai_node,
/turf/open/floor/plating/ground/mars/random/cave,
/area/bigredv2/caves/east)
"z" = (
/turf/open/floor/plating/ground/mars/random/cave/rock,
/area/bigredv2/caves/east)
"K" = (
/obj/effect/landmark/weed_node,
/turf/open/floor/plating/ground/mars/random/cave,
/area/bigredv2/caves/northeast)
"Q" = (
/obj/effect/landmark/start/job/xenomorph,
/obj/effect/landmark/weed_node,
/turf/open/floor/plating/ground/mars/random/cave,
/area/bigredv2/caves/east)
"U" = (
/obj/effect/ai_node,
/turf/open/floor/plating/ground/mars/random/cave,
/area/bigredv2/caves/northeast)
"X" = (
/obj/effect/landmark/lv624/fog_blocker,
/turf/open/floor/plating/ground/mars/random/cave,
/area/bigredv2/caves/east)

(1,1,1) = {"
b
b
b
b
b
b
b
b
b
b
b
"}
(2,1,1) = {"
b
b
b
b
b
b
b
b
b
b
b
"}
(3,1,1) = {"
b
b
b
b
b
b
b
b
b
b
b
"}
(4,1,1) = {"
b
b
b
b
b
b
b
b
b
b
b
"}
(5,1,1) = {"
b
b
b
b
b
b
b
b
b
b
b
"}
(6,1,1) = {"
K
b
b
k
r
k
l
k
b
b
b
"}
(7,1,1) = {"
h
k
k
k
r
k
k
r
k
z
z
"}
(8,1,1) = {"
U
r
k
l
k
k
l
k
k
p
X
"}
(9,1,1) = {"
h
k
k
k
b
b
b
b
k
X
l
"}
(10,1,1) = {"
U
k
r
k
b
b
b
b
b
t
k
"}
(11,1,1) = {"
K
k
r
k
k
b
k
e
e
k
Q
"}
(12,1,1) = {"
h
k
r
k
r
k
X
z
r
k
l
"}
(13,1,1) = {"
U
r
k
l
k
X
k
k
k
l
b
"}
(14,1,1) = {"
b
k
k
b
r
X
b
b
k
b
b
"}
(15,1,1) = {"
b
b
b
b
b
e
b
b
b
b
b
"}
(16,1,1) = {"
b
b
b
b
b
e
b
b
b
b
b
"}
(17,1,1) = {"
b
b
b
b
b
e
b
b
b
b
b
"}
(18,1,1) = {"
b
b
b
b
b
e
b
b
b
b
b
"}
(19,1,1) = {"
b
b
b
b
b
e
b
b
b
b
b
"}
(20,1,1) = {"
b
b
b
b
b
e
b
b
b
b
b
"}
(21,1,1) = {"
b
b
b
b
b
e
b
b
b
b
b
"}
(22,1,1) = {"
e
e
e
e
e
b
b
b
b
b
b
"}
