//MAP CONVERTED BY dmm2tgm.py THIS HEADER COMMENT PREVENTS RECONVERSION, DO NOT REMOVE
"a" = (
/turf/closed/mineral/bigred,
/area/bigredv2/caves/rock)
"o" = (
/turf/open/floor/plating/ground/mars/random/cave,
/area/bigredv2/caves/northeast)
"v" = (
/atom/movable/effect/landmark/lv624/fog_blocker,
/turf/open/floor/plating/ground/mars/random/cave,
/area/bigredv2/caves/east)
"w" = (
/atom/movable/effect/landmark/weed_node,
/turf/open/floor/plating/ground/mars/random/cave,
/area/bigredv2/caves/east)
"x" = (
/atom/movable/effect/ai_node,
/turf/open/floor/plating/ground/mars/random/cave,
/area/bigredv2/caves/northeast)
"z" = (
/turf/open/floor/plating/ground/mars/random/cave/rock,
/area/bigredv2/caves/east)
"A" = (
/atom/movable/effect/landmark/weed_node,
/turf/open/floor/plating/ground/mars/random/cave,
/area/bigredv2/caves/northeast)
"D" = (
/atom/movable/effect/landmark/lv624/fog_blocker,
/atom/movable/effect/ai_node,
/turf/open/floor/plating/ground/mars/random/cave,
/area/bigredv2/caves/east)
"F" = (
/atom/movable/effect/landmark/start/job/xenomorph,
/atom/movable/effect/landmark/weed_node,
/turf/open/floor/plating/ground/mars/random/cave,
/area/bigredv2/caves/east)
"O" = (
/atom/movable/effect/ai_node,
/turf/open/floor/plating/ground/mars/random/cave,
/area/bigredv2/caves/east)
"S" = (
/turf/open/floor/plating/ground/mars/random/cave,
/area/bigredv2/caves/east)
"T" = (
/atom/movable/effect/landmark/weed_node,
/atom/movable/effect/ai_node,
/turf/open/floor/plating/ground/mars/random/cave,
/area/bigredv2/caves/east)
"Y" = (
/atom/movable/effect/landmark/lv624/fog_blocker,
/turf/closed/mineral/bigred,
/area/bigredv2/caves/rock)

(1,1,1) = {"
a
a
a
a
a
a
a
a
a
a
a
"}
(2,1,1) = {"
a
a
a
a
a
a
a
a
a
a
a
"}
(3,1,1) = {"
a
a
a
a
a
a
a
a
a
a
a
"}
(4,1,1) = {"
a
a
a
a
a
a
a
a
a
a
a
"}
(5,1,1) = {"
a
a
a
a
a
a
a
a
a
a
a
"}
(6,1,1) = {"
A
a
a
S
w
S
O
S
a
a
a
"}
(7,1,1) = {"
o
S
S
S
w
S
S
w
S
z
z
"}
(8,1,1) = {"
x
w
S
S
S
S
S
S
S
T
v
"}
(9,1,1) = {"
o
O
S
S
w
S
O
w
S
v
O
"}
(10,1,1) = {"
x
S
w
S
S
w
S
S
S
D
S
"}
(11,1,1) = {"
A
S
w
S
S
S
S
v
v
S
F
"}
(12,1,1) = {"
o
S
w
S
w
S
v
z
w
S
O
"}
(13,1,1) = {"
x
w
S
O
S
v
S
S
S
O
a
"}
(14,1,1) = {"
a
S
S
a
w
v
a
a
S
a
a
"}
(15,1,1) = {"
a
a
a
a
a
Y
a
a
a
a
a
"}
(16,1,1) = {"
a
a
a
a
a
Y
a
a
a
a
a
"}
(17,1,1) = {"
a
a
a
a
a
Y
a
a
a
a
a
"}
(18,1,1) = {"
a
a
a
a
a
Y
a
a
a
a
a
"}
(19,1,1) = {"
a
a
a
a
a
Y
a
a
a
a
a
"}
(20,1,1) = {"
a
a
a
a
a
Y
a
a
a
a
a
"}
(21,1,1) = {"
a
a
a
a
a
Y
a
a
a
a
a
"}
(22,1,1) = {"
Y
Y
Y
Y
Y
a
a
a
a
a
a
"}
