//MAP CONVERTED BY dmm2tgm.py THIS HEADER COMMENT PREVENTS RECONVERSION, DO NOT REMOVE
"e" = (
/obj/effect/ai_node,
/turf/open/floor/plating/ground/mars/random/cave,
/area/bigredv2/caves/east)
"g" = (
/obj/effect/landmark/lv624/fog_blocker,
/turf/open/floor/plating/ground/mars/random/cave,
/area/bigredv2/caves/east)
"l" = (
/turf/open/floor/plating/ground/mars/random/cave/rock,
/area/bigredv2/caves/east)
"m" = (
/obj/effect/landmark/lv624/fog_blocker,
/obj/effect/ai_node,
/turf/open/floor/plating/ground/mars/random/cave,
/area/bigredv2/caves/east)
"s" = (
/turf/open/floor/plating/ground/mars/random/cave,
/area/bigredv2/caves/east)
"w" = (
/turf/closed/mineral/smooth/bigred,
/area/bigredv2/caves/rock)
"x" = (
/obj/effect/ai_node,
/turf/open/floor/plating/ground/mars/random/cave,
/area/bigredv2/caves/northeast)
"y" = (
/obj/effect/landmark/start/job/xenomorph,
/obj/effect/landmark/weed_node,
/turf/open/floor/plating/ground/mars/random/cave,
/area/bigredv2/caves/east)
"E" = (
/obj/effect/ai_node,
/turf/open/floor/plating/ground/mars/random/cave/rock,
/area/bigredv2/caves/east)
"J" = (
/obj/effect/landmark/lv624/fog_blocker,
/turf/closed/mineral/smooth/bigred,
/area/bigredv2/caves/rock)
"N" = (
/obj/effect/ai_node,
/turf/open/floor/plating/ground/mars/random/cave/rock,
/area/bigredv2/caves/northeast)
"Q" = (
/turf/open/floor/plating/ground/mars/random/cave,
/area/bigredv2/caves/northeast)
"X" = (
/obj/effect/landmark/weed_node,
/turf/open/floor/plating/ground/mars/random/cave,
/area/bigredv2/caves/northeast)
"Z" = (
/obj/effect/landmark/weed_node,
/turf/open/floor/plating/ground/mars/random/cave,
/area/bigredv2/caves/east)

(1,1,1) = {"
w
w
w
w
w
w
w
w
w
w
w
"}
(2,1,1) = {"
w
w
w
w
w
w
w
w
w
w
w
"}
(3,1,1) = {"
w
w
w
w
w
w
w
w
w
w
w
"}
(4,1,1) = {"
w
w
w
w
w
w
w
w
w
w
w
"}
(5,1,1) = {"
N
w
w
w
w
w
w
w
w
w
w
"}
(6,1,1) = {"
Q
w
w
w
w
w
w
w
w
w
w
"}
(7,1,1) = {"
Q
s
w
w
w
w
w
w
w
l
l
"}
(8,1,1) = {"
Q
Z
s
w
w
w
w
w
s
Z
g
"}
(9,1,1) = {"
Q
s
s
w
w
w
Z
s
s
g
e
"}
(10,1,1) = {"
x
s
Z
s
e
s
s
E
s
m
s
"}
(11,1,1) = {"
X
s
Z
s
s
s
s
g
g
s
y
"}
(12,1,1) = {"
Q
s
s
s
Z
s
g
l
s
s
e
"}
(13,1,1) = {"
x
Z
s
s
s
g
s
s
s
w
w
"}
(14,1,1) = {"
w
s
s
s
Z
g
s
Z
s
w
w
"}
(15,1,1) = {"
w
w
w
s
e
g
s
e
w
w
w
"}
(16,1,1) = {"
w
w
w
w
s
g
s
w
w
w
w
"}
(17,1,1) = {"
w
w
w
w
w
J
w
w
w
w
w
"}
(18,1,1) = {"
w
w
w
w
w
J
w
w
w
w
w
"}
(19,1,1) = {"
w
w
w
w
w
J
w
w
w
w
w
"}
(20,1,1) = {"
w
w
w
w
w
J
w
w
w
w
w
"}
(21,1,1) = {"
w
w
w
w
w
J
w
w
w
w
w
"}
(22,1,1) = {"
J
J
J
J
J
w
w
w
w
w
w
"}
