//MAP CONVERTED BY dmm2tgm.py THIS HEADER COMMENT PREVENTS RECONVERSION, DO NOT REMOVE
"ag" = (
/obj/effect/decal/cleanable/blood,
/turf/open/floor/carpet/side{
	dir = 8
	},
/area/bigredv2/outside/library)
"aV" = (
/obj/machinery/atmospherics/pipe/simple/green/hidden,
/turf/open/floor/marking/asteroidwarning{
	dir = 8
	},
/area/bigredv2/outside/e)
"cB" = (
/obj/structure/table/woodentable,
/obj/item/toy/dice/d20,
/obj/item/paper/crumpled,
/turf/open/floor/wood,
/area/bigredv2/outside/library)
"cF" = (
/obj/machinery/light{
	dir = 4
	},
/turf/open/floor/wood,
/area/bigredv2/outside/library)
"cM" = (
/turf/open/floor/carpet/side{
	dir = 8
	},
/area/bigredv2/outside/library)
"de" = (
/obj/machinery/light{
	dir = 4
	},
/obj/structure/table/woodentable,
/obj/effect/spawner/random/food_or_drink/drink_alcohol_bottle,
/obj/effect/spawner/random/food_or_drink/drink_alcohol_bottle{
	pixel_x = 1;
	pixel_y = 5
	},
/obj/effect/spawner/random/food_or_drink/drink_alcohol_bottle{
	pixel_y = 2
	},
/obj/effect/spawner/random/food_or_drink/drink_alcohol_bottle{
	pixel_x = -4;
	pixel_y = 3
	},
/obj/effect/spawner/random/food_or_drink/drink_alcohol_bottle,
/obj/effect/spawner/random/food_or_drink/drink_alcohol_bottle,
/obj/item/pizzabox/meat{
	pixel_x = -5;
	pixel_y = 12
	},
/turf/open/floor/wood,
/area/bigredv2/outside/library)
"dx" = (
/obj/machinery/atmospherics/pipe/simple/green/hidden,
/obj/item/paper,
/turf/open/floor/carpet/side{
	dir = 4
	},
/area/bigredv2/outside/library)
"eI" = (
/obj/machinery/atmospherics/pipe/simple/green/hidden,
/turf/open/floor/carpet/side{
	dir = 5
	},
/area/bigredv2/outside/library)
"eV" = (
/obj/effect/landmark/weed_node,
/obj/effect/ai_node,
/obj/item/shard,
/turf/open/floor/wood,
/area/bigredv2/outside/library)
"fU" = (
/obj/item/toy/dice/d20,
/turf/open/floor/wood,
/area/bigredv2/outside/library)
"gs" = (
/obj/structure/cable,
/obj/machinery/atmospherics/pipe/simple/green/hidden,
/obj/effect/ai_node,
/turf/open/floor/wood,
/area/bigredv2/outside/library)
"iG" = (
/obj/machinery/atmospherics/pipe/manifold/green/hidden{
	dir = 4
	},
/obj/effect/ai_node,
/obj/effect/spawner/random/misc/trash,
/turf/open/floor/wood,
/area/bigredv2/outside/library)
"jI" = (
/obj/structure/cable,
/obj/machinery/atmospherics/components/unary/vent_pump{
	dir = 8;
	on = 1
	},
/turf/open/floor/wood,
/area/bigredv2/outside/library)
"jK" = (
/turf/closed/wall,
/area/bigredv2/outside/library)
"ka" = (
/obj/effect/landmark/corpsespawner/colonist,
/obj/effect/decal/cleanable/blood,
/turf/open/floor/carpet/side{
	dir = 5
	},
/area/bigredv2/outside/library)
"ke" = (
/obj/effect/ai_node,
/turf/open/floor/wood,
/area/bigredv2/outside/library)
"kf" = (
/obj/machinery/door_control{
	dir = 8;
	id = "Library";
	name = "Storm Shutters"
	},
/turf/open/floor/wood,
/area/bigredv2/outside/library)
"kP" = (
/obj/structure/cable,
/obj/machinery/atmospherics/pipe/simple/green/hidden{
	dir = 9
	},
/obj/effect/decal/cleanable/blood/drip,
/turf/open/floor/wood,
/area/bigredv2/outside/library)
"lw" = (
/obj/effect/decal/cleanable/blood,
/turf/open/floor/wood,
/area/bigredv2/outside/library)
"lG" = (
/obj/structure/cable,
/obj/machinery/atmospherics/pipe/simple/green/hidden{
	dir = 4
	},
/obj/machinery/door/airlock/mainship/generic{
	name = "\improper Library Backroom"
	},
/obj/effect/ai_node,
/turf/open/floor/wood,
/area/bigredv2/outside/library)
"nb" = (
/turf/open/floor/carpet/side{
	dir = 1
	},
/area/bigredv2/outside/library)
"nr" = (
/obj/structure/bookcase{
	density = 0
	},
/obj/effect/landmark/weed_node,
/turf/open/floor/wood,
/area/bigredv2/outside/library)
"nL" = (
/turf/open/floor/carpet/side{
	dir = 9
	},
/area/bigredv2/outside/library)
"qw" = (
/obj/machinery/atmospherics/pipe/simple/green/hidden{
	dir = 4
	},
/obj/structure/cable,
/turf/open/floor/wood,
/area/bigredv2/outside/library)
"rc" = (
/obj/effect/landmark/corpsespawner/colonist,
/obj/effect/decal/cleanable/blood,
/turf/open/floor/wood,
/area/bigredv2/outside/library)
"rt" = (
/obj/machinery/air_alarm{
	dir = 4
	},
/turf/open/floor/wood,
/area/bigredv2/outside/library)
"rL" = (
/obj/effect/spawner/random/misc/structure/broken_window/colonyspawn,
/obj/machinery/door/poddoor/shutters/mainship{
	id = "Library";
	name = "\improper Library Shutters"
	},
/turf/open/floor/plating,
/area/bigredv2/outside/library)
"rO" = (
/obj/structure/table/woodentable,
/obj/item/pizzabox/meat{
	pixel_x = -5;
	pixel_y = 12
	},
/turf/open/floor/wood,
/area/bigredv2/outside/library)
"so" = (
/obj/machinery/atmospherics/pipe/simple/green/hidden,
/obj/effect/landmark/corpsespawner/security,
/obj/effect/decal/cleanable/blood,
/turf/open/floor/carpet/side{
	dir = 4
	},
/area/bigredv2/outside/library)
"up" = (
/obj/effect/landmark/weed_node,
/turf/open/floor/carpet/side{
	dir = 6
	},
/area/bigredv2/outside/library)
"uy" = (
/obj/structure/bookcase{
	density = 0
	},
/turf/open/floor/wood,
/area/bigredv2/outside/library)
"uM" = (
/obj/machinery/atmospherics/pipe/simple/green/hidden{
	dir = 4
	},
/obj/structure/cable,
/obj/machinery/door/airlock/mainship/medical/glass/free_access{
	name = "\improper Greenhouse Storage"
	},
/turf/open/floor/wood,
/area/bigredv2/outside/library)
"ve" = (
/obj/effect/spawner/random/misc/trash,
/turf/open/floor/carpet/side,
/area/bigredv2/outside/library)
"vN" = (
/obj/machinery/light{
	dir = 4
	},
/obj/machinery/power/apc,
/obj/structure/cable,
/obj/effect/ai_node,
/turf/open/floor/wood,
/area/bigredv2/outside/library)
"vX" = (
/obj/structure/table/woodentable,
/obj/item/pizzabox/meat{
	pixel_x = -5;
	pixel_y = 12
	},
/obj/item/pizzabox/meat{
	pixel_x = -5;
	pixel_y = 12
	},
/obj/item/reagent_containers/food/drinks/bottle/absinthe,
/turf/open/floor/wood,
/area/bigredv2/outside/library)
"wI" = (
/obj/structure/nuke_disk_candidate,
/turf/open/floor/wood,
/area/bigredv2/outside/library)
"xB" = (
/obj/structure/table/woodentable,
/obj/item/toy/dice/d20,
/obj/item/reagent_containers/food/snacks/pizzapasta/meatpizzaslice,
/obj/effect/spawner/random/food_or_drink/drink_alcohol_bottle{
	pixel_x = -1;
	pixel_y = 3
	},
/obj/effect/spawner/random/food_or_drink/drink_alcohol_bottle,
/turf/open/floor/wood,
/area/bigredv2/outside/library)
"yE" = (
/obj/item/trash/chunk{
	pixel_x = -3;
	pixel_y = 4
	},
/turf/open/floor/wood,
/area/bigredv2/outside/library)
"zM" = (
/obj/machinery/atmospherics/pipe/simple/green/hidden,
/turf/open/floor/carpet,
/area/bigredv2/outside/library)
"AA" = (
/obj/machinery/atmospherics/pipe/simple/green/hidden{
	dir = 4
	},
/obj/structure/cable,
/obj/effect/landmark/corpsespawner/colonist,
/obj/effect/decal/cleanable/blood,
/turf/open/floor/wood,
/area/bigredv2/outside/library)
"BC" = (
/obj/machinery/atmospherics/pipe/simple/green/hidden,
/obj/effect/ai_node,
/turf/open/floor/carpet/side{
	dir = 4
	},
/area/bigredv2/outside/library)
"CH" = (
/obj/effect/decal/cleanable/vomit,
/turf/open/floor/carpet/side{
	dir = 8
	},
/area/bigredv2/outside/library)
"CM" = (
/obj/machinery/atmospherics/pipe/simple/green/hidden{
	dir = 5
	},
/obj/effect/landmark/weed_node,
/turf/open/floor/carpet/side,
/area/bigredv2/outside/library)
"Ey" = (
/turf/open/floor/wood,
/area/bigredv2/outside/library)
"Ez" = (
/obj/structure/table/woodentable,
/obj/item/reagent_containers/food/snacks/pizzapasta/meatpizzaslice{
	pixel_x = -3;
	pixel_y = 4
	},
/obj/effect/spawner/random/food_or_drink/outdoors_snacks,
/obj/item/tool/pen/invisible,
/turf/open/floor/wood,
/area/bigredv2/outside/library)
"EI" = (
/turf/open/floor/marking/asteroidwarning{
	dir = 4
	},
/area/bigredv2/outside/e)
"Fz" = (
/obj/structure/bed/chair/wood/normal{
	dir = 4
	},
/obj/effect/decal/cleanable/blood/drip,
/turf/open/floor/wood,
/area/bigredv2/outside/library)
"FX" = (
/obj/item/trash/chunk{
	pixel_x = -3;
	pixel_y = 4
	},
/turf/open/floor/carpet/side{
	dir = 8
	},
/area/bigredv2/outside/library)
"Gj" = (
/obj/machinery/atmospherics/pipe/simple/green/hidden,
/turf/open/floor/carpet/side{
	dir = 4
	},
/area/bigredv2/outside/library)
"HS" = (
/obj/effect/spawner/random/misc/trash,
/turf/open/floor/wood,
/area/bigredv2/outside/library)
"Jb" = (
/obj/structure/bed/chair/wood/normal,
/obj/item/paper,
/turf/open/floor/wood,
/area/bigredv2/outside/library)
"Jz" = (
/obj/item/toy/dice/d20,
/obj/effect/decal/cleanable/blood/drip,
/turf/open/floor/carpet/side{
	dir = 8
	},
/area/bigredv2/outside/library)
"Kh" = (
/obj/structure/reagent_dispensers/beerkeg,
/turf/open/floor/wood,
/area/bigredv2/outside/library)
"Mt" = (
/turf/open/floor/carpet/side{
	dir = 10
	},
/area/bigredv2/outside/library)
"MR" = (
/turf/open/floor/carpet/side,
/area/bigredv2/outside/library)
"Nb" = (
/obj/structure/table/woodentable,
/obj/item/reagent_containers/food/snacks/pizzapasta/meatpizzaslice,
/obj/effect/spawner/random/food_or_drink/drink_alcohol_bottle,
/obj/effect/spawner/random/food_or_drink/drink_alcohol_bottle,
/turf/open/floor/wood,
/area/bigredv2/outside/library)
"NF" = (
/obj/structure/cable,
/obj/effect/decal/cleanable/vomit,
/turf/open/floor/wood,
/area/bigredv2/outside/library)
"PL" = (
/obj/effect/decal/cleanable/blood/drip,
/turf/open/floor/carpet/side{
	dir = 8
	},
/area/bigredv2/outside/library)
"Qv" = (
/obj/structure/cable,
/obj/machinery/atmospherics/pipe/simple/green/hidden{
	dir = 4
	},
/turf/open/floor/wood,
/area/bigredv2/outside/library)
"Rn" = (
/obj/effect/spawner/random/misc/structure/broken_window/colonyspawn,
/obj/machinery/door/poddoor/shutters/mainship{
	dir = 2;
	id = "Library";
	name = "\improper Library Shutters"
	},
/turf/open/floor/plating,
/area/bigredv2/outside/library)
"RJ" = (
/obj/machinery/light{
	dir = 1
	},
/obj/item/weapon/broken_bottle,
/obj/item/shard,
/obj/item/shard,
/turf/open/floor/wood,
/area/bigredv2/outside/library)
"St" = (
/obj/effect/decal/cleanable/vomit,
/turf/open/floor/wood,
/area/bigredv2/outside/library)
"SH" = (
/obj/machinery/atmospherics/pipe/simple/green/hidden,
/obj/machinery/door/airlock/multi_tile/mainship/generic{
	name = "\improper Library"
	},
/turf/open/floor/wood,
/area/bigredv2/outside/library)
"SU" = (
/obj/machinery/atmospherics/pipe/simple/green/hidden,
/obj/effect/landmark/weed_node,
/turf/open/floor/carpet/side{
	dir = 4
	},
/area/bigredv2/outside/library)
"Tc" = (
/obj/structure/bed/chair/wood/normal,
/turf/open/floor/wood,
/area/bigredv2/outside/library)
"Tr" = (
/obj/effect/decal/cleanable/blood/drip,
/turf/open/floor/carpet/side{
	dir = 1
	},
/area/bigredv2/outside/library)
"Tw" = (
/obj/structure/table/woodentable,
/obj/item/paper,
/turf/open/floor/wood,
/area/bigredv2/outside/library)
"UU" = (
/obj/structure/bookcase{
	density = 0
	},
/obj/machinery/light{
	dir = 8
	},
/obj/effect/landmark/weed_node,
/turf/open/floor/wood,
/area/bigredv2/outside/library)
"VU" = (
/obj/structure/table/woodentable,
/obj/item/paper,
/obj/item/paper/crumpled,
/obj/effect/spawner/random/food_or_drink/drink_alcohol_bottle{
	pixel_x = -5
	},
/obj/effect/spawner/random/food_or_drink/drink_alcohol_bottle,
/turf/open/floor/wood,
/area/bigredv2/outside/library)
"VX" = (
/turf/open/floor/plating/ground/mars/random/dirt,
/area/bigredv2/outside/e)
"We" = (
/obj/machinery/light,
/turf/open/floor/wood,
/area/bigredv2/outside/library)
"WK" = (
/obj/machinery/atmospherics/pipe/simple/green/hidden{
	dir = 10
	},
/turf/open/floor/carpet/side,
/area/bigredv2/outside/library)
"WZ" = (
/obj/structure/bed/chair/wood/normal{
	dir = 4
	},
/turf/open/floor/wood,
/area/bigredv2/outside/library)
"Xq" = (
/obj/machinery/light{
	dir = 4
	},
/obj/structure/reagent_dispensers/beerkeg,
/turf/open/floor/wood,
/area/bigredv2/outside/library)
"XA" = (
/obj/item/paper,
/turf/open/floor/wood,
/area/bigredv2/outside/library)
"Yv" = (
/obj/structure/cable,
/obj/machinery/atmospherics/pipe/simple/green/hidden{
	dir = 6
	},
/turf/open/floor/wood,
/area/bigredv2/outside/library)
"Yz" = (
/obj/machinery/atmospherics/pipe/simple/green/hidden,
/turf/open/floor/wood,
/area/bigredv2/outside/library)
"Zn" = (
/obj/effect/decal/cleanable/blood/drip,
/turf/open/floor/wood,
/area/bigredv2/outside/library)
"ZY" = (
/obj/effect/landmark/weed_node,
/turf/open/floor/wood,
/area/bigredv2/outside/library)

(1,1,1) = {"
jK
jK
jK
jK
uM
jK
jK
jK
jK
jK
jK
jK
jK
jK
jK
jK
jK
jK
"}
(2,1,1) = {"
jK
uy
Ey
Ey
qw
nr
Ey
uy
rt
UU
Ey
uy
Ey
uy
ZY
lw
jK
VX
"}
(3,1,1) = {"
jK
uy
Ey
Ey
AA
uy
St
uy
HS
uy
Ey
uy
Ey
uy
HS
Ey
Rn
VX
"}
(4,1,1) = {"
jK
wI
HS
NF
Qv
nL
cM
Jz
FX
ag
CH
cM
PL
cM
Mt
Zn
Rn
VX
"}
(5,1,1) = {"
jK
uy
eV
Yv
iG
eI
SU
so
Gj
dx
SU
BC
Gj
zM
CM
We
jK
VX
"}
(6,1,1) = {"
jK
RJ
Ey
Qv
XA
rc
XA
Ey
Fz
WZ
HS
uy
ke
nb
WK
Yz
SH
aV
"}
(7,1,1) = {"
jK
Yv
gs
kP
kf
St
Tc
VU
cB
Nb
Ey
yE
Ey
Tr
MR
Ey
Ey
EI
"}
(8,1,1) = {"
jK
lG
jK
jK
jK
yE
Tc
xB
Tw
Ez
fU
uy
Ey
nb
ve
We
jK
VX
"}
(9,1,1) = {"
jK
jI
vX
rO
jK
Kh
ZY
rc
Zn
Ey
ZY
uy
Ey
ka
up
Ey
Rn
VX
"}
(10,1,1) = {"
jK
vN
ZY
Ey
jK
Xq
HS
yE
Jb
de
XA
Ey
cF
Ey
Ey
Ey
Rn
VX
"}
(11,1,1) = {"
jK
jK
jK
jK
jK
jK
jK
rL
rL
jK
rL
rL
jK
rL
rL
jK
jK
VX
"}
