//MAP CONVERTED BY dmm2tgm.py THIS HEADER COMMENT PREVENTS RECONVERSION, DO NOT REMOVE
"a" = (
/turf/closed/mineral/bigred,
/area/bigredv2/caves/rock)
"b" = (
/turf/open/floor/plating/ground/mars/random/cave,
/area/bigredv2/caves/east)
"c" = (
/atom/movable/effect/landmark/lv624/fog_blocker/xeno_spawn,
/turf/open/floor/plating/ground/mars/random/cave,
/area/bigredv2/caves/southeast)
"d" = (
/atom/movable/effect/landmark/patrol_point{
	id = "TGMC_11";
	name = "TGMC exit point 11"
	},
/turf/open/floor/plating/ground/mars/random/cave,
/area/bigredv2/caves/southeast)
"f" = (
/obj/docking_port/stationary/crashmode,
/turf/closed/mineral/bigred,
/area/bigredv2/caves/rock)
"h" = (
/obj/machinery/miner/damaged/platinum,
/turf/open/floor/plating/ground/mars/random/cave,
/area/bigredv2/caves/southeast)
"m" = (
/atom/movable/effect/landmark/lv624/fog_blocker/xeno_spawn,
/atom/movable/effect/landmark/xeno_resin_wall,
/turf/open/floor/plating/ground/mars/random/cave,
/area/bigredv2/caves/southeast)
"o" = (
/turf/closed/wall/indestructible/mineral,
/area/space)
"q" = (
/atom/movable/effect/landmark/start/job/xenomorph,
/turf/open/floor/plating/ground/mars/random/cave,
/area/bigredv2/caves/southeast)
"s" = (
/turf/open/space/basic,
/area/space)
"u" = (
/atom/movable/effect/ai_node,
/turf/open/floor/plating/ground/mars/random/cave,
/area/bigredv2/caves/southeast)
"v" = (
/turf/open/floor/plating/ground/mars/random/cave/rock,
/area/bigredv2/caves/southeast)
"x" = (
/atom/movable/effect/landmark/weed_node,
/turf/open/floor/plating/ground/mars/random/cave/rock,
/area/bigredv2/caves/southeast)
"B" = (
/atom/movable/effect/landmark/patrol_point{
	id = "TGMC_13";
	name = "TGMC exit point 13"
	},
/turf/open/floor/plating/ground/mars/random/cave,
/area/bigredv2/caves/southeast)
"E" = (
/atom/movable/effect/landmark/weed_node,
/turf/open/floor/plating/ground/mars/random/cave,
/area/bigredv2/caves/southeast)
"F" = (
/atom/movable/effect/landmark/start/job/xenomorph,
/atom/movable/effect/landmark/weed_node,
/turf/open/floor/plating/ground/mars/random/cave,
/area/bigredv2/caves/southeast)
"I" = (
/turf/open/floor/plating/ground/mars/random/cave,
/area/bigredv2/caves/southeast)
"J" = (
/atom/movable/effect/landmark/patrol_point{
	id = "TGMC_14";
	name = "TGMC exit point 14"
	},
/turf/open/floor/plating/ground/mars/random/cave,
/area/bigredv2/caves/southeast)
"K" = (
/atom/movable/effect/ai_node,
/turf/open/floor/plating/ground/mars/random/cave/rock,
/area/bigredv2/caves/southeast)
"M" = (
/atom/movable/effect/landmark/weed_node,
/atom/movable/effect/ai_node,
/turf/open/floor/plating/ground/mars/random/cave,
/area/bigredv2/caves/southeast)
"N" = (
/atom/movable/effect/landmark/patrol_point{
	id = "TGMC_12";
	name = "TGMC exit point 12"
	},
/turf/open/floor/plating/ground/mars/random/cave,
/area/bigredv2/caves/southeast)
"O" = (
/atom/movable/effect/landmark/xeno_resin_door,
/turf/open/floor/plating/ground/mars/random/cave/rock,
/area/bigredv2/caves/southeast)
"P" = (
/atom/movable/effect/landmark/xeno_resin_door,
/turf/open/floor/plating/ground/mars/random/cave,
/area/bigredv2/caves/southeast)
"Q" = (
/atom/movable/effect/landmark/lv624/fog_blocker/xeno_spawn,
/turf/closed/mineral/bigred,
/area/bigredv2/caves/rock)
"S" = (
/atom/movable/effect/landmark/lv624/fog_blocker/xeno_spawn,
/atom/movable/effect/landmark/xeno_resin_door,
/turf/open/floor/plating/ground/mars/random/cave,
/area/bigredv2/caves/southeast)
"X" = (
/atom/movable/effect/landmark/xeno_resin_wall,
/turf/open/floor/plating/ground/mars/random/cave,
/area/bigredv2/caves/southeast)
"Y" = (
/atom/movable/effect/landmark/weed_node,
/atom/movable/effect/landmark/lv624/fog_blocker/xeno_spawn,
/turf/open/floor/plating/ground/mars/random/cave,
/area/bigredv2/caves/southeast)
"Z" = (
/atom/movable/effect/landmark/xeno_silo_spawn,
/turf/open/floor/plating/ground/mars/random/cave,
/area/bigredv2/caves/southeast)

(1,1,1) = {"
a
a
a
a
a
a
a
a
a
a
a
a
a
a
a
a
I
I
I
I
I
E
v
a
a
a
a
a
a
a
a
I
I
I
I
I
I
a
a
a
a
a
a
a
a
a
a
a
a
a
P
P
P
P
a
a
a
a
a
a
a
a
a
a
o
o
s
"}
(2,1,1) = {"
b
a
a
a
a
a
a
a
a
a
a
a
a
a
v
v
I
I
I
a
I
I
v
a
a
a
a
a
a
a
a
P
P
P
P
P
a
a
a
a
a
a
a
a
a
a
a
a
a
a
I
E
I
I
a
a
a
a
a
a
a
a
a
a
a
o
s
"}
(3,1,1) = {"
a
a
a
a
a
a
a
a
a
a
a
a
a
a
I
I
I
I
I
a
v
I
v
a
a
a
a
a
a
a
a
I
I
I
I
I
a
a
a
a
a
a
a
a
a
a
a
a
a
a
I
I
I
I
a
a
a
a
a
a
a
a
a
a
a
o
s
"}
(4,1,1) = {"
a
a
a
a
a
a
a
a
a
a
a
a
a
K
I
I
M
I
a
a
a
I
v
a
a
a
a
a
a
a
a
I
I
q
I
I
a
a
a
a
a
a
a
a
a
a
a
a
a
a
I
I
I
I
a
a
a
a
a
a
a
a
a
a
a
o
s
"}
(5,1,1) = {"
a
a
a
a
a
a
a
a
a
a
a
a
a
I
E
v
I
I
a
a
a
I
v
a
a
a
a
a
a
a
a
I
I
I
I
I
a
a
a
a
a
a
a
a
a
a
a
a
a
a
I
I
u
E
a
a
a
a
a
a
a
a
a
a
a
o
s
"}
(6,1,1) = {"
a
a
a
a
a
a
a
a
a
a
a
v
v
I
I
v
I
I
a
a
a
I
v
a
a
a
a
a
a
a
a
I
I
I
I
I
a
a
f
a
a
a
a
a
a
a
a
a
a
a
I
E
I
I
a
a
a
a
a
a
a
a
a
a
a
o
s
"}
(7,1,1) = {"
a
a
a
a
a
a
a
a
a
a
a
I
I
I
v
I
I
a
a
a
a
I
v
a
a
a
a
a
a
a
a
I
I
E
I
I
a
a
a
a
a
a
a
a
a
a
a
a
a
a
I
I
I
I
a
a
a
a
a
a
a
a
a
a
a
o
s
"}
(8,1,1) = {"
a
a
a
a
a
a
a
a
a
a
a
I
I
M
I
a
a
a
a
a
a
I
v
a
a
a
a
a
a
a
a
I
I
I
I
I
a
a
a
a
a
a
a
a
a
a
a
a
a
a
I
I
I
I
a
a
a
a
a
a
a
a
a
a
a
o
s
"}
(9,1,1) = {"
a
a
a
a
a
a
a
a
a
a
a
I
K
I
I
a
a
a
a
a
a
I
v
a
a
a
a
a
a
a
a
I
I
E
I
I
a
a
a
a
a
a
a
a
a
a
a
a
a
a
I
I
I
I
a
a
a
a
a
a
a
a
a
a
a
o
s
"}
(10,1,1) = {"
a
a
a
a
a
a
a
a
a
a
v
I
v
I
I
a
a
a
a
I
I
u
x
a
a
a
a
a
a
a
I
I
I
I
I
I
a
a
a
a
a
a
a
a
a
a
a
a
a
a
I
I
E
I
a
a
a
a
a
a
a
a
a
a
a
o
s
"}
(11,1,1) = {"
a
a
a
a
a
a
a
a
a
a
I
I
v
I
v
v
v
v
v
I
I
I
v
a
a
a
a
a
a
I
I
I
I
u
I
I
I
a
a
a
a
a
a
a
a
a
a
a
a
a
I
I
I
I
a
a
a
a
a
a
a
a
a
a
a
o
s
"}
(12,1,1) = {"
f
a
a
a
a
a
a
a
a
a
I
F
I
v
I
I
I
I
v
I
E
I
a
a
a
a
a
I
u
I
I
I
u
I
I
I
I
a
a
a
a
a
a
a
a
a
a
a
a
a
I
E
I
a
a
a
a
a
a
a
a
a
a
a
a
o
s
"}
(13,1,1) = {"
a
a
a
a
a
a
a
a
a
a
I
I
I
I
I
E
u
I
E
I
I
I
a
a
a
a
a
I
I
I
I
I
E
I
I
I
I
a
a
a
a
a
a
a
a
a
a
a
a
I
I
I
I
a
a
a
a
a
a
a
a
a
a
a
a
o
s
"}
(14,1,1) = {"
v
I
a
a
a
a
a
a
a
v
I
I
I
I
I
I
I
I
I
I
I
v
a
a
a
a
a
I
E
I
I
I
I
I
I
I
I
I
I
a
a
a
a
a
a
a
a
a
a
I
I
I
u
a
a
a
a
a
a
a
a
a
a
a
a
o
s
"}
(15,1,1) = {"
v
a
a
a
a
a
a
a
a
I
u
I
u
E
I
I
u
I
I
v
a
a
a
a
a
I
I
I
I
I
I
I
I
I
I
I
E
I
I
I
I
a
a
a
a
a
a
a
I
I
I
u
I
a
a
a
a
a
a
a
a
a
a
a
a
o
s
"}
(16,1,1) = {"
v
a
a
a
a
a
a
v
v
I
v
I
I
I
I
I
I
I
I
I
I
a
a
a
a
I
I
I
I
I
I
I
I
I
I
I
I
I
I
I
I
I
I
I
I
a
a
a
I
I
I
I
I
a
a
a
a
a
a
a
a
a
a
a
a
o
s
"}
(17,1,1) = {"
I
a
a
a
a
a
a
I
I
I
v
I
I
I
a
a
a
O
P
P
P
a
a
a
a
I
I
I
I
I
I
I
I
I
I
I
I
I
I
I
I
I
I
I
I
I
I
I
I
E
I
I
a
a
a
a
a
a
a
a
a
a
a
a
a
o
s
"}
(18,1,1) = {"
I
a
a
a
a
a
a
v
I
v
I
I
I
a
a
a
a
a
I
I
u
I
I
E
E
I
I
I
I
I
E
I
I
I
I
I
I
I
I
I
I
E
I
E
I
I
I
I
I
I
I
I
a
a
a
a
a
a
a
a
a
a
a
a
a
o
o
"}
(19,1,1) = {"
I
a
a
a
a
a
I
I
I
v
I
a
a
a
a
a
a
a
a
a
I
I
I
I
I
I
I
I
u
I
I
I
I
u
I
I
I
I
I
I
I
I
u
I
I
I
I
h
I
u
I
u
a
a
a
a
a
a
a
a
a
a
a
a
a
a
o
"}
(20,1,1) = {"
I
a
a
I
I
I
u
I
I
I
u
a
a
a
a
a
a
a
a
a
I
I
I
E
I
I
I
I
I
I
E
I
I
I
I
I
I
I
I
I
I
I
I
I
I
I
E
I
I
I
I
I
a
a
a
a
a
a
a
a
a
a
a
a
a
a
o
"}
(21,1,1) = {"
I
I
I
I
I
I
I
I
v
I
a
a
a
a
a
a
a
a
a
a
u
I
I
I
u
I
E
I
u
I
I
I
I
I
I
I
I
I
I
I
I
I
I
I
I
I
I
I
I
I
I
a
a
a
a
a
a
a
a
a
a
a
a
a
a
a
o
"}
(22,1,1) = {"
I
I
I
I
v
v
I
I
I
I
a
a
a
a
a
a
a
a
a
a
a
I
I
I
I
I
I
I
I
I
h
I
I
E
I
I
I
a
a
a
a
I
I
I
I
I
I
I
I
I
a
a
a
a
a
a
a
a
a
a
a
a
a
a
a
a
o
"}
(23,1,1) = {"
h
u
I
v
I
I
u
I
I
a
a
a
a
a
a
a
a
a
a
a
a
a
I
I
I
I
I
I
I
I
I
I
I
I
I
I
a
a
a
a
a
a
a
a
a
a
a
a
a
a
a
a
a
a
a
a
a
a
a
a
a
a
a
a
a
a
o
"}
(24,1,1) = {"
I
v
x
I
I
I
I
v
a
a
a
a
a
a
a
a
a
a
a
a
a
a
a
I
I
I
I
I
I
I
I
I
I
I
I
I
a
a
a
a
a
a
a
a
a
a
a
a
a
a
a
a
a
a
a
a
a
a
a
a
a
a
a
a
a
a
o
"}
(25,1,1) = {"
v
I
I
v
a
a
a
a
a
a
a
a
a
a
a
a
a
a
a
a
a
a
a
a
u
I
I
I
E
u
I
I
I
I
I
I
a
a
a
a
a
a
a
a
a
a
a
a
a
a
a
a
a
a
a
a
a
a
a
a
a
a
a
a
a
a
o
"}
(26,1,1) = {"
I
I
I
v
a
a
a
a
a
a
a
a
a
a
a
a
a
a
a
a
a
a
a
a
a
I
I
I
u
I
I
E
I
u
I
a
a
a
a
a
a
a
a
a
a
a
a
a
a
a
a
a
a
a
a
a
a
a
a
a
a
a
a
a
a
a
o
"}
(27,1,1) = {"
a
a
a
a
a
a
a
a
a
a
a
a
a
a
a
a
a
a
a
a
a
a
a
a
a
I
I
I
I
I
I
I
I
I
I
a
a
a
a
a
a
a
a
a
a
a
a
a
a
a
a
a
a
a
a
a
a
a
a
a
a
a
a
a
a
a
o
"}
(28,1,1) = {"
a
a
a
a
a
a
a
a
a
a
a
a
a
a
a
a
a
a
a
a
a
a
a
a
a
I
I
I
I
I
I
I
I
I
a
a
a
a
a
a
a
a
a
a
a
a
a
a
a
a
a
a
a
a
a
a
a
a
a
a
a
a
a
a
a
a
o
"}
(29,1,1) = {"
a
a
a
a
a
a
a
a
a
a
a
a
a
a
a
a
a
a
a
a
a
a
a
a
a
I
I
I
I
I
I
I
I
a
a
a
a
a
a
a
a
a
a
a
a
a
a
a
a
a
a
a
a
a
a
a
a
a
a
a
a
a
a
a
a
a
o
"}
(30,1,1) = {"
a
a
a
a
a
a
a
a
a
a
a
a
a
a
a
a
a
a
a
a
a
a
a
a
a
I
I
I
u
I
I
I
a
a
a
a
a
a
a
a
a
a
a
a
a
a
a
a
a
a
a
a
a
a
a
a
a
a
a
a
a
a
a
a
a
a
o
"}
(31,1,1) = {"
a
a
a
a
a
a
a
a
a
a
a
a
a
a
a
a
a
a
a
a
a
a
a
a
a
I
I
M
I
I
I
a
a
a
a
a
a
a
a
a
a
a
a
a
a
a
a
a
a
a
a
a
a
a
a
a
a
a
a
a
a
a
a
a
a
a
o
"}
(32,1,1) = {"
I
I
a
a
a
a
a
a
a
a
a
a
a
a
a
a
a
a
a
a
a
a
a
a
a
I
I
I
E
I
a
a
a
a
a
a
a
a
a
a
a
a
a
a
a
a
a
a
a
a
a
a
a
a
a
a
a
a
a
a
a
a
a
a
a
a
o
"}
(33,1,1) = {"
I
I
E
I
u
a
a
a
a
a
a
a
a
a
a
a
a
a
a
a
a
a
a
a
a
B
I
I
I
I
a
a
a
a
a
a
a
a
a
a
a
a
a
a
a
a
a
a
a
a
a
a
a
a
a
a
a
a
a
a
a
a
a
a
a
a
o
"}
(34,1,1) = {"
I
I
I
I
I
I
I
a
a
a
a
a
a
a
a
a
a
a
a
a
a
a
a
a
a
I
I
I
I
I
a
a
a
a
a
a
a
a
a
a
a
a
a
a
a
a
a
a
a
a
a
a
a
a
a
a
a
a
a
a
a
a
a
a
a
a
o
"}
(35,1,1) = {"
I
I
I
I
I
I
I
a
a
a
a
a
a
a
a
a
a
a
a
a
a
a
a
a
a
I
I
I
E
I
a
a
a
a
a
a
a
a
a
a
a
a
a
a
a
a
a
a
a
a
a
a
a
a
a
a
a
a
a
a
a
a
a
a
a
a
o
"}
(36,1,1) = {"
I
I
I
I
I
I
I
I
a
I
a
a
a
a
a
a
a
a
a
a
a
a
a
a
I
I
I
I
I
I
a
a
a
a
a
a
a
a
a
a
a
a
a
a
a
a
a
a
a
a
a
a
a
a
a
a
a
a
a
a
a
a
a
a
a
a
o
"}
(37,1,1) = {"
I
I
I
I
u
E
I
u
I
I
I
I
a
a
a
a
a
a
a
a
a
a
Q
Q
c
c
Y
c
c
c
a
a
a
a
a
a
a
a
a
a
a
a
a
a
a
a
a
a
a
a
a
a
a
a
a
a
a
a
a
a
a
a
a
a
a
a
o
"}
(38,1,1) = {"
a
a
I
I
I
I
I
I
I
I
I
I
I
I
a
a
a
a
a
a
a
a
Q
a
X
X
P
P
X
Q
a
a
a
a
a
a
a
a
a
a
a
a
a
a
a
a
a
a
a
a
a
a
a
a
a
a
a
a
a
a
a
a
a
o
o
o
o
"}
(39,1,1) = {"
a
a
I
I
I
I
I
u
I
I
I
I
I
I
u
I
I
J
a
a
a
a
Q
a
I
I
I
I
I
Q
a
a
a
a
a
a
a
a
a
a
a
a
a
a
a
a
a
a
a
a
a
a
a
a
a
a
a
a
a
a
a
a
a
o
s
s
s
"}
(40,1,1) = {"
a
a
I
I
I
I
I
I
I
I
I
I
I
I
I
I
I
I
I
a
a
a
Q
X
I
I
I
I
I
Q
a
a
a
a
a
a
a
a
a
a
a
a
a
a
a
a
a
a
a
a
a
a
a
a
a
a
a
a
a
a
a
a
a
o
s
s
s
"}
(41,1,1) = {"
I
I
I
I
I
I
I
I
I
I
E
I
I
I
I
I
E
I
I
I
a
a
Q
X
I
I
I
I
I
Q
a
a
a
a
a
a
a
a
a
a
a
a
a
a
a
a
a
a
a
a
a
a
a
a
a
a
a
a
a
a
a
a
a
o
s
s
s
"}
(42,1,1) = {"
I
I
I
I
I
I
I
I
I
I
I
I
I
I
I
I
I
I
I
I
I
I
Q
X
I
I
I
I
I
Q
a
a
a
a
a
a
a
a
a
a
a
a
a
a
a
a
a
a
a
a
a
a
a
a
a
a
a
a
a
a
a
a
a
o
s
s
s
"}
(43,1,1) = {"
I
I
I
E
I
I
I
I
I
I
I
I
I
I
I
h
I
I
I
I
I
I
m
X
I
E
I
I
I
Q
a
a
a
a
a
a
a
a
a
a
a
a
a
a
a
a
a
a
a
a
a
a
a
a
a
a
a
a
a
a
a
a
a
o
s
s
s
"}
(44,1,1) = {"
I
I
I
I
I
I
I
E
I
I
I
I
E
I
I
I
I
I
I
I
I
I
m
I
I
I
I
I
E
Q
a
a
a
a
a
a
a
a
a
a
a
a
a
a
a
a
a
a
a
a
a
a
a
a
a
a
a
a
a
a
a
a
a
o
s
s
s
"}
(45,1,1) = {"
I
u
I
I
I
I
I
u
I
I
I
I
I
I
M
I
I
I
I
I
I
I
S
I
E
u
I
M
d
Q
a
a
a
a
a
a
a
a
a
a
a
a
a
a
a
a
a
a
a
a
a
a
a
a
a
a
a
a
a
a
a
a
a
o
s
s
s
"}
(46,1,1) = {"
I
I
I
I
I
I
I
I
I
a
I
I
I
I
I
I
I
I
I
E
I
I
S
I
I
Z
I
E
I
Q
a
a
a
a
a
a
a
a
a
a
a
a
a
a
a
a
a
a
a
a
a
a
a
a
a
a
a
a
a
a
a
a
a
o
s
s
s
"}
(47,1,1) = {"
I
I
E
I
I
I
I
I
I
a
a
a
I
I
I
I
I
I
E
I
I
I
m
I
E
I
I
I
a
Q
a
a
a
a
a
a
a
a
a
a
a
a
a
a
a
a
a
a
a
a
a
a
a
a
a
a
a
a
a
a
a
a
a
o
s
s
s
"}
(48,1,1) = {"
I
I
I
I
I
I
I
a
a
a
a
a
a
a
a
I
I
I
I
I
I
I
m
I
I
I
I
a
a
Q
a
a
a
a
a
a
a
a
a
a
a
a
a
a
a
a
a
a
a
a
a
a
a
a
a
a
a
a
a
a
a
a
a
o
s
s
s
"}
(49,1,1) = {"
I
u
I
I
I
I
a
a
a
a
a
a
a
a
a
a
a
I
I
I
I
I
m
I
I
a
a
a
a
Q
a
a
a
a
a
a
a
a
a
a
a
a
a
a
a
a
a
a
a
a
a
a
a
a
a
a
a
a
a
a
a
a
a
o
s
s
s
"}
(50,1,1) = {"
I
I
I
a
a
a
a
a
a
a
a
a
a
a
a
a
a
a
a
N
I
I
m
a
a
a
a
a
a
Q
a
a
a
a
a
a
a
a
a
a
a
a
a
a
a
a
a
a
a
a
a
a
a
a
a
a
a
a
a
a
a
a
a
o
s
s
s
"}
(51,1,1) = {"
I
I
I
a
a
a
a
a
a
a
a
a
a
a
a
a
a
a
a
a
a
a
Q
Q
Q
Q
Q
Q
Q
Q
a
a
a
a
a
a
a
a
a
a
a
a
a
a
a
a
a
a
a
a
a
a
a
a
a
a
a
a
a
a
a
a
a
o
s
s
s
"}
(52,1,1) = {"
a
a
a
a
a
a
a
a
a
a
a
a
a
a
a
a
a
a
a
a
a
a
a
a
a
a
a
a
a
a
a
a
a
a
a
a
a
a
a
a
a
a
a
a
a
a
a
a
a
a
a
a
a
a
a
a
a
a
a
a
a
a
a
o
s
s
s
"}
(53,1,1) = {"
a
a
a
a
a
a
a
a
a
a
a
a
a
a
a
a
a
a
a
a
a
a
a
a
a
a
a
a
a
a
a
a
a
a
a
a
a
a
a
a
a
a
a
a
a
a
a
a
a
a
a
a
a
a
a
a
a
a
a
a
a
a
a
o
s
s
s
"}
(54,1,1) = {"
a
a
a
a
a
a
a
a
a
a
a
a
a
a
a
a
a
a
a
a
a
a
a
a
a
a
a
a
a
a
a
a
a
a
a
a
a
a
a
a
a
a
a
a
a
a
a
a
a
a
a
a
a
a
a
a
a
a
a
a
a
a
a
o
s
s
s
"}
(55,1,1) = {"
a
a
a
a
a
a
a
a
a
a
a
a
a
a
a
a
a
a
a
a
a
a
a
a
a
a
a
a
a
a
a
a
a
a
a
a
a
a
a
a
a
a
a
a
a
a
a
a
a
a
a
a
a
a
a
a
a
a
a
a
a
a
a
o
s
s
s
"}
(56,1,1) = {"
a
a
a
a
a
a
a
a
a
a
a
a
a
a
a
a
a
a
a
a
a
a
a
a
a
a
a
a
a
a
a
a
a
a
a
a
a
a
a
a
a
a
a
a
a
a
a
a
a
a
a
a
a
a
a
a
a
a
a
a
a
a
a
o
s
s
s
"}
(57,1,1) = {"
a
a
a
a
a
a
a
a
a
a
a
a
a
a
a
a
a
a
a
a
a
a
a
a
a
a
a
a
a
a
a
a
a
a
a
a
a
a
a
a
a
a
a
a
a
a
a
a
a
a
a
a
a
a
a
a
a
a
a
a
a
a
a
o
s
s
s
"}
(58,1,1) = {"
a
a
a
a
a
a
a
a
a
a
a
a
a
a
a
a
a
a
a
a
a
a
a
a
a
a
a
a
a
a
a
a
a
a
a
a
a
a
a
a
a
a
a
a
a
a
a
a
a
a
a
a
a
a
a
a
a
a
a
a
a
a
a
o
s
s
s
"}
(59,1,1) = {"
a
a
a
a
a
a
a
a
a
a
a
a
a
a
a
a
a
a
a
a
a
a
a
a
a
a
a
a
a
a
a
a
a
a
a
a
a
a
a
a
a
a
a
a
a
a
a
a
a
a
a
a
a
a
a
a
a
a
a
a
a
a
a
o
s
s
s
"}
(60,1,1) = {"
a
a
a
a
a
a
a
a
a
a
a
a
a
a
a
a
a
a
a
a
a
a
a
a
a
a
a
a
a
a
a
a
a
a
a
a
a
a
a
a
a
a
a
a
a
a
a
a
a
a
a
a
a
a
a
a
a
a
a
a
a
a
a
o
s
s
s
"}
(61,1,1) = {"
a
a
a
a
a
a
a
a
a
a
a
a
a
a
a
a
a
a
a
a
a
a
a
a
a
a
a
a
a
a
a
a
a
a
a
a
a
a
a
a
a
a
a
a
a
a
a
a
a
a
a
a
a
a
a
a
a
a
a
a
a
a
a
o
s
s
s
"}
(62,1,1) = {"
a
a
a
a
a
a
a
a
a
a
a
a
a
a
a
a
a
a
a
a
a
a
a
a
a
a
a
a
a
a
a
a
a
a
a
a
a
a
a
a
a
a
a
a
a
a
a
a
a
a
a
a
a
a
a
a
a
a
a
a
a
a
a
o
s
s
s
"}
(63,1,1) = {"
o
o
o
o
o
o
o
o
o
o
o
o
o
o
o
o
o
o
o
o
o
o
o
o
o
o
o
o
o
o
o
o
o
o
o
o
o
o
o
o
o
o
o
o
a
a
a
a
a
a
a
a
a
a
a
a
a
a
a
a
a
a
a
o
s
s
s
"}
(64,1,1) = {"
s
s
s
s
s
s
s
s
s
s
s
s
s
s
s
s
s
s
s
s
s
s
s
s
s
s
s
s
s
s
s
s
s
s
s
s
s
s
s
s
s
s
s
o
a
a
a
a
a
a
a
a
a
a
a
a
a
a
a
a
a
a
a
o
s
s
s
"}
(65,1,1) = {"
s
s
s
s
s
s
s
s
s
s
s
s
s
s
s
s
s
s
s
s
s
s
s
s
s
s
s
s
s
s
s
s
s
s
s
s
s
s
s
s
s
s
s
o
a
a
a
a
a
a
a
a
a
a
a
a
a
a
a
a
a
a
a
o
s
s
s
"}
(66,1,1) = {"
s
s
s
s
s
s
s
s
s
s
s
s
s
s
s
s
s
s
s
s
s
s
s
s
s
s
s
s
s
s
s
s
s
s
s
s
s
s
s
s
s
s
s
o
a
a
a
a
a
a
a
a
a
a
a
a
a
a
a
a
a
a
a
o
s
s
s
"}
(67,1,1) = {"
s
s
s
s
s
s
s
s
s
s
s
s
s
s
s
s
s
s
s
s
s
s
s
s
s
s
s
s
s
s
s
s
s
s
s
s
s
s
s
s
s
s
s
o
a
a
a
a
a
a
a
a
a
a
a
a
a
a
a
a
a
a
a
o
s
s
s
"}
(68,1,1) = {"
s
s
s
s
s
s
s
s
s
s
s
s
s
s
s
s
s
s
s
s
s
s
s
s
s
s
s
s
s
s
s
s
s
s
s
s
s
s
s
s
s
s
s
o
a
a
a
a
a
a
a
a
a
a
a
a
a
a
a
a
a
a
a
o
s
s
s
"}
(69,1,1) = {"
s
s
s
s
s
s
s
s
s
s
s
s
s
s
s
s
s
s
s
s
s
s
s
s
s
s
s
s
s
s
s
s
s
s
s
s
s
s
s
s
s
s
s
o
a
a
a
a
a
a
a
a
a
a
a
a
a
a
a
a
a
a
a
o
s
s
s
"}
(70,1,1) = {"
s
s
s
s
s
s
s
s
s
s
s
s
s
s
s
s
s
s
s
s
s
s
s
s
s
s
s
s
s
s
s
s
s
s
s
s
s
s
s
s
s
s
s
o
o
o
o
o
o
a
a
a
a
a
a
a
a
a
a
a
a
a
a
o
s
s
s
"}
(71,1,1) = {"
s
s
s
s
s
s
s
s
s
s
s
s
s
s
s
s
s
s
s
s
s
s
s
s
s
s
s
s
s
s
s
s
s
s
s
s
s
s
s
s
s
s
s
s
s
s
s
s
o
o
o
o
o
o
o
o
o
o
o
o
o
o
o
o
s
s
s
"}
