//MAP CONVERTED BY dmm2tgm.py THIS HEADER COMMENT PREVENTS RECONVERSION, DO NOT REMOVE
"a" = (
/turf/closed/interior/apc/twentyeight,
/area/interior/apc)
"b" = (
/turf/closed/interior/tank/door,
/area/interior/apc)
"e" = (
/turf/closed/interior/apc/seventeen,
/area/interior/apc)
"f" = (
/obj/machinery/telecomms/relay/preset/telecomms/onboard/nondense,
/turf/closed/interior/apc/six,
/area/interior/apc)
"g" = (
/turf/closed/interior/apc/nineteen,
/area/interior/apc)
"k" = (
/turf/closed/interior/apc/twentyseven,
/area/interior/apc)
"l" = (
/obj/machinery/vending/nanoammo/directional/south,
/obj/structure/bed/chair/dropship/doublewide/left,
/obj/structure/bed/chair/dropship/doublewide/right,
/turf/open/interior/apc/nine,
/area/interior/apc)
"m" = (
/turf/closed/interior/apc/twenty,
/area/interior/apc)
"n" = (
/obj/structure/bed/chair/loader_seat{
	pixel_y = -5
	},
/obj/structure/periscope/apc,
/turf/open/interior/apc/nine,
/area/interior/apc)
"o" = (
/obj/structure/periscope/apc,
/obj/structure/bed/chair/loader_seat{
	pixel_y = -5
	},
/turf/open/interior/apc/twentytwo,
/area/interior/apc)
"q" = (
/turf/closed/interior/apc/twelve,
/area/interior/apc)
"v" = (
/turf/closed/interior/apc/three,
/area/interior/apc)
"w" = (
/turf/closed/interior/apc/thirteen,
/area/interior/apc)
"x" = (
/turf/closed/interior/apc/four,
/area/interior/apc)
"z" = (
/turf/closed/interior/apc/five,
/area/interior/apc)
"A" = (
/obj/structure/bed/chair/vehicle_crew/driver_gunner{
	pixel_x = -3;
	pixel_y = -5
	},
/turf/open/interior/apc/eleven,
/area/interior/apc)
"B" = (
/obj/structure/bed/chair/dropship/doublewide/left,
/obj/structure/bed/chair/dropship/doublewide/right,
/turf/open/interior/apc/eight,
/area/interior/apc)
"D" = (
/turf/closed/interior/apc/twentyfour,
/area/interior/apc)
"E" = (
/obj/structure/bed/chair/dropship/doublewide/left,
/obj/structure/bed/chair/dropship/doublewide/right,
/turf/open/interior/apc/nine,
/area/interior/apc)
"F" = (
/turf/closed/interior/apc/two,
/area/interior/apc)
"I" = (
/obj/machinery/vending/nanomed/tadpolemed,
/obj/structure/bed/chair/dropship/doublewide/left,
/obj/structure/bed/chair/dropship/doublewide/right,
/turf/open/interior/apc/nine,
/area/interior/apc)
"J" = (
/obj/structure/bed/chair/dropship/doublewide/left,
/obj/structure/bed/chair/dropship/doublewide/right,
/turf/open/interior/apc/twentynine,
/area/interior/apc)
"L" = (
/turf/closed/interior/apc/one,
/area/interior/apc)
"M" = (
/turf/open/interior/apc/fifteen,
/area/interior/apc)
"O" = (
/turf/open/interior/apc/ten,
/area/interior/apc)
"P" = (
/turf/open/interior/apc/sixteen,
/area/interior/apc)
"Q" = (
/turf/open/interior/apc/fourteen,
/area/interior/apc)
"T" = (
/turf/closed/interior/apc/twentythree,
/area/interior/apc)
"V" = (
/turf/open/interior/apc/twentynine,
/area/interior/apc)
"X" = (
/obj/structure/bed/chair/dropship/doublewide/right,
/obj/structure/bed/chair/dropship/doublewide/left,
/turf/open/interior/apc/twentynine,
/area/interior/apc)

(1,1,1) = {"
L
w
b
w
g
"}
(2,1,1) = {"
F
B
Q
V
k
"}
(3,1,1) = {"
F
l
M
V
k
"}
(4,1,1) = {"
F
I
M
J
k
"}
(5,1,1) = {"
v
E
M
J
k
"}
(6,1,1) = {"
x
n
M
X
k
"}
(7,1,1) = {"
F
O
P
o
k
"}
(8,1,1) = {"
z
A
e
T
m
"}
(9,1,1) = {"
f
q
D
D
a
"}
