//MAP CONVERTED BY dmm2tgm.py THIS HEADER COMMENT PREVENTS RECONVERSION, DO NOT REMOVE
"aa" = (
/turf/open/space/basic,
/area/space)
"ab" = (
/turf/closed/wall/indestructible,
/area/tdome)
"ac" = (
/obj/structure/closet/secure_closet/bar,
/turf/open/floor/tile/white,
/area/tdome)
"ad" = (
/turf/open/floor/tile/white,
/area/tdome)
"ae" = (
/obj/machinery/gibber,
/turf/open/floor/tile/white,
/area/tdome)
"af" = (
/obj/machinery/vending/marine/shared/cigarette,
/turf/open/floor/tile/red/redblue/full,
/area/tdome/tdomeobserve)
"ag" = (
/obj/structure/table,
/obj/item/reagent_containers/food/drinks/cans/beer,
/obj/item/reagent_containers/food/drinks/cans/beer,
/obj/item/reagent_containers/food/drinks/cans/beer,
/obj/item/tool/lighter/zippo,
/obj/item/storage/fancy/cigarettes,
/turf/open/floor/tile/red/redblue/full,
/area/tdome/tdomeobserve)
"ah" = (
/obj/item/reagent_containers/food/drinks/cans/cola,
/obj/item/reagent_containers/food/drinks/cans/cola,
/obj/item/reagent_containers/food/drinks/cans/cola,
/obj/structure/table,
/obj/item/ashtray/glass,
/turf/open/floor/tile/red/redblue/full,
/area/tdome/tdomeobserve)
"ai" = (
/obj/structure/reagent_dispensers/beerkeg,
/turf/open/floor/tile/red/redblue/full,
/area/tdome/tdomeobserve)
"aj" = (
/obj/structure/reagent_dispensers/beerkeg,
/obj/item/storage/box/drinkingglasses,
/turf/open/floor/tile/red/redblue/full,
/area/tdome/tdomeobserve)
"ak" = (
/turf/open/floor/tile/red/redblue/full,
/area/tdome/tdomeobserve)
"al" = (
/obj/machinery/vending/coffee,
/turf/open/floor/tile/red/redblue/full,
/area/tdome/tdomeobserve)
"am" = (
/obj/structure/closet/secure_closet/freezer/meat,
/turf/open/floor/tile/white,
/area/tdome)
"an" = (
/obj/structure/closet/secure_closet/freezer/fridge,
/turf/open/floor/tile/white,
/area/tdome)
"ao" = (
/obj/structure/bed/chair,
/obj/effect/landmark/thunderdome/observe,
/turf/open/floor/tile/red/redblue/full,
/area/tdome/tdomeobserve)
"ap" = (
/obj/structure/disposalpipe/trunk,
/obj/structure/disposaloutlet,
/turf/open/floor/tile/red/redblue/full,
/area/tdome/tdomeobserve)
"aq" = (
/obj/machinery/vending/snack,
/turf/open/floor/tile/red/redblue/full,
/area/tdome/tdomeobserve)
"ar" = (
/obj/item/storage/box/donkpockets{
	pixel_x = 3;
	pixel_y = 3
	},
/obj/item/storage/box/donkpockets{
	pixel_x = 3;
	pixel_y = 3
	},
/obj/item/storage/box/donkpockets{
	pixel_x = 3;
	pixel_y = 3
	},
/obj/item/storage/box/donkpockets{
	pixel_x = 3;
	pixel_y = 3
	},
/obj/structure/table,
/turf/open/floor/tile/white,
/area/tdome)
"as" = (
/obj/structure/table,
/obj/machinery/microwave,
/turf/open/floor/tile/white,
/area/tdome)
"at" = (
/obj/structure/table/reinforced,
/turf/open/floor/tile/white,
/area/tdome)
"au" = (
/obj/machinery/computer/security/telescreen,
/turf/open/floor/tile/red/redblue/full,
/area/tdome/tdomeobserve)
"av" = (
/obj/item/camera,
/turf/open/floor/tile/red/redblue/full,
/area/tdome/tdomeobserve)
"aw" = (
/obj/structure/disposalpipe/segment,
/turf/open/floor/tile/red/redblue/full,
/area/tdome/tdomeobserve)
"ax" = (
/obj/structure/bed/chair,
/obj/structure/disposalpipe/segment,
/obj/effect/landmark/thunderdome/observe,
/turf/open/floor/tile/red/redblue/full,
/area/tdome/tdomeobserve)
"az" = (
/turf/open/floor/plating,
/area/tdome)
"aA" = (
/obj/structure/window/reinforced{
	dir = 5
	},
/obj/effect/forcefield{
	desc = "You can't get in. Heh.";
	name = "Blocker"
	},
/turf/open/floor,
/area/tdome)
"aB" = (
/obj/structure/window/reinforced{
	dir = 5
	},
/obj/effect/forcefield{
	desc = "You can't get in. Heh.";
	name = "Blocker"
	},
/obj/structure/disposalpipe/segment,
/turf/open/floor,
/area/tdome)
"aC" = (
/turf/open/floor/mainship/cargo,
/area/centcom/supplypod/loading/one)
"aD" = (
/obj/machinery/igniter,
/obj/machinery/light{
	dir = 8
	},
/turf/open/floor,
/area/tdome)
"aE" = (
/turf/open/floor,
/area/tdome)
"aF" = (
/obj/structure/disposalpipe/segment,
/turf/open/floor,
/area/tdome)
"aG" = (
/turf/open/floor/mainship/cargo,
/area/centcom/supplypod/loading/two)
"aH" = (
/turf/open/floor/mainship/stripesquare,
/area/centcom/supplypod/loading/one)
"aI" = (
/obj/effect/landmark/thunderdome/two,
/turf/open/floor/plating,
/area/tdome/tdome2)
"aJ" = (
/obj/machinery/door/poddoor{
	id = "thunderdome";
	name = "Thunderdome Blast Door"
	},
/turf/open/floor/plating,
/area/tdome)
"aK" = (
/turf/open/floor/tile/red/redtaupe{
	dir = 8
	},
/area/tdome)
"aL" = (
/turf/open/floor/tile/green/greentaupe{
	dir = 4
	},
/area/tdome)
"aM" = (
/obj/effect/landmark/thunderdome/one,
/turf/open/floor/plating,
/area/tdome/tdome1)
"aR" = (
/turf/open/floor/podhatch/floor,
/area/tdome)
"aS" = (
/obj/machinery/flasher{
	id = "flash";
	name = "Thunderdome Flash"
	},
/turf/open/floor/podhatch/floor,
/area/tdome)
"bb" = (
/obj/machinery/atmospherics/pipe/simple/general/visible{
	dir = 5
	},
/turf/open/floor,
/area/tdome)
"bc" = (
/obj/machinery/atmospherics/pipe/manifold/general/visible{
	dir = 1
	},
/turf/open/floor,
/area/tdome)
"bd" = (
/obj/machinery/atmospherics/pipe/simple/general/visible{
	dir = 9
	},
/turf/open/floor,
/area/tdome)
"bf" = (
/obj/machinery/atmospherics/pipe/simple/general/visible,
/turf/open/floor,
/area/tdome)
"bi" = (
/turf/open/floor/mainship/stripesquare,
/area/centcom/supplypod/loading/two)
"bk" = (
/obj/machinery/door/airlock/command/thunderdome,
/turf/open/floor,
/area/tdome)
"bl" = (
/obj/structure/window/reinforced{
	dir = 5
	},
/obj/effect/forcefield{
	desc = "You can't get in. Heh.";
	name = "Blocker"
	},
/obj/machinery/atmospherics/pipe/simple/general/visible,
/turf/open/floor,
/area/tdome)
"bn" = (
/turf/open/floor/tile/red/yellowfull,
/area/tdome/tdomeadmin)
"bo" = (
/obj/structure/bed/chair{
	dir = 1
	},
/obj/effect/landmark/thunderdome/admin,
/turf/open/floor/tile/red/yellowfull,
/area/tdome/tdomeadmin)
"bp" = (
/obj/item/tool/extinguisher,
/turf/open/floor/tile/red/yellowfull,
/area/tdome/tdomeadmin)
"bq" = (
/obj/effect/spawner/modularmap/admin/eorg,
/turf/open/space/basic,
/area/space)
"br" = (
/obj/structure/bed/chair{
	dir = 1
	},
/obj/structure/disposalpipe/segment,
/obj/effect/landmark/thunderdome/admin,
/turf/open/floor/tile/red/yellowfull,
/area/tdome/tdomeadmin)
"bt" = (
/obj/machinery/computer/security/telescreen,
/turf/open/floor/tile/red/yellowfull,
/area/tdome/tdomeadmin)
"bv" = (
/obj/item/tool/wrench,
/turf/open/floor/tile/red/yellowfull,
/area/tdome/tdomeadmin)
"bw" = (
/obj/structure/disposalpipe/trunk{
	dir = 1
	},
/obj/machinery/disposal,
/turf/open/floor/tile/red/yellowfull,
/area/tdome/tdomeadmin)
"by" = (
/obj/structure/bed/chair,
/turf/open/floor/tile/red/yellowfull,
/area/tdome/tdomeadmin)
"bB" = (
/obj/structure/table,
/turf/open/floor/tile/red/yellowfull,
/area/tdome/tdomeadmin)
"bC" = (
/obj/item/explosive/grenade/chem_grenade/cleaner,
/obj/item/explosive/grenade/chem_grenade/cleaner,
/obj/item/explosive/grenade/chem_grenade/cleaner,
/obj/item/explosive/grenade/chem_grenade/cleaner,
/obj/item/explosive/grenade/chem_grenade/cleaner,
/obj/item/explosive/grenade/chem_grenade/cleaner,
/obj/item/explosive/grenade/chem_grenade/cleaner,
/obj/item/explosive/grenade/chem_grenade/cleaner,
/obj/item/explosive/grenade/chem_grenade/cleaner,
/obj/item/explosive/grenade/chem_grenade/cleaner,
/obj/structure/table,
/obj/machinery/light,
/turf/open/floor/tile/red/yellowfull,
/area/tdome/tdomeadmin)
"bD" = (
/obj/machinery/computer/pod{
	id = "thunderdomeaxe";
	name = "Thunderdome Axe Supply"
	},
/turf/open/floor/tile/red/yellowfull,
/area/tdome/tdomeadmin)
"bE" = (
/obj/machinery/computer/pod{
	id = "thunderdomegen";
	name = "Thunderdome General Supply"
	},
/turf/open/floor/tile/red/yellowfull,
/area/tdome/tdomeadmin)
"bF" = (
/obj/machinery/computer/pod{
	id = "thunderdomehea";
	name = "Thunderdome Heavy Supply"
	},
/turf/open/floor/tile/red/yellowfull,
/area/tdome/tdomeadmin)
"bG" = (
/obj/machinery/computer/pod{
	id = "thunderdome";
	name = "Thunderdome Blast Door Control"
	},
/turf/open/floor/tile/red/yellowfull,
/area/tdome/tdomeadmin)
"bI" = (
/obj/structure/table,
/obj/item/stack/medical/heal_pack/gauze,
/obj/item/stack/medical/heal_pack/gauze,
/obj/item/stack/medical/heal_pack/gauze,
/turf/open/floor/tile/red/yellowfull,
/area/tdome/tdomeadmin)
"bJ" = (
/obj/structure/table,
/obj/item/storage/box/handcuffs,
/obj/machinery/light,
/turf/open/floor/tile/red/yellowfull,
/area/tdome/tdomeadmin)
"bK" = (
/obj/structure/table,
/obj/item/storage/toolbox/electrical,
/turf/open/floor/tile/red/yellowfull,
/area/tdome/tdomeadmin)
"bL" = (
/obj/structure/table,
/obj/item/storage/toolbox/mechanical,
/turf/open/floor/tile/red/yellowfull,
/area/tdome/tdomeadmin)
"cf" = (
/turf/open/floor/mainship{
	icon_state = "test_floor5"
	},
/area/centcom/supplypod/podStorage)
"cg" = (
/turf/open/floor/mainship{
	icon_state = "test_floor5"
	},
/area/centcom/supplypod/flyMeToTheMoon)
"cm" = (
/turf/open/floor/mainship/cargo,
/area/centcom/supplypod/loading/three)
"cn" = (
/turf/open/floor/mainship/cargo,
/area/centcom/supplypod/loading/four)
"cp" = (
/turf/open/floor/mainship/stripesquare,
/area/centcom/supplypod/loading/three)
"cq" = (
/turf/open/floor/mainship/stripesquare,
/area/centcom/supplypod/loading/four)
"cr" = (
/turf/open/floor/mainship/cargo,
/area/centcom/supplypod/loading/ert)
"dv" = (
/obj/item/stack/medical/heal_pack/ointment,
/obj/item/stack/medical/heal_pack/ointment,
/obj/item/stack/medical/heal_pack/ointment,
/turf/open/floor/tile/red/yellowfull,
/area/tdome/tdomeadmin)
"dX" = (
/turf/closed/wall/mainship/outer{
	name = "reinforced hull"
	},
/area/centcom)
"hk" = (
/obj/structure/table,
/obj/item/reagent_containers/food/drinks/cans/beer,
/obj/item/reagent_containers/food/drinks/cans/beer,
/obj/item/reagent_containers/food/drinks/cans/beer,
/obj/item/tool/lighter/zippo,
/obj/item/storage/fancy/cigarettes,
/obj/machinery/light{
	dir = 1
	},
/turf/open/floor/tile/red/redblue/full,
/area/tdome/tdomeobserve)
"hp" = (
/turf/closed/wall/indestructible,
/area/start)
"ji" = (
/obj/effect/landmark/newplayer_start,
/turf/open/floor,
/area/start)
"kw" = (
/obj/structure/prop/mainship/toolboxforacause2020,
/turf/open/floor/tile/red/redblue/full,
/area/tdome/tdomeobserve)
"kx" = (
/turf/closed/wall/indestructible/splashscreen,
/area/start)
"tW" = (
/obj/machinery/igniter,
/obj/machinery/light{
	dir = 4
	},
/turf/open/floor,
/area/tdome)
"vc" = (
/obj/structure/reagent_dispensers/beerkeg,
/obj/item/storage/box/drinkingglasses,
/obj/machinery/light{
	dir = 1
	},
/turf/open/floor/tile/red/redblue/full,
/area/tdome/tdomeobserve)
"wi" = (
/obj/machinery/light{
	dir = 1
	},
/turf/open/floor/tile/white,
/area/tdome)
"Cf" = (
/obj/machinery/light{
	dir = 1
	},
/turf/open/floor,
/area/tdome)
"Dh" = (
/obj/machinery/light,
/turf/open/floor/tile/red/yellowfull,
/area/tdome/tdomeadmin)
"Fi" = (
/obj/machinery/atmospherics/pipe/simple/general/visible,
/obj/machinery/light,
/turf/open/floor,
/area/tdome)
"OG" = (
/turf/open/ai_visible,
/area/ai_multicam_room)
"VE" = (
/obj/effect/landmark/ai_multicam_room,
/turf/open/ai_visible,
/area/ai_multicam_room)
"VK" = (
/obj/machinery/light{
	dir = 1
	},
/turf/open/floor/tile/red/redblue/full,
/area/tdome/tdomeobserve)
"WC" = (
/obj/machinery/light{
	dir = 4
	},
/turf/open/floor/plating,
/area/tdome)
"ZY" = (
/obj/machinery/light{
	dir = 8
	},
/turf/open/floor/plating,
/area/tdome)

(1,1,1) = {"
aa
aa
aa
aa
aa
aa
aa
aa
aa
aa
aa
aa
aa
aa
aa
aa
aa
aa
aa
aa
aa
aa
aa
aa
aa
aa
aa
aa
aa
aa
aa
aa
aa
aa
aa
hp
hp
hp
hp
hp
hp
hp
hp
hp
hp
hp
hp
hp
hp
kx
"}
(2,1,1) = {"
aa
aa
aa
aa
aa
aa
aa
aa
aa
aa
aa
aa
aa
aa
aa
aa
aa
aa
aa
aa
aa
aa
aa
aa
aa
aa
aa
aa
aa
aa
aa
aa
aa
aa
aa
hp
hp
hp
hp
hp
hp
hp
hp
hp
hp
hp
hp
hp
hp
hp
"}
(3,1,1) = {"
aa
aa
dX
dX
dX
dX
dX
dX
aa
aa
aa
aa
aa
aa
aa
aa
aa
aa
aa
ab
ab
ab
ab
ab
ab
ab
ab
aa
aa
aa
aa
aa
aa
aa
aa
hp
hp
hp
hp
hp
hp
hp
hp
hp
hp
hp
hp
hp
hp
hp
"}
(4,1,1) = {"
aa
aa
dX
cf
cf
cg
cg
dX
aa
aa
aa
aa
ab
ab
ab
ab
ab
ab
ab
ab
az
az
az
az
az
az
ab
aa
aa
aa
aa
aa
aa
aa
aa
hp
hp
hp
hp
hp
hp
hp
hp
hp
hp
hp
hp
hp
hp
hp
"}
(5,1,1) = {"
aa
aa
dX
cf
cf
cg
cg
dX
aa
aa
aa
aa
ab
ac
ac
am
am
ab
ab
ab
az
az
az
az
az
az
ab
ab
ab
aa
aa
aa
aa
aa
aa
hp
hp
hp
hp
hp
hp
hp
hp
hp
hp
hp
hp
hp
hp
hp
"}
(6,1,1) = {"
aa
aa
dX
cf
cf
cg
cg
dX
aa
aa
aa
aa
ab
ad
ad
ad
ar
ab
az
ZY
aI
aI
aI
aI
aI
aI
ZY
az
ab
aa
aa
aa
aa
aa
aa
hp
hp
hp
hp
hp
hp
hp
hp
hp
hp
hp
hp
hp
hp
hp
"}
(7,1,1) = {"
aa
aa
dX
cf
cf
cg
cg
dX
aa
aa
aa
aa
ab
wi
ad
ad
as
ab
az
az
aI
aI
aI
aI
aI
aI
az
az
ab
aa
aa
aa
aa
aa
aa
hp
hp
hp
hp
hp
hp
hp
hp
hp
hp
hp
hp
hp
hp
hp
"}
(8,1,1) = {"
aa
aa
dX
dX
dX
dX
dX
dX
dX
dX
aa
aa
ab
ad
ad
ad
as
ab
az
az
aI
aI
aI
aI
aI
aI
az
az
ab
aa
aa
aa
aa
aa
aa
hp
hp
hp
hp
hp
hp
hp
ji
hp
hp
hp
hp
hp
hp
hp
"}
(9,1,1) = {"
aa
aa
dX
aC
aC
aC
aC
aC
aC
dX
aa
aa
ab
ad
ad
ad
ad
ab
az
az
aI
aI
aI
aI
aI
aI
az
az
ab
aa
aa
aa
aa
aa
aa
hp
hp
hp
hp
hp
hp
hp
hp
hp
hp
hp
hp
hp
hp
hp
"}
(10,1,1) = {"
aa
aa
dX
aC
aC
aC
aC
aC
aC
dX
aa
aa
ab
ae
ae
an
ad
ab
az
WC
aI
aI
aI
aI
aI
aI
WC
az
ab
aa
aa
aa
aa
aa
aa
hp
hp
hp
hp
hp
hp
hp
hp
hp
hp
hp
hp
hp
hp
hp
"}
(11,1,1) = {"
aa
aa
dX
aC
aH
aC
aC
aH
aC
dX
aa
aa
ab
ab
ab
ab
at
ab
ab
ab
aJ
aJ
aJ
aJ
aJ
aJ
ab
ab
ab
ab
ab
ab
ab
aa
aa
hp
hp
hp
hp
hp
hp
hp
hp
hp
hp
hp
hp
hp
hp
hp
"}
(12,1,1) = {"
aa
aa
dX
aC
aH
aH
aH
aH
aC
dX
aa
aa
aa
ab
af
ak
ak
ak
aA
aD
aK
aK
aK
aK
aK
aK
aD
aA
bn
bn
bn
bB
ab
aa
aa
hp
hp
hp
hp
hp
hp
hp
hp
hp
hp
hp
hp
hp
hp
hp
"}
(13,1,1) = {"
aa
aa
dX
aC
aC
aC
aC
aH
aC
dX
aa
aa
aa
ab
ag
ao
ak
ao
aA
aE
aE
aE
aE
aE
aE
aE
aE
aA
bo
bn
bn
bB
ab
aa
aa
hp
hp
hp
hp
hp
hp
hp
hp
hp
hp
hp
hp
hp
hp
hp
"}
(14,1,1) = {"
aa
aa
dX
aC
aC
aC
aC
aC
aC
dX
aa
aa
aa
ab
ah
ao
au
ao
aA
aE
aE
aE
aE
aE
aE
aE
aE
aA
bo
bt
bn
bB
ab
aa
aa
hp
hp
hp
hp
hp
hp
hp
hp
hp
hp
hp
hp
hp
hp
hp
"}
(15,1,1) = {"
aa
aa
dX
dX
dX
dX
dX
dX
dX
dX
aa
aa
aa
ab
hk
ao
av
ao
aA
aE
aE
aE
aE
aE
aE
aE
aE
aA
bo
bn
by
bC
ab
aa
aa
hp
hp
hp
hp
hp
hp
hp
hp
hp
hp
hp
hp
hp
hp
hp
"}
(16,1,1) = {"
aa
aa
dX
aG
aG
aG
aG
aG
aG
dX
aa
aa
aa
ab
ai
ao
au
ao
aA
aE
aE
aE
aE
aE
aE
aE
aE
aA
bo
bt
by
bD
ab
aa
aa
aa
aa
aa
aa
aa
aa
aa
aa
aa
aa
aa
aa
aa
aa
aa
"}
(17,1,1) = {"
aa
aa
dX
aG
aG
bi
aG
aG
bi
dX
aa
aa
aa
ab
aj
ao
ak
ao
aA
aE
aE
aE
aE
aE
aE
aE
aE
aA
bo
bn
by
bE
ab
aa
aa
aa
aa
aa
aa
aa
aa
aa
aa
aa
aa
aa
aa
aa
aa
aa
"}
(18,1,1) = {"
aa
aa
dX
aG
bi
aG
aG
bi
bi
dX
aa
aa
aa
ab
ai
ak
ak
ak
aA
aE
aE
aE
aR
aR
bb
aE
aE
bk
bp
bn
bn
bF
ab
aa
aa
OG
OG
OG
OG
OG
OG
OG
OG
OG
OG
OG
OG
OG
OG
OG
"}
(19,1,1) = {"
aa
aa
dX
aG
bi
aG
bi
aG
bi
dX
aa
aa
aa
ab
vc
ak
ak
kw
aA
Cf
aE
aE
aS
aR
bc
bf
Fi
bl
bn
bn
bn
Dh
ab
aa
aa
OG
OG
OG
OG
OG
OG
OG
OG
OG
OG
OG
OG
OG
OG
OG
"}
(20,1,1) = {"
aa
aa
dX
aG
aG
bi
aG
aG
bi
dX
aa
aa
aa
ab
ai
ak
ak
ak
aA
aE
aE
aE
aR
aR
bd
aE
aE
bk
bn
bv
bn
bG
ab
aa
aa
OG
OG
OG
OG
OG
OG
OG
OG
OG
OG
OG
OG
OG
OG
OG
"}
(21,1,1) = {"
aa
aa
dX
aG
aG
aG
aG
aG
aG
dX
aa
aa
aa
ab
aj
ao
ak
ao
aA
aE
aE
aE
aE
aE
aE
aE
aE
aA
bo
bn
by
dv
ab
aa
aa
OG
OG
OG
OG
OG
OG
OG
OG
OG
OG
OG
OG
OG
OG
OG
"}
(22,1,1) = {"
aa
aa
dX
dX
dX
dX
dX
dX
dX
dX
aa
aa
aa
ab
ai
ao
au
ao
aA
aE
aE
aE
aE
aE
aE
aE
aE
aA
bo
bt
by
bI
ab
aa
aa
OG
OG
OG
OG
OG
OG
OG
OG
OG
OG
OG
OG
OG
OG
OG
"}
(23,1,1) = {"
aa
aa
dX
cm
cm
cm
cm
cm
cm
dX
aa
aa
aa
ab
VK
ao
av
ao
aA
aE
aE
aE
aE
aE
aE
aE
aE
aA
bo
bn
by
bJ
ab
aa
aa
OG
OG
OG
OG
OG
OG
OG
OG
OG
OG
OG
OG
OG
OG
OG
"}
(24,1,1) = {"
aa
aa
dX
cm
cm
cm
cm
cm
cm
dX
aa
aa
aa
ab
ak
ao
au
ao
aA
aE
aE
aE
aE
aE
aE
aE
aE
aA
bo
bt
by
bB
ab
aa
aa
OG
OG
OG
OG
OG
OG
OG
OG
OG
OG
OG
OG
OG
OG
OG
"}
(25,1,1) = {"
aa
aa
dX
cm
cp
cm
cp
cm
cp
dX
aa
aa
aa
ab
ak
ap
aw
ax
aB
aF
aF
aF
aF
aF
aF
aF
aF
aB
br
bw
by
bK
ab
aa
aa
OG
OG
OG
OG
OG
OG
OG
VE
OG
OG
OG
OG
OG
OG
OG
"}
(26,1,1) = {"
aa
aa
dX
cm
cp
cm
cp
cm
cp
dX
aa
aa
aa
ab
al
aq
ak
ak
aA
tW
aL
aL
aL
aL
aL
aL
tW
aA
bn
bn
bn
bL
ab
aa
aa
OG
OG
OG
OG
OG
OG
OG
OG
OG
OG
OG
OG
OG
OG
OG
"}
(27,1,1) = {"
aa
aa
dX
cm
cm
cp
cm
cp
cm
dX
aa
aa
aa
ab
ab
ab
ab
ab
ab
ab
aJ
aJ
aJ
aJ
aJ
aJ
ab
ab
ab
ab
ab
ab
ab
aa
aa
OG
OG
OG
OG
OG
OG
OG
OG
OG
OG
OG
OG
OG
OG
OG
"}
(28,1,1) = {"
aa
aa
dX
cm
cm
cm
cm
cm
cm
dX
aa
aa
aa
aa
aa
aa
aa
ab
az
ZY
aM
aM
aM
aM
aM
aM
ZY
az
ab
aa
aa
aa
aa
aa
aa
OG
OG
OG
OG
OG
OG
OG
OG
OG
OG
OG
OG
OG
OG
OG
"}
(29,1,1) = {"
aa
aa
dX
dX
dX
dX
dX
dX
dX
dX
aa
aa
aa
aa
aa
aa
aa
ab
az
az
aM
aM
aM
aM
aM
aM
az
az
ab
aa
aa
aa
aa
aa
aa
OG
OG
OG
OG
OG
OG
OG
OG
OG
OG
OG
OG
OG
OG
OG
"}
(30,1,1) = {"
aa
aa
dX
cn
cn
cn
cn
cn
cn
dX
aa
aa
aa
aa
aa
aa
aa
ab
az
az
aM
aM
aM
aM
aM
aM
az
az
ab
aa
aa
aa
aa
aa
aa
OG
OG
OG
OG
OG
OG
OG
OG
OG
OG
OG
OG
OG
OG
OG
"}
(31,1,1) = {"
aa
aa
dX
cn
cq
cq
cq
cn
cn
dX
aa
aa
aa
aa
aa
aa
aa
ab
az
az
aM
aM
aM
aM
aM
aM
az
az
ab
aa
aa
aa
aa
aa
aa
OG
OG
OG
OG
OG
OG
OG
OG
OG
OG
OG
OG
OG
OG
OG
"}
(32,1,1) = {"
aa
aa
dX
cn
cn
cn
cq
cn
cn
dX
aa
aa
aa
aa
aa
aa
aa
ab
az
WC
aM
aM
aM
aM
aM
aM
WC
az
ab
aa
aa
aa
aa
aa
aa
OG
OG
OG
OG
OG
OG
OG
OG
OG
OG
OG
OG
OG
OG
OG
"}
(33,1,1) = {"
aa
aa
dX
cn
cq
cq
cq
cq
cq
dX
aa
aa
aa
aa
aa
aa
aa
ab
ab
ab
az
az
az
az
az
az
ab
ab
ab
aa
aa
aa
aa
aa
aa
aa
aa
aa
aa
aa
aa
aa
aa
aa
aa
aa
aa
aa
aa
aa
"}
(34,1,1) = {"
aa
aa
dX
cn
cn
cn
cq
cn
cn
dX
aa
aa
aa
aa
aa
aa
aa
aa
aa
ab
az
az
az
az
az
az
ab
aa
aa
aa
aa
aa
aa
aa
aa
aa
aa
aa
aa
aa
aa
aa
aa
aa
aa
aa
aa
aa
aa
aa
"}
(35,1,1) = {"
aa
aa
dX
cn
cn
cn
cn
cn
cn
dX
aa
aa
aa
aa
aa
aa
aa
aa
aa
ab
ab
ab
ab
ab
ab
ab
ab
aa
aa
aa
aa
aa
aa
aa
aa
aa
aa
aa
aa
aa
aa
aa
aa
aa
aa
aa
aa
aa
aa
aa
"}
(36,1,1) = {"
aa
aa
dX
dX
dX
dX
dX
dX
dX
dX
aa
aa
aa
aa
aa
aa
aa
aa
aa
aa
aa
aa
aa
aa
aa
aa
aa
aa
aa
aa
aa
aa
aa
aa
aa
aa
aa
aa
aa
aa
aa
aa
aa
aa
aa
aa
aa
aa
aa
aa
"}
(37,1,1) = {"
aa
aa
dX
cr
cr
cr
cr
dX
aa
aa
aa
aa
aa
aa
aa
aa
aa
aa
aa
aa
aa
aa
aa
aa
aa
aa
aa
aa
aa
aa
aa
aa
aa
aa
aa
aa
aa
aa
aa
aa
aa
aa
aa
aa
aa
aa
aa
aa
aa
aa
"}
(38,1,1) = {"
aa
aa
dX
cr
cr
cr
cr
dX
aa
aa
aa
aa
aa
aa
aa
aa
aa
aa
aa
aa
aa
aa
aa
aa
aa
aa
aa
aa
aa
aa
aa
aa
aa
aa
aa
aa
aa
aa
aa
aa
aa
aa
aa
aa
aa
aa
aa
aa
aa
aa
"}
(39,1,1) = {"
aa
aa
dX
cr
cr
cr
cr
dX
aa
aa
aa
aa
aa
aa
aa
aa
aa
aa
aa
aa
aa
aa
aa
aa
aa
aa
aa
aa
aa
aa
aa
aa
aa
aa
aa
aa
aa
aa
aa
aa
aa
aa
aa
aa
aa
aa
aa
aa
aa
aa
"}
(40,1,1) = {"
aa
aa
dX
cr
cr
cr
cr
dX
aa
aa
aa
aa
aa
aa
aa
aa
aa
aa
aa
aa
aa
aa
aa
aa
aa
aa
aa
aa
aa
aa
aa
aa
aa
aa
aa
aa
aa
aa
aa
aa
aa
aa
aa
aa
aa
aa
aa
aa
aa
aa
"}
(41,1,1) = {"
aa
aa
dX
cr
cr
cr
cr
dX
aa
aa
aa
aa
aa
aa
aa
aa
aa
aa
aa
aa
aa
aa
aa
aa
aa
aa
aa
aa
aa
aa
aa
aa
aa
aa
aa
aa
aa
aa
aa
aa
aa
aa
aa
aa
aa
aa
aa
aa
aa
aa
"}
(42,1,1) = {"
aa
aa
dX
dX
dX
dX
dX
dX
aa
aa
aa
aa
aa
aa
aa
aa
aa
aa
aa
aa
aa
aa
aa
aa
aa
aa
aa
aa
aa
aa
aa
aa
aa
aa
aa
aa
aa
aa
aa
aa
aa
aa
aa
aa
aa
aa
aa
aa
aa
aa
"}
(43,1,1) = {"
aa
aa
aa
aa
aa
aa
aa
aa
aa
aa
aa
aa
aa
aa
aa
aa
aa
aa
aa
aa
aa
aa
aa
aa
aa
aa
aa
aa
aa
aa
aa
aa
aa
aa
aa
aa
aa
aa
aa
aa
aa
aa
aa
aa
aa
aa
aa
aa
aa
aa
"}
(44,1,1) = {"
aa
aa
aa
aa
aa
aa
aa
aa
aa
aa
aa
aa
aa
aa
aa
aa
aa
aa
aa
aa
aa
aa
aa
aa
aa
aa
aa
aa
aa
aa
aa
aa
aa
aa
aa
aa
aa
aa
aa
aa
aa
aa
aa
aa
aa
aa
aa
aa
aa
aa
"}
(45,1,1) = {"
aa
aa
aa
aa
aa
aa
aa
aa
aa
aa
aa
aa
aa
aa
aa
aa
aa
aa
aa
aa
aa
aa
aa
aa
aa
aa
aa
aa
aa
aa
aa
aa
aa
aa
aa
aa
aa
aa
aa
aa
aa
aa
aa
aa
aa
aa
aa
bq
aa
aa
"}
(46,1,1) = {"
aa
aa
aa
aa
aa
aa
aa
aa
aa
aa
aa
aa
aa
aa
aa
aa
aa
aa
aa
aa
aa
aa
aa
aa
aa
aa
aa
aa
aa
aa
aa
aa
aa
aa
aa
aa
aa
aa
aa
aa
aa
aa
aa
aa
aa
aa
aa
aa
aa
aa
"}
(47,1,1) = {"
aa
aa
aa
aa
aa
aa
aa
aa
aa
aa
aa
aa
aa
aa
aa
aa
aa
aa
aa
aa
aa
aa
aa
aa
aa
aa
aa
aa
aa
aa
aa
aa
aa
aa
aa
aa
aa
aa
aa
aa
aa
aa
aa
aa
aa
aa
aa
aa
aa
aa
"}
(48,1,1) = {"
aa
aa
aa
aa
aa
aa
aa
aa
aa
aa
aa
aa
aa
aa
aa
aa
aa
aa
aa
aa
aa
aa
aa
aa
aa
aa
aa
aa
aa
aa
aa
aa
aa
aa
aa
aa
aa
aa
aa
aa
aa
aa
aa
aa
aa
aa
aa
aa
aa
aa
"}
(49,1,1) = {"
aa
aa
aa
aa
aa
aa
aa
aa
aa
aa
aa
aa
aa
aa
aa
aa
aa
aa
aa
aa
aa
aa
aa
aa
aa
aa
aa
aa
aa
aa
aa
aa
aa
aa
aa
aa
aa
aa
aa
aa
aa
aa
aa
aa
aa
aa
aa
aa
aa
aa
"}
(50,1,1) = {"
aa
aa
aa
aa
aa
aa
aa
aa
aa
aa
aa
aa
aa
aa
aa
aa
aa
aa
aa
aa
aa
aa
aa
aa
aa
aa
aa
aa
aa
aa
aa
aa
aa
aa
aa
aa
aa
aa
aa
aa
aa
aa
aa
aa
aa
aa
aa
aa
aa
aa
"}
(51,1,1) = {"
aa
aa
aa
aa
aa
aa
aa
aa
aa
aa
aa
aa
aa
aa
aa
aa
aa
aa
aa
aa
aa
aa
aa
aa
aa
aa
aa
aa
aa
aa
aa
aa
aa
aa
aa
aa
aa
aa
aa
aa
aa
aa
aa
aa
aa
aa
aa
aa
aa
aa
"}
(52,1,1) = {"
aa
aa
aa
aa
aa
aa
aa
aa
aa
aa
aa
aa
aa
aa
aa
aa
aa
aa
aa
aa
aa
aa
aa
aa
aa
aa
aa
aa
aa
aa
aa
aa
aa
aa
aa
aa
aa
aa
aa
aa
aa
aa
aa
aa
aa
aa
aa
aa
aa
aa
"}
(53,1,1) = {"
aa
aa
aa
aa
aa
aa
aa
aa
aa
aa
aa
aa
aa
aa
aa
aa
aa
aa
aa
aa
aa
aa
aa
aa
aa
aa
aa
aa
aa
aa
aa
aa
aa
aa
aa
aa
aa
aa
aa
aa
aa
aa
aa
aa
aa
aa
aa
aa
aa
aa
"}
(54,1,1) = {"
aa
aa
aa
aa
aa
aa
aa
aa
aa
aa
aa
aa
aa
aa
aa
aa
aa
aa
aa
aa
aa
aa
aa
aa
aa
aa
aa
aa
aa
aa
aa
aa
aa
aa
aa
aa
aa
aa
aa
aa
aa
aa
aa
aa
aa
aa
aa
aa
aa
aa
"}
(55,1,1) = {"
aa
aa
aa
aa
aa
aa
aa
aa
aa
aa
aa
aa
aa
aa
aa
aa
aa
aa
aa
aa
aa
aa
aa
aa
aa
aa
aa
aa
aa
aa
aa
aa
aa
aa
aa
aa
aa
aa
aa
aa
aa
aa
aa
aa
aa
aa
aa
aa
aa
aa
"}
(56,1,1) = {"
aa
aa
aa
aa
aa
aa
aa
aa
aa
aa
aa
aa
aa
aa
aa
aa
aa
aa
aa
aa
aa
aa
aa
aa
aa
aa
aa
aa
aa
aa
aa
aa
aa
aa
aa
aa
aa
aa
aa
aa
aa
aa
aa
aa
aa
aa
aa
aa
aa
aa
"}
(57,1,1) = {"
aa
aa
aa
aa
aa
aa
aa
aa
aa
aa
aa
aa
aa
aa
aa
aa
aa
aa
aa
aa
aa
aa
aa
aa
aa
aa
aa
aa
aa
aa
aa
aa
aa
aa
aa
aa
aa
aa
aa
aa
aa
aa
aa
aa
aa
aa
aa
aa
aa
aa
"}
(58,1,1) = {"
aa
aa
aa
aa
aa
aa
aa
aa
aa
aa
aa
aa
aa
aa
aa
aa
aa
aa
aa
aa
aa
aa
aa
aa
aa
aa
aa
aa
aa
aa
aa
aa
aa
aa
aa
aa
aa
aa
aa
aa
aa
aa
aa
aa
aa
aa
aa
aa
aa
aa
"}
(59,1,1) = {"
aa
aa
aa
aa
aa
aa
aa
aa
aa
aa
aa
aa
aa
aa
aa
aa
aa
aa
aa
aa
aa
aa
aa
aa
aa
aa
aa
aa
aa
aa
aa
aa
aa
aa
aa
aa
aa
aa
aa
aa
aa
aa
aa
aa
aa
aa
aa
aa
aa
aa
"}
(60,1,1) = {"
aa
aa
aa
aa
aa
aa
aa
aa
aa
aa
aa
aa
aa
aa
aa
aa
aa
aa
aa
aa
aa
aa
aa
aa
aa
aa
aa
aa
aa
aa
aa
aa
aa
aa
aa
aa
aa
aa
aa
aa
aa
aa
aa
aa
aa
aa
aa
aa
aa
aa
"}
(61,1,1) = {"
aa
aa
aa
aa
aa
aa
aa
aa
aa
aa
aa
aa
aa
aa
aa
aa
aa
aa
aa
aa
aa
aa
aa
aa
aa
aa
aa
aa
aa
aa
aa
aa
aa
aa
aa
aa
aa
aa
aa
aa
aa
aa
aa
aa
aa
aa
aa
aa
aa
aa
"}
(62,1,1) = {"
aa
aa
aa
aa
aa
aa
aa
aa
aa
aa
aa
aa
aa
aa
aa
aa
aa
aa
aa
aa
aa
aa
aa
aa
aa
aa
aa
aa
aa
aa
aa
aa
aa
aa
aa
aa
aa
aa
aa
aa
aa
aa
aa
aa
aa
aa
aa
aa
aa
aa
"}
(63,1,1) = {"
aa
aa
aa
aa
aa
aa
aa
aa
aa
aa
aa
aa
aa
aa
aa
aa
aa
aa
aa
aa
aa
aa
aa
aa
aa
aa
aa
aa
aa
aa
aa
aa
aa
aa
aa
aa
aa
aa
aa
aa
aa
aa
aa
aa
aa
aa
aa
aa
aa
aa
"}
(64,1,1) = {"
aa
aa
aa
aa
aa
aa
aa
aa
aa
aa
aa
aa
aa
aa
aa
aa
aa
aa
aa
aa
aa
aa
aa
aa
aa
aa
aa
aa
aa
aa
aa
aa
aa
aa
aa
aa
aa
aa
aa
aa
aa
aa
aa
aa
aa
aa
aa
aa
aa
aa
"}
(65,1,1) = {"
aa
aa
aa
aa
aa
aa
aa
aa
aa
aa
aa
aa
aa
aa
aa
aa
aa
aa
aa
aa
aa
aa
aa
aa
aa
aa
aa
aa
aa
aa
aa
aa
aa
aa
aa
aa
aa
aa
aa
aa
aa
aa
aa
aa
aa
aa
aa
aa
aa
aa
"}
(66,1,1) = {"
aa
aa
aa
aa
aa
aa
aa
aa
aa
aa
aa
aa
aa
aa
aa
aa
aa
aa
aa
aa
aa
aa
aa
aa
aa
aa
aa
aa
aa
aa
aa
aa
aa
aa
aa
aa
aa
aa
aa
aa
aa
aa
aa
aa
aa
aa
aa
aa
aa
aa
"}
(67,1,1) = {"
aa
aa
aa
aa
aa
aa
aa
aa
aa
aa
aa
aa
aa
aa
aa
aa
aa
aa
aa
aa
aa
aa
aa
aa
aa
aa
aa
aa
aa
aa
aa
aa
aa
aa
aa
aa
aa
aa
aa
aa
aa
aa
aa
aa
aa
aa
aa
aa
aa
aa
"}
(68,1,1) = {"
aa
aa
aa
aa
aa
aa
aa
aa
aa
aa
aa
aa
aa
aa
aa
aa
aa
aa
aa
aa
aa
aa
aa
aa
aa
aa
aa
aa
aa
aa
aa
aa
aa
aa
aa
aa
aa
aa
aa
aa
aa
aa
aa
aa
aa
aa
aa
aa
aa
aa
"}
(69,1,1) = {"
aa
aa
aa
aa
aa
aa
aa
aa
aa
aa
aa
aa
aa
aa
aa
aa
aa
aa
aa
aa
aa
aa
aa
aa
aa
aa
aa
aa
aa
aa
aa
aa
aa
aa
aa
aa
aa
aa
aa
aa
aa
aa
aa
aa
aa
aa
aa
aa
aa
aa
"}
(70,1,1) = {"
aa
aa
aa
aa
aa
aa
aa
aa
aa
aa
aa
aa
aa
aa
aa
aa
aa
aa
aa
aa
aa
aa
aa
aa
aa
aa
aa
aa
aa
aa
aa
aa
aa
aa
aa
aa
aa
aa
aa
aa
aa
aa
aa
aa
aa
aa
aa
aa
aa
aa
"}
(71,1,1) = {"
aa
aa
aa
aa
aa
aa
aa
aa
aa
aa
aa
aa
aa
aa
aa
aa
aa
aa
aa
aa
aa
aa
aa
aa
aa
aa
aa
aa
aa
aa
aa
aa
aa
aa
aa
aa
aa
aa
aa
aa
aa
aa
aa
aa
aa
aa
aa
aa
aa
aa
"}
(72,1,1) = {"
aa
aa
aa
aa
aa
aa
aa
aa
aa
aa
aa
aa
aa
aa
aa
aa
aa
aa
aa
aa
aa
aa
aa
aa
aa
aa
aa
aa
aa
aa
aa
aa
aa
aa
aa
aa
aa
aa
aa
aa
aa
aa
aa
aa
aa
aa
aa
aa
aa
aa
"}
(73,1,1) = {"
aa
aa
aa
aa
aa
aa
aa
aa
aa
aa
aa
aa
aa
aa
aa
aa
aa
aa
aa
aa
aa
aa
aa
aa
aa
aa
aa
aa
aa
aa
aa
aa
aa
aa
aa
aa
aa
aa
aa
aa
aa
aa
aa
aa
aa
aa
aa
aa
aa
aa
"}
(74,1,1) = {"
aa
aa
aa
aa
aa
aa
aa
aa
aa
aa
aa
aa
aa
aa
aa
aa
aa
aa
aa
aa
aa
aa
aa
aa
aa
aa
aa
aa
aa
aa
aa
aa
aa
aa
aa
aa
aa
aa
aa
aa
aa
aa
aa
aa
aa
aa
aa
aa
aa
aa
"}
(75,1,1) = {"
aa
aa
aa
aa
aa
aa
aa
aa
aa
aa
aa
aa
aa
aa
aa
aa
aa
aa
aa
aa
aa
aa
aa
aa
aa
aa
aa
aa
aa
aa
aa
aa
aa
aa
aa
aa
aa
aa
aa
aa
aa
aa
aa
aa
aa
aa
aa
aa
aa
aa
"}
(76,1,1) = {"
aa
aa
aa
aa
aa
aa
aa
aa
aa
aa
aa
aa
aa
aa
aa
aa
aa
aa
aa
aa
aa
aa
aa
aa
aa
aa
aa
aa
aa
aa
aa
aa
aa
aa
aa
aa
aa
aa
aa
aa
aa
aa
aa
aa
aa
aa
aa
aa
aa
aa
"}
(77,1,1) = {"
aa
aa
aa
aa
aa
aa
aa
aa
aa
aa
aa
aa
aa
aa
aa
aa
aa
aa
aa
aa
aa
aa
aa
aa
aa
aa
aa
aa
aa
aa
aa
aa
aa
aa
aa
aa
aa
aa
aa
aa
aa
aa
aa
aa
aa
aa
aa
aa
aa
aa
"}
(78,1,1) = {"
aa
aa
aa
aa
aa
aa
aa
aa
aa
aa
aa
aa
aa
aa
aa
aa
aa
aa
aa
aa
aa
aa
aa
aa
aa
aa
aa
aa
aa
aa
aa
aa
aa
aa
aa
aa
aa
aa
aa
aa
aa
aa
aa
aa
aa
aa
aa
aa
aa
aa
"}
(79,1,1) = {"
aa
aa
aa
aa
aa
aa
aa
aa
aa
aa
aa
aa
aa
aa
aa
aa
aa
aa
aa
aa
aa
aa
aa
aa
aa
aa
aa
aa
aa
aa
aa
aa
aa
aa
aa
aa
aa
aa
aa
aa
aa
aa
aa
aa
aa
aa
aa
aa
aa
aa
"}
(80,1,1) = {"
aa
aa
aa
aa
aa
aa
aa
aa
aa
aa
aa
aa
aa
aa
aa
aa
aa
aa
aa
aa
aa
aa
aa
aa
aa
aa
aa
aa
aa
aa
aa
aa
aa
aa
aa
aa
aa
aa
aa
aa
aa
aa
aa
aa
aa
aa
aa
aa
aa
aa
"}
(81,1,1) = {"
aa
aa
aa
aa
aa
aa
aa
aa
aa
aa
aa
aa
aa
aa
aa
aa
aa
aa
aa
aa
aa
aa
aa
aa
aa
aa
aa
aa
aa
aa
aa
aa
aa
aa
aa
aa
aa
aa
aa
aa
aa
aa
aa
aa
aa
aa
aa
aa
aa
aa
"}
(82,1,1) = {"
aa
aa
aa
aa
aa
aa
aa
aa
aa
aa
aa
aa
aa
aa
aa
aa
aa
aa
aa
aa
aa
aa
aa
aa
aa
aa
aa
aa
aa
aa
aa
aa
aa
aa
aa
aa
aa
aa
aa
aa
aa
aa
aa
aa
aa
aa
aa
aa
aa
aa
"}
(83,1,1) = {"
aa
aa
aa
aa
aa
aa
aa
aa
aa
aa
aa
aa
aa
aa
aa
aa
aa
aa
aa
aa
aa
aa
aa
aa
aa
aa
aa
aa
aa
aa
aa
aa
aa
aa
aa
aa
aa
aa
aa
aa
aa
aa
aa
aa
aa
aa
aa
aa
aa
aa
"}
(84,1,1) = {"
aa
aa
aa
aa
aa
aa
aa
aa
aa
aa
aa
aa
aa
aa
aa
aa
aa
aa
aa
aa
aa
aa
aa
aa
aa
aa
aa
aa
aa
aa
aa
aa
aa
aa
aa
aa
aa
aa
aa
aa
aa
aa
aa
aa
aa
aa
aa
aa
aa
aa
"}
(85,1,1) = {"
aa
aa
aa
aa
aa
aa
aa
aa
aa
aa
aa
aa
aa
aa
aa
aa
aa
aa
aa
aa
aa
aa
aa
aa
aa
aa
aa
aa
aa
aa
aa
aa
aa
aa
aa
aa
aa
aa
aa
aa
aa
aa
aa
aa
aa
aa
aa
aa
aa
aa
"}
(86,1,1) = {"
aa
aa
aa
aa
aa
aa
aa
aa
aa
aa
aa
aa
aa
aa
aa
aa
aa
aa
aa
aa
aa
aa
aa
aa
aa
aa
aa
aa
aa
aa
aa
aa
aa
aa
aa
aa
aa
aa
aa
aa
aa
aa
aa
aa
aa
aa
aa
aa
aa
aa
"}
(87,1,1) = {"
aa
aa
aa
aa
aa
aa
aa
aa
aa
aa
aa
aa
aa
aa
aa
aa
aa
aa
aa
aa
aa
aa
aa
aa
aa
aa
aa
aa
aa
aa
aa
aa
aa
aa
aa
aa
aa
aa
aa
aa
aa
aa
aa
aa
aa
aa
aa
aa
aa
aa
"}
(88,1,1) = {"
aa
aa
aa
aa
aa
aa
aa
aa
aa
aa
aa
aa
aa
aa
aa
aa
aa
aa
aa
aa
aa
aa
aa
aa
aa
aa
aa
aa
aa
aa
aa
aa
aa
aa
aa
aa
aa
aa
aa
aa
aa
aa
aa
aa
aa
aa
aa
aa
aa
aa
"}
(89,1,1) = {"
aa
aa
aa
aa
aa
aa
aa
aa
aa
aa
aa
aa
aa
aa
aa
aa
aa
aa
aa
aa
aa
aa
aa
aa
aa
aa
aa
aa
aa
aa
aa
aa
aa
aa
aa
aa
aa
aa
aa
aa
aa
aa
aa
aa
aa
aa
aa
aa
aa
aa
"}
(90,1,1) = {"
aa
aa
aa
aa
aa
aa
aa
aa
aa
aa
aa
aa
aa
aa
aa
aa
aa
aa
aa
aa
aa
aa
aa
aa
aa
aa
aa
aa
aa
aa
aa
aa
aa
aa
aa
aa
aa
aa
aa
aa
aa
aa
aa
aa
aa
aa
aa
aa
aa
aa
"}
