//MAP CONVERTED BY dmm2tgm.py THIS HEADER COMMENT PREVENTS RECONVERSION, DO NOT REMOVE
"aI" = (
/obj/machinery/atmospherics/pipe/simple/supply/hidden/layer1{
	dir = 10
	},
/obj/effect/ai_node,
/turf/open/floor/plating/ground/dirt,
/area/lv624/ground/jungle7)
"aW" = (
/obj/machinery/floodlight/colony,
/turf/open/floor/plating/ground/dirt,
/area/lv624/ground/jungle7)
"bH" = (
/obj/docking_port/stationary/crashmode,
/turf/closed/gm/dense,
/area/lv624/ground/jungle9)
"bL" = (
/obj/structure/jungle/vines,
/turf/open/ground/grass,
/area/lv624/ground/compound/ne)
"cg" = (
/obj/structure/flora/ausbushes/fullgrass,
/turf/open/floor/plating/ground/dirtgrassborder{
	dir = 8
	},
/area/lv624/ground/jungle7)
"ch" = (
/obj/structure/jungle/vines,
/turf/open/floor/plating/ground/dirt,
/area/lv624/ground/jungle7)
"cV" = (
/turf/closed/wall/r_wall,
/area/lv624/lazarus/main_hall)
"da" = (
/turf/open/floor/plating/ground/dirtgrassborder,
/area/lv624/ground/jungle9)
"dI" = (
/turf/open/ground/grass,
/area/lv624/ground/compound/ne)
"eg" = (
/obj/structure/flora/ausbushes/fullgrass,
/obj/machinery/floodlight/colony{
	dir = 8
	},
/turf/closed/gm/dense,
/area/lv624/ground/compound/ne)
"eh" = (
/obj/structure/jungle/vines,
/turf/open/floor/plating/ground/dirtgrassborder/corner{
	dir = 8
	},
/area/lv624/ground/jungle9)
"eo" = (
/obj/structure/bed/chair/office{
	dir = 8
	},
/turf/open/floor/plating/ground/dirtgrassborder{
	dir = 1
	},
/area/lv624/ground/jungle9)
"ep" = (
/obj/structure/jungle/vines,
/turf/open/floor/plating/ground/dirtgrassborder{
	dir = 4
	},
/area/lv624/ground/jungle7)
"eA" = (
/obj/structure/jungle/vines,
/turf/open/floor/plating/ground/dirtgrassborder/corner,
/area/lv624/ground/jungle9)
"eM" = (
/obj/structure/flora/ausbushes/fullgrass,
/turf/open/ground/grass,
/area/lv624/ground/jungle9)
"fj" = (
/obj/structure/flora/ausbushes/fullgrass,
/turf/open/floor/plating/ground/dirtgrassborder/corner{
	dir = 1
	},
/area/lv624/ground/jungle7)
"gZ" = (
/turf/open/floor/plating/ground/dirtgrassborder/corner{
	dir = 1
	},
/area/lv624/ground/jungle7)
"hh" = (
/obj/structure/fence,
/turf/open/floor/plating/ground/dirtgrassborder,
/area/lv624/ground/compound/ne)
"hq" = (
/obj/structure/jungle/planttop1,
/turf/open/ground/grass,
/area/lv624/ground/jungle9)
"in" = (
/obj/structure/flora/ausbushes/fullgrass,
/turf/open/ground/grass,
/area/lv624/ground/jungle7)
"iF" = (
/obj/machinery/atmospherics/pipe/simple/supply/hidden/layer1{
	dir = 4
	},
/obj/effect/ai_node,
/turf/open/floor/plating/ground/dirt,
/area/lv624/ground/jungle9)
"iO" = (
/obj/item/trash/pistachios,
/turf/open/ground/grass,
/area/lv624/ground/jungle9)
"jf" = (
/turf/open/ground/grass,
/area/lv624/ground/jungle9)
"jl" = (
/obj/structure/jungle/vines,
/turf/open/floor/plating/ground/dirtgrassborder/corner2{
	dir = 8
	},
/area/lv624/ground/jungle7)
"kC" = (
/obj/structure/jungle/vines,
/turf/open/ground/grass,
/area/lv624/ground/jungle7)
"kF" = (
/obj/structure/jungle/plantbot1,
/turf/open/ground/grass,
/area/lv624/ground/jungle9)
"la" = (
/obj/structure/flora/ausbushes/ppflowers,
/turf/open/floor/plating/ground/dirtgrassborder/corner{
	dir = 1
	},
/area/lv624/ground/jungle7)
"lx" = (
/obj/machinery/floodlight/colony{
	dir = 8
	},
/turf/open/floor/plating/ground/dirt,
/area/lv624/ground/jungle7)
"ly" = (
/obj/machinery/atmospherics/pipe/simple/supply/hidden/layer1,
/obj/structure/jungle/vines,
/obj/effect/ai_node,
/turf/open/floor/plating/ground/dirt,
/area/lv624/ground/jungle9)
"mb" = (
/obj/machinery/atmospherics/pipe/simple/supply/hidden/layer1,
/obj/effect/ai_node,
/turf/open/floor/plating/ground/dirt,
/area/lv624/ground/jungle9)
"nd" = (
/turf/open/floor/plating/ground/dirt,
/area/lv624/ground/jungle7)
"qe" = (
/obj/structure/flora/ausbushes/fullgrass,
/obj/structure/jungle/vines,
/turf/open/ground/grass,
/area/lv624/ground/jungle9)
"sZ" = (
/obj/structure/jungle/vines,
/turf/open/floor/plating/ground/dirtgrassborder/corner{
	dir = 1
	},
/area/lv624/ground/jungle9)
"td" = (
/obj/structure/flora/ausbushes/ppflowers,
/turf/open/ground/grass,
/area/lv624/ground/jungle9)
"up" = (
/obj/structure/flora/ausbushes/brflowers,
/turf/open/ground/grass,
/area/lv624/ground/jungle7)
"uA" = (
/obj/structure/flora/ausbushes/fullgrass,
/turf/open/floor/plating/ground/dirt,
/area/lv624/ground/jungle9)
"vS" = (
/obj/machinery/atmospherics/pipe/simple/supply/hidden/layer1{
	dir = 4
	},
/turf/open/floor/plating/ground/dirt,
/area/lv624/ground/jungle9)
"vT" = (
/obj/structure/fence,
/turf/open/floor/plating/ground/dirtgrassborder{
	dir = 1
	},
/area/lv624/ground/compound/ne)
"wf" = (
/obj/item/tape/engineering,
/turf/open/floor/plating/ground/dirtgrassborder{
	dir = 4
	},
/area/lv624/ground/compound/ne)
"wR" = (
/obj/structure/jungle/vines,
/turf/open/floor/plating/ground/dirtgrassborder{
	dir = 8
	},
/area/lv624/ground/jungle7)
"xw" = (
/turf/closed/wall,
/area/lv624/ground/jungle9)
"xR" = (
/turf/open/floor/plating/ground/dirtgrassborder/corner{
	dir = 4
	},
/area/lv624/ground/jungle7)
"yd" = (
/turf/open/floor/plating/ground/dirtgrassborder,
/area/lv624/ground/jungle7)
"yh" = (
/obj/structure/flora/ausbushes/fullgrass,
/obj/structure/jungle/vines,
/obj/structure/jungle/vines,
/turf/open/ground/grass,
/area/lv624/ground/jungle9)
"yi" = (
/obj/item/trash/chips,
/turf/open/floor/plating/ground/dirt,
/area/lv624/ground/jungle9)
"zZ" = (
/obj/structure/jungle/vines/heavy,
/turf/open/ground/grass,
/area/lv624/ground/jungle7)
"Aq" = (
/obj/machinery/atmospherics/pipe/simple/supply/hidden/layer1,
/obj/structure/flora/ausbushes/fullgrass,
/turf/open/floor/plating/ground/dirt,
/area/lv624/ground/jungle9)
"Az" = (
/obj/structure/flora/ausbushes/fullgrass,
/turf/closed/gm/dense,
/area/lv624/ground/compound/ne)
"AQ" = (
/obj/structure/jungle/vines,
/turf/open/floor/plating/ground/dirtgrassborder{
	dir = 4
	},
/area/lv624/ground/jungle9)
"Br" = (
/obj/structure/jungle/vines,
/obj/structure/jungle/vines,
/obj/structure/jungle/vines,
/turf/open/floor/plating/ground/dirtgrassborder{
	dir = 4
	},
/area/lv624/ground/jungle9)
"Bz" = (
/obj/machinery/atmospherics/pipe/simple/supply/hidden/layer1,
/obj/structure/jungle/vines,
/obj/structure/jungle/vines,
/turf/open/floor/plating/ground/dirt,
/area/lv624/ground/jungle9)
"BP" = (
/obj/structure/jungle/vines/heavy,
/turf/open/floor/plating/ground/dirtgrassborder/corner{
	dir = 1
	},
/area/lv624/ground/jungle9)
"CE" = (
/turf/open/floor/plating/ground/dirtgrassborder{
	dir = 8
	},
/area/lv624/ground/jungle7)
"CJ" = (
/turf/open/floor/plating/ground/dirtgrassborder{
	dir = 1
	},
/area/lv624/ground/jungle7)
"CR" = (
/obj/structure/jungle/vines/heavy,
/turf/open/ground/grass,
/area/lv624/ground/jungle9)
"Dq" = (
/turf/closed/gm/dense,
/area/lv624/ground/jungle7)
"DI" = (
/turf/open/floor/plating/ground/dirtgrassborder{
	dir = 4
	},
/area/lv624/ground/jungle9)
"EC" = (
/obj/structure/powerloader_wreckage,
/turf/open/ground/grass,
/area/lv624/ground/jungle7)
"Fb" = (
/obj/item/trash/eat,
/turf/open/ground/grass,
/area/lv624/ground/jungle9)
"Fh" = (
/obj/structure/flora/tree/jungle,
/turf/open/ground/grass,
/area/lv624/ground/jungle7)
"Fi" = (
/obj/structure/flora/ausbushes/fullgrass,
/turf/open/floor/plating/ground/dirtgrassborder{
	dir = 4
	},
/area/lv624/ground/jungle9)
"Fz" = (
/obj/machinery/atmospherics/pipe/simple/supply/hidden/layer1{
	dir = 4
	},
/obj/structure/flora/ausbushes/fullgrass,
/turf/open/floor/plating/ground/dirt,
/area/lv624/ground/jungle9)
"GG" = (
/obj/structure/flora/ausbushes/fullgrass,
/turf/open/floor/plating/ground/dirtgrassborder/corner{
	dir = 4
	},
/area/lv624/ground/jungle7)
"GW" = (
/obj/structure/table,
/obj/item/reagent_containers/food/snacks/monkeyburger{
	pixel_x = -3
	},
/obj/item/reagent_containers/food/snacks/orangecakeslice{
	pixel_x = 4;
	pixel_y = 8
	},
/turf/open/floor/plating/ground/dirtgrassborder{
	dir = 1
	},
/area/lv624/ground/jungle9)
"Hs" = (
/obj/structure/flora/ausbushes/fullgrass,
/turf/open/floor/plating/ground/dirtgrassborder{
	dir = 1
	},
/area/lv624/ground/jungle9)
"Is" = (
/turf/open/floor/plating/ground/dirtgrassborder/corner2,
/area/lv624/ground/jungle7)
"Ix" = (
/turf/open/floor/plating/ground/dirt,
/area/lv624/ground/jungle9)
"Jm" = (
/obj/structure/jungle/vines,
/obj/structure/jungle/vines,
/turf/open/floor/plating/ground/dirtgrassborder{
	dir = 4
	},
/area/lv624/ground/jungle9)
"Js" = (
/obj/machinery/atmospherics/pipe/simple/supply/hidden/layer1,
/turf/open/floor/plating/ground/dirt,
/area/lv624/ground/jungle9)
"JB" = (
/turf/open/floor/plating/ground/dirtgrassborder/corner2{
	dir = 8
	},
/area/lv624/ground/jungle9)
"JU" = (
/obj/machinery/atmospherics/pipe/simple/supply/hidden/layer1,
/obj/structure/jungle/vines,
/turf/open/floor/plating/ground/dirt,
/area/lv624/ground/jungle9)
"Lr" = (
/turf/open/floor/plating/ground/dirtgrassborder{
	dir = 1
	},
/area/lv624/ground/jungle9)
"Lt" = (
/obj/item/trash/burger,
/turf/open/floor/plating/ground/dirtgrassborder{
	dir = 8
	},
/area/lv624/ground/jungle9)
"Ma" = (
/turf/open/floor/plating/ground/dirtgrassborder/corner2{
	dir = 1
	},
/area/lv624/ground/jungle9)
"Mk" = (
/turf/open/floor/plating/ground/dirt,
/area/lv624/ground/compound/ne)
"MC" = (
/obj/machinery/miner/damaged,
/turf/open/ground/grass,
/area/lv624/ground/jungle7)
"MK" = (
/obj/structure/jungle/vines,
/obj/structure/jungle/vines/heavy,
/turf/open/ground/grass,
/area/lv624/ground/jungle9)
"MX" = (
/turf/open/floor/plating/ground/dirtgrassborder/corner{
	dir = 1
	},
/area/lv624/ground/jungle9)
"Ne" = (
/obj/structure/jungle/vines,
/turf/open/floor/plating/ground/dirtgrassborder{
	dir = 8
	},
/area/lv624/ground/jungle9)
"Op" = (
/obj/structure/jungle/vines,
/turf/open/floor/plating/ground/dirtgrassborder,
/area/lv624/ground/jungle9)
"Oz" = (
/obj/structure/flora/ausbushes/fullgrass,
/obj/machinery/floodlight/colony{
	dir = 4
	},
/turf/open/ground/grass,
/area/lv624/ground/jungle9)
"PR" = (
/turf/open/floor/plating/ground/dirtgrassborder{
	dir = 4
	},
/area/lv624/ground/jungle7)
"QD" = (
/obj/structure/flora/ausbushes/sunnybush,
/turf/open/floor/plating/ground/dirtgrassborder{
	dir = 1
	},
/area/lv624/ground/jungle9)
"QG" = (
/obj/structure/flora/ausbushes/fullgrass,
/turf/open/floor/plating/ground/dirtgrassborder,
/area/lv624/ground/jungle9)
"QV" = (
/turf/open/floor/plating/ground/dirtgrassborder/corner2{
	dir = 4
	},
/area/lv624/ground/jungle9)
"RS" = (
/obj/structure/jungle/vines,
/turf/open/ground/grass,
/area/lv624/ground/jungle9)
"Sx" = (
/obj/structure/flora/ausbushes/fullgrass,
/turf/open/ground/grass,
/area/lv624/ground/compound/ne)
"Ta" = (
/turf/open/floor/plating/ground/dirtgrassborder/corner{
	dir = 8
	},
/area/lv624/ground/jungle9)
"Tr" = (
/obj/structure/flora/ausbushes/fullgrass,
/obj/machinery/floodlight/colony{
	dir = 1
	},
/turf/open/floor/plating/ground/dirt,
/area/lv624/ground/jungle9)
"UP" = (
/obj/structure/jungle/vines,
/turf/open/floor/plating/ground/dirtgrassborder/corner{
	dir = 4
	},
/area/lv624/ground/jungle9)
"UQ" = (
/turf/open/floor/plating/ground/dirtgrassborder/corner,
/area/lv624/ground/jungle7)
"Va" = (
/turf/open/floor/plating/ground/dirtgrassborder{
	dir = 8
	},
/area/lv624/ground/jungle9)
"Vg" = (
/obj/machinery/door/poddoor/mainship{
	density = 0;
	dir = 2;
	icon_state = "pdoor0";
	id = "nexus_blast";
	name = "\improper Nexus Blast Door";
	opacity = 0
	},
/obj/machinery/atmospherics/pipe/simple/supply/hidden/layer1,
/obj/machinery/door/airlock/maintenance,
/turf/open/floor/tile/white,
/area/lv624/lazarus/main_hall)
"Vq" = (
/turf/open/ground/grass,
/area/lv624/ground/jungle7)
"Vy" = (
/turf/closed/wall,
/area/lv624/ground/compound/ne)
"VS" = (
/turf/open/floor/plating/ground/dirtgrassborder/corner{
	dir = 4
	},
/area/lv624/ground/jungle9)
"Wz" = (
/obj/structure/jungle/vines,
/turf/open/floor/plating/ground/dirtgrassborder{
	dir = 1
	},
/area/lv624/ground/jungle9)
"WC" = (
/obj/structure/flora/ausbushes/ppflowers,
/turf/open/ground/grass,
/area/lv624/ground/jungle7)
"WT" = (
/obj/structure/fence,
/turf/open/floor/plating/ground/dirtgrassborder,
/area/lv624/ground/jungle7)
"Xf" = (
/obj/structure/bed/chair/office{
	dir = 4
	},
/turf/open/floor/plating/ground/dirtgrassborder{
	dir = 1
	},
/area/lv624/ground/jungle9)
"Xh" = (
/turf/closed/wall,
/area/lv624/ground/jungle7)
"Xl" = (
/turf/closed/gm/dense,
/area/lv624/ground/jungle9)
"Xr" = (
/obj/structure/flora/ausbushes/fullgrass,
/obj/structure/jungle/vines/heavy,
/turf/open/ground/grass,
/area/lv624/ground/jungle9)
"XQ" = (
/turf/open/floor/plating/ground/dirtgrassborder/corner,
/area/lv624/ground/jungle9)
"XX" = (
/turf/open/floor/plating/ground/dirtgrassborder/corner{
	dir = 8
	},
/area/lv624/ground/jungle7)
"Zw" = (
/obj/structure/flora/ausbushes/fullgrass,
/turf/open/floor/plating/ground/dirtgrassborder{
	dir = 1
	},
/area/lv624/ground/jungle7)
"ZF" = (
/obj/structure/jungle/vines,
/turf/open/floor/plating/ground/dirtgrassborder/corner{
	dir = 4
	},
/area/lv624/ground/jungle7)

(1,1,1) = {"
PR
XX
Vq
WT
Ix
Ix
iF
Ix
xw
jf
eM
RS
CR
jf
Xl
jf
jf
jf
CR
Xl
"}
(2,1,1) = {"
nd
Zw
in
Xh
nd
Ix
vS
uA
Lr
XQ
Fi
eh
jf
Xl
Xl
Xl
Xl
DI
Ta
eA
"}
(3,1,1) = {"
cg
GG
Vq
la
CE
QV
vS
Ix
Lr
QG
Tr
Wz
Xl
Xl
Xl
Xl
Op
uA
Hs
da
"}
(4,1,1) = {"
Vq
Fh
WC
Vq
Vq
da
vS
yi
Xf
MX
Ne
UP
bH
Xl
Xl
MK
BP
Va
VS
sZ
"}
(5,1,1) = {"
Vq
Vq
Vq
Vq
Fh
da
vS
Ix
GW
jf
RS
MK
jf
Xl
jf
jf
RS
Xr
Xl
Xl
"}
(6,1,1) = {"
UQ
PR
XX
Vq
Vq
da
vS
Ix
eo
jf
Xl
Xl
jf
RS
jf
jf
jf
Xl
Xl
jf
"}
(7,1,1) = {"
yd
aW
CJ
Vq
Vq
yd
vS
Ix
Lr
RS
Xl
Xl
RS
qe
jf
eM
jf
RS
eh
RS
"}
(8,1,1) = {"
gZ
CE
ZF
Vq
Vq
yd
vS
Ix
Lr
jf
Xl
jf
RS
jf
hq
kF
jf
eM
jf
RS
"}
(9,1,1) = {"
Vq
kC
kC
Vq
WC
yd
vS
Ix
QD
jf
jf
RS
yh
jf
Oz
jf
jf
jf
jf
jf
"}
(10,1,1) = {"
Dq
Dq
Vq
Fh
UQ
Is
Fz
Ix
JB
Ta
td
RS
RS
jf
jf
jf
jf
Fb
dI
cV
"}
(11,1,1) = {"
Dq
Dq
Vq
UQ
Is
nd
vS
Ix
Ix
JB
AQ
AQ
Jm
Br
Jm
DI
DI
DI
DI
cV
"}
(12,1,1) = {"
Dq
Dq
kC
yd
aW
nd
aI
Js
Aq
Js
Js
ly
Js
JU
Bz
Js
Js
Js
mb
Vg
"}
(13,1,1) = {"
Dq
Dq
Vq
gZ
CE
CE
CE
CE
Va
Va
Va
QV
Ix
Ma
Va
Va
Lt
Va
Va
cV
"}
(14,1,1) = {"
XX
Vq
Vq
Dq
WC
Vq
MC
up
RS
XQ
Ta
MX
Va
VS
yh
jf
jf
eM
iO
cV
"}
(15,1,1) = {"
jl
PR
XX
Dq
Dq
Vq
Dq
Dq
kC
sZ
VS
XQ
Ta
jf
RS
RS
eM
jf
jf
cV
"}
(16,1,1) = {"
ch
nd
CJ
Vq
in
Vq
Dq
kC
WC
kC
jf
MX
VS
qe
RS
RS
RS
jf
jf
cV
"}
(17,1,1) = {"
wR
wR
xR
Vq
Vq
Vq
EC
Vq
Vq
dI
dI
jf
jf
eM
jf
RS
RS
jf
jf
cV
"}
(18,1,1) = {"
kC
kC
kC
Vq
Vq
in
UQ
ep
XX
Vy
wf
wf
wf
xw
dI
jf
RS
jf
jf
cV
"}
(19,1,1) = {"
zZ
Dq
Dq
Dq
kC
Vq
yd
lx
CJ
hh
Mk
Mk
Mk
vT
eg
Az
bL
RS
jf
dI
"}
(20,1,1) = {"
Dq
Dq
Dq
Dq
kC
in
fj
CE
xR
Vy
Mk
Mk
Mk
vT
Sx
Az
bL
dI
bL
dI
"}
