"aI" = (/obj/machinery/atmospherics/pipe/simple/supply/hidden/layer1{dir = 10},/turf/open/floor/plating/ground/dirt,/area/lv624/ground/jungle7)
"aW" = (/obj/machinery/colony_floodlight,/turf/open/floor/plating/ground/dirt,/area/lv624/ground/jungle7)
"bH" = (/obj/docking_port/stationary/crashmode,/turf/closed/gm/dense,/area/lv624/ground/jungle9)
"bL" = (/obj/structure/jungle/vines,/turf/open/ground/grass,/area/lv624/ground/compound/ne)
"cg" = (/obj/structure/flora/ausbushes/fullgrass,/turf/open/floor/plating/ground/dirtgrassborder{dir = 8},/area/lv624/ground/jungle7)
"ch" = (/obj/structure/jungle/vines,/turf/open/floor/plating/ground/dirt,/area/lv624/ground/jungle7)
"cV" = (/turf/closed/wall/r_wall,/area/lv624/lazarus/main_hall)
"da" = (/turf/open/floor/plating/ground/dirtgrassborder,/area/lv624/ground/jungle9)
"dI" = (/turf/open/ground/grass,/area/lv624/ground/compound/ne)
"eg" = (/obj/structure/flora/ausbushes/fullgrass,/obj/machinery/colony_floodlight{dir = 8},/turf/closed/gm/dense,/area/lv624/ground/compound/ne)
"eh" = (/obj/structure/jungle/vines,/turf/open/floor/plating/ground/dirtgrassborder/corner{dir = 8},/area/lv624/ground/jungle9)
"eo" = (/obj/structure/bed/chair/office{dir = 8},/turf/open/ground/grass,/area/lv624/ground/jungle9)
"ep" = (/obj/structure/jungle/vines,/turf/open/floor/plating/ground/dirtgrassborder{dir = 4},/area/lv624/ground/jungle7)
"eA" = (/obj/structure/jungle/vines,/turf/open/floor/plating/ground/dirtgrassborder/corner,/area/lv624/ground/jungle9)
"eM" = (/obj/structure/flora/ausbushes/fullgrass,/turf/open/ground/grass,/area/lv624/ground/jungle9)
"fj" = (/obj/structure/flora/ausbushes/fullgrass,/turf/open/floor/plating/ground/dirtgrassborder/corner{dir = 1},/area/lv624/ground/jungle7)
"gZ" = (/turf/open/floor/plating/ground/dirtgrassborder/corner{dir = 1},/area/lv624/ground/jungle7)
"hh" = (/obj/structure/fence,/turf/open/floor/plating/ground/dirtgrassborder,/area/lv624/ground/compound/ne)
"hq" = (/obj/structure/jungle/planttop1,/turf/open/ground/grass,/area/lv624/ground/jungle9)
"in" = (/obj/structure/flora/ausbushes/fullgrass,/turf/open/ground/grass,/area/lv624/ground/jungle7)
"iO" = (/obj/item/trash/pistachios,/turf/open/ground/grass,/area/lv624/ground/jungle9)
"jf" = (/turf/open/ground/grass,/area/lv624/ground/jungle9)
"jl" = (/obj/structure/jungle/vines,/turf/open/floor/plating/ground/dirtgrassborder/corner2{dir = 8},/area/lv624/ground/jungle7)
"kC" = (/obj/structure/jungle/vines,/turf/open/ground/grass,/area/lv624/ground/jungle7)
"kF" = (/obj/structure/jungle/plantbot1,/turf/open/ground/grass,/area/lv624/ground/jungle9)
"la" = (/obj/structure/flora/ausbushes/ppflowers,/turf/open/floor/plating/ground/dirtgrassborder/corner{dir = 1},/area/lv624/ground/jungle7)
"lx" = (/obj/machinery/colony_floodlight{dir = 8},/turf/open/floor/plating/ground/dirt,/area/lv624/ground/jungle7)
"ly" = (/obj/machinery/atmospherics/pipe/simple/supply/hidden/layer1{dir = 4},/turf/open/floor/plating/ground/dirt,/area/lv624/ground/jungle9)
"nd" = (/turf/open/floor/plating/ground/dirt,/area/lv624/ground/jungle7)
"qe" = (/obj/structure/flora/ausbushes/fullgrass,/obj/structure/jungle/vines,/turf/open/ground/grass,/area/lv624/ground/jungle9)
"sZ" = (/obj/structure/jungle/vines,/turf/open/floor/plating/ground/dirtgrassborder/corner{dir = 1},/area/lv624/ground/jungle9)
"td" = (/obj/structure/flora/ausbushes/ppflowers,/turf/open/ground/grass,/area/lv624/ground/jungle9)
"up" = (/obj/structure/flora/ausbushes/brflowers,/turf/open/ground/grass,/area/lv624/ground/jungle7)
"uA" = (/obj/structure/flora/ausbushes/fullgrass,/turf/open/floor/plating/ground/dirt,/area/lv624/ground/jungle9)
"vT" = (/obj/structure/fence,/turf/open/floor/plating/ground/dirtgrassborder{dir = 1},/area/lv624/ground/compound/ne)
"wf" = (/obj/item/tape/engineering,/turf/open/floor/plating/ground/dirtgrassborder{dir = 4},/area/lv624/ground/compound/ne)
"wR" = (/obj/structure/jungle/vines,/turf/open/floor/plating/ground/dirtgrassborder{dir = 8},/area/lv624/ground/jungle7)
"xw" = (/turf/closed/wall,/area/lv624/ground/jungle9)
"xR" = (/turf/open/floor/plating/ground/dirtgrassborder/corner{dir = 4},/area/lv624/ground/jungle7)
"yd" = (/turf/open/floor/plating/ground/dirtgrassborder,/area/lv624/ground/jungle7)
"yh" = (/obj/structure/flora/ausbushes/fullgrass,/obj/structure/jungle/vines,/obj/structure/jungle/vines,/turf/open/ground/grass,/area/lv624/ground/jungle9)
"yi" = (/obj/item/trash/chips,/turf/open/floor/plating/ground/dirtgrassborder{dir = 1},/area/lv624/ground/jungle9)
"zZ" = (/obj/structure/jungle/vines/heavy,/turf/open/ground/grass,/area/lv624/ground/jungle7)
"Aq" = (/obj/machinery/atmospherics/pipe/simple/supply/hidden/layer1,/obj/structure/flora/ausbushes/fullgrass,/turf/open/floor/plating/ground/dirt,/area/lv624/ground/jungle9)
"Az" = (/obj/structure/flora/ausbushes/fullgrass,/turf/closed/gm/dense,/area/lv624/ground/compound/ne)
"AQ" = (/obj/structure/jungle/vines,/turf/open/floor/plating/ground/dirtgrassborder{dir = 4},/area/lv624/ground/jungle9)
"Br" = (/obj/structure/jungle/vines,/obj/structure/jungle/vines,/obj/structure/jungle/vines,/turf/open/floor/plating/ground/dirtgrassborder{dir = 4},/area/lv624/ground/jungle9)
"Bz" = (/obj/machinery/atmospherics/pipe/simple/supply/hidden/layer1,/obj/structure/jungle/vines,/obj/structure/jungle/vines,/turf/open/floor/plating/ground/dirt,/area/lv624/ground/jungle9)
"BP" = (/obj/structure/jungle/vines/heavy,/turf/open/floor/plating/ground/dirtgrassborder/corner{dir = 1},/area/lv624/ground/jungle9)
"CE" = (/turf/open/floor/plating/ground/dirtgrassborder{dir = 8},/area/lv624/ground/jungle7)
"CJ" = (/turf/open/floor/plating/ground/dirtgrassborder{dir = 1},/area/lv624/ground/jungle7)
"CR" = (/obj/structure/jungle/vines/heavy,/turf/open/ground/grass,/area/lv624/ground/jungle9)
"Dq" = (/turf/closed/gm/dense,/area/lv624/ground/jungle7)
"DI" = (/turf/open/floor/plating/ground/dirtgrassborder{dir = 4},/area/lv624/ground/jungle9)
"EC" = (/obj/structure/powerloader_wreckage,/turf/open/ground/grass,/area/lv624/ground/jungle7)
"Fb" = (/obj/item/trash/eat,/turf/open/ground/grass,/area/lv624/ground/jungle9)
"Fh" = (/obj/structure/flora/tree/jungle,/turf/open/ground/grass,/area/lv624/ground/jungle7)
"Fi" = (/obj/structure/flora/ausbushes/fullgrass,/turf/open/floor/plating/ground/dirtgrassborder{dir = 4},/area/lv624/ground/jungle9)
"Fz" = (/obj/machinery/atmospherics/pipe/simple/supply/hidden/layer1{dir = 4},/obj/structure/flora/ausbushes/fullgrass,/turf/open/floor/plating/ground/dirt,/area/lv624/ground/jungle9)
"GG" = (/obj/structure/flora/ausbushes/fullgrass,/turf/open/floor/plating/ground/dirtgrassborder/corner{dir = 4},/area/lv624/ground/jungle7)
"GW" = (/obj/structure/table,/obj/item/reagent_containers/food/snacks/monkeyburger{pixel_x = -3},/obj/item/reagent_containers/food/snacks/orangecakeslice{pixel_x = 4; pixel_y = 8},/turf/open/ground/grass,/area/lv624/ground/jungle9)
"Hs" = (/obj/structure/flora/ausbushes/fullgrass,/turf/open/floor/plating/ground/dirtgrassborder{dir = 1},/area/lv624/ground/jungle9)
"Is" = (/turf/open/floor/plating/ground/dirtgrassborder/corner2{dir = 8},/area/lv624/ground/jungle9)
"Ix" = (/turf/open/floor/plating/ground/dirt,/area/lv624/ground/jungle9)
"Jm" = (/obj/structure/jungle/vines,/obj/structure/jungle/vines,/turf/open/floor/plating/ground/dirtgrassborder{dir = 4},/area/lv624/ground/jungle9)
"Js" = (/obj/machinery/atmospherics/pipe/simple/supply/hidden/layer1,/turf/open/floor/plating/ground/dirt,/area/lv624/ground/jungle9)
"JB" = (/turf/open/floor/plating/ground/dirtgrassborder/corner2,/area/lv624/ground/jungle7)
"JU" = (/obj/machinery/atmospherics/pipe/simple/supply/hidden/layer1,/obj/structure/jungle/vines,/turf/open/floor/plating/ground/dirt,/area/lv624/ground/jungle9)
"Lr" = (/turf/open/floor/plating/ground/dirtgrassborder{dir = 1},/area/lv624/ground/jungle9)
"Lt" = (/obj/item/trash/burger,/turf/open/floor/plating/ground/dirtgrassborder{dir = 8},/area/lv624/ground/jungle9)
"Ma" = (/turf/open/floor/plating/ground/dirtgrassborder/corner2{dir = 1},/area/lv624/ground/jungle9)
"Mk" = (/turf/open/floor/plating/ground/dirt,/area/lv624/ground/compound/ne)
"MC" = (/obj/machinery/miner/damaged,/turf/open/ground/grass,/area/lv624/ground/jungle7)
"MK" = (/obj/structure/jungle/vines,/obj/structure/jungle/vines/heavy,/turf/open/ground/grass,/area/lv624/ground/jungle9)
"MX" = (/turf/open/floor/plating/ground/dirtgrassborder/corner{dir = 1},/area/lv624/ground/jungle9)
"Ne" = (/obj/structure/jungle/vines,/turf/open/floor/plating/ground/dirtgrassborder{dir = 8},/area/lv624/ground/jungle9)
"Op" = (/obj/structure/jungle/vines,/turf/open/floor/plating/ground/dirtgrassborder,/area/lv624/ground/jungle9)
"Oz" = (/obj/structure/flora/ausbushes/fullgrass,/obj/machinery/colony_floodlight{dir = 4},/turf/open/ground/grass,/area/lv624/ground/jungle9)
"PR" = (/turf/open/floor/plating/ground/dirtgrassborder{dir = 4},/area/lv624/ground/jungle7)
"QD" = (/obj/structure/flora/ausbushes/sunnybush,/turf/open/ground/grass,/area/lv624/ground/jungle9)
"QG" = (/obj/structure/flora/ausbushes/fullgrass,/turf/open/floor/plating/ground/dirtgrassborder,/area/lv624/ground/jungle9)
"QV" = (/turf/open/floor/plating/ground/dirtgrassborder/corner2{dir = 4},/area/lv624/ground/jungle9)
"RS" = (/obj/structure/jungle/vines,/turf/open/ground/grass,/area/lv624/ground/jungle9)
"Sx" = (/obj/structure/flora/ausbushes/fullgrass,/turf/open/ground/grass,/area/lv624/ground/compound/ne)
"Ta" = (/turf/open/floor/plating/ground/dirtgrassborder/corner{dir = 8},/area/lv624/ground/jungle9)
"Tr" = (/obj/structure/flora/ausbushes/fullgrass,/obj/machinery/colony_floodlight{dir = 1},/turf/open/floor/plating/ground/dirt,/area/lv624/ground/jungle9)
"UP" = (/obj/structure/jungle/vines,/turf/open/floor/plating/ground/dirtgrassborder/corner{dir = 4},/area/lv624/ground/jungle9)
"UQ" = (/turf/open/floor/plating/ground/dirtgrassborder/corner,/area/lv624/ground/jungle7)
"Va" = (/turf/open/floor/plating/ground/dirtgrassborder{dir = 8},/area/lv624/ground/jungle9)
"Vg" = (/obj/machinery/door/poddoor/mainship{density = 0; dir = 2; icon_state = "pdoor0"; id = "nexus_blast"; name = "\improper Nexus Blast Door"; opacity = 0},/obj/machinery/atmospherics/pipe/simple/supply/hidden/layer1,/obj/machinery/door/airlock/maintenance,/turf/open/floor/tile/white,/area/lv624/lazarus/main_hall)
"Vq" = (/turf/open/ground/grass,/area/lv624/ground/jungle7)
"Vy" = (/turf/closed/wall,/area/lv624/ground/compound/ne)
"VS" = (/turf/open/floor/plating/ground/dirtgrassborder/corner{dir = 4},/area/lv624/ground/jungle9)
"Wz" = (/obj/structure/jungle/vines,/turf/open/floor/plating/ground/dirtgrassborder{dir = 1},/area/lv624/ground/jungle9)
"WC" = (/obj/structure/flora/ausbushes/ppflowers,/turf/open/ground/grass,/area/lv624/ground/jungle7)
"WT" = (/obj/structure/fence,/turf/open/floor/plating/ground/dirtgrassborder,/area/lv624/ground/jungle7)
"Xf" = (/obj/structure/bed/chair/office{dir = 4},/turf/open/ground/grass,/area/lv624/ground/jungle9)
"Xh" = (/turf/closed/wall,/area/lv624/ground/jungle7)
"Xl" = (/turf/closed/gm/dense,/area/lv624/ground/jungle9)
"Xr" = (/obj/structure/flora/ausbushes/fullgrass,/obj/structure/jungle/vines/heavy,/turf/open/ground/grass,/area/lv624/ground/jungle9)
"XQ" = (/turf/open/floor/plating/ground/dirtgrassborder/corner,/area/lv624/ground/jungle9)
"XX" = (/turf/open/floor/plating/ground/dirtgrassborder/corner{dir = 8},/area/lv624/ground/jungle7)
"Zw" = (/obj/structure/flora/ausbushes/fullgrass,/turf/open/floor/plating/ground/dirtgrassborder{dir = 1},/area/lv624/ground/jungle7)
"ZF" = (/obj/structure/jungle/vines,/turf/open/floor/plating/ground/dirtgrassborder/corner{dir = 4},/area/lv624/ground/jungle7)

(1,1,1) = {"
PRndcgVqVqUQydgZVqDqDqDqDqXXjlchwRkCzZDq
XXZwGGFhVqPRaWCEkCDqDqDqDqVqPRndwRkCDqDq
VqinVqWCVqXXCJZFkCVqVqkCVqVqXXCJxRkCDqDq
WTXhlaVqVqVqVqVqVqFhUQydgZDqDqVqVqVqDqDq
IxndCEVqFhVqVqVqWCVqPRaWCEWCDqinVqVqkCkC
IxIxQVdadadaydydydydJBndCEVqVqVqVqinVqin
lylylylylylylylylyFzlyaICEMCDqDqECUQydfj
IxuAMayiLrLrLrLrLrLrIsJsCEupDqkCVqeplxCE
xwLrVSXfGWeojfjfQDjfDIAqVaRSkCWCVqXXCJxR
jfXQQGMXjfjfRSjfjfjfDIJsVaXQsZkCdIVyhhVy
eMFiTrNeRSXlXlXljftdAQJsVaTaVSjfdIwfMkMk
RSehWzUPMKXlXljfRSRSAQJUVajfXQMXjfwfMkMk
CRjfXlbHjfjfRSRSyhRSJmJsVajfTaVSjfwfMkMk
jfXlXlXlXlRSqejfjfjfBrJUVajfjfqeeMxwvTvT
XlXlXlXljfjfjfhqOzjfJmBzVayhRSRSjfdIegSx
jfXlXlMKjfjfeMkFjfjfDIJsVajfRSRSRSjfAzAz
jfXlOpBPRSjfjfjfjfjfDIJsLtjfeMRSRSRSbLbL
jfDIuAVaXrXlRSeMjfFbDIJsVaeMjfjfjfjfRSdI
CRTaHsVSXlXlehjfjfdIDIJsVaiOjfjfjfjfjfbL
XleAdasZXljfRSRSjfcVcVVgcVcVcVcVcVcVdIdI
"}
