//MAP CONVERTED BY dmm2tgm.py THIS HEADER COMMENT PREVENTS RECONVERSION, DO NOT REMOVE
"ap" = (
/turf/open/ground/coast{
	dir = 6
	},
/area/lv624/ground/caves/central2)
"co" = (
/turf/open/floor,
/area/lv624/ground/caves/central1)
"cS" = (
/atom/movable/effect/landmark/xeno_resin_door,
/turf/open/floor/plating/ground/dirt,
/area/lv624/ground/caves/central3)
"eH" = (
/atom/movable/effect/landmark/xeno_resin_door,
/atom/movable/effect/ai_node,
/turf/open/floor/plating/ground/dirt,
/area/lv624/ground/caves/central1)
"gn" = (
/turf/open/ground/coast{
	dir = 8
	},
/area/lv624/ground/caves/central2)
"gv" = (
/obj/machinery/miner/damaged/platinum,
/turf/open/floor/plating/ground/dirt,
/area/lv624/ground/caves/central2)
"hc" = (
/atom/movable/effect/landmark/xeno_resin_wall,
/turf/open/floor/plating/ground/dirt,
/area/lv624/ground/caves/central2)
"hk" = (
/turf/open/ground/coast/corner{
	dir = 1
	},
/area/lv624/ground/caves/central2)
"hY" = (
/turf/open/floor/plating/ground/dirt,
/area/lv624/ground/caves/central2)
"jw" = (
/obj/structure/rack,
/obj/item/stack/sheet/mineral/diamond{
	amount = 2
	},
/turf/open/floor/tile/vault{
	dir = 8
	},
/area/lv624/ground/caves/central1)
"jJ" = (
/obj/structure/jungle/plantbot1/alien,
/turf/open/ground/river,
/area/lv624/ground/caves/central2)
"km" = (
/obj/structure/rack,
/obj/item/stack/sheet/mineral/silver{
	amount = 20
	},
/turf/open/floor/tile/vault{
	dir = 8
	},
/area/lv624/ground/caves/central1)
"ln" = (
/atom/movable/effect/ai_node,
/turf/open/floor/tile/dark,
/area/lv624/ground/caves/central1)
"lP" = (
/turf/open/ground/coast/corner,
/area/lv624/ground/caves/central2)
"mX" = (
/turf/open/ground/coast/corner{
	dir = 8
	},
/area/lv624/ground/caves/central2)
"nP" = (
/atom/movable/effect/landmark/lv624/fog_blocker/xeno_spawn,
/turf/closed/wall/r_wall,
/area/lv624/ground/caves/rock)
"on" = (
/turf/closed/mineral/smooth/indestructible,
/area/lv624/ground/caves/rock)
"pX" = (
/atom/movable/effect/landmark/weed_node,
/turf/open/floor/plating/ground/dirt,
/area/lv624/ground/caves/central1)
"qG" = (
/turf/closed/mineral/smooth,
/area/lv624/ground/caves/central1)
"rO" = (
/obj/structure/rack,
/turf/open/floor/tile/vault{
	dir = 8
	},
/area/lv624/ground/caves/central1)
"sp" = (
/turf/open/ground/coast/corner2{
	dir = 1
	},
/area/lv624/ground/caves/central2)
"tv" = (
/obj/structure/rack,
/obj/item/stack/sheet/mineral/iron{
	amount = 5
	},
/obj/item/stack/sheet/mineral/platinum,
/obj/machinery/light{
	dir = 8
	},
/atom/movable/effect/landmark/lv624/fog_blocker/xeno_spawn,
/turf/open/floor/tile/vault{
	dir = 8
	},
/area/lv624/ground/caves/central1)
"ty" = (
/obj/structure/rack,
/obj/item/stack/sheet/mineral/gold{
	amount = 2
	},
/obj/item/stack/sheet/mineral/platinum{
	pixel_x = -6
	},
/turf/open/floor/tile/vault{
	dir = 8
	},
/area/lv624/ground/caves/central1)
"tA" = (
/turf/open/ground/coast/corner2{
	dir = 2
	},
/area/lv624/ground/caves/central2)
"uE" = (
/obj/structure/rack,
/obj/item/tool/shovel,
/atom/movable/effect/landmark/lv624/fog_blocker/xeno_spawn,
/turf/open/floor/tile/vault{
	dir = 8
	},
/area/lv624/ground/caves/central1)
"vh" = (
/turf/closed/wall/r_wall,
/area/lv624/ground/caves/central1)
"wX" = (
/atom/movable/effect/landmark/lv624/fog_blocker,
/atom/movable/effect/landmark/lv624/fog_blocker/xeno_spawn,
/turf/closed/mineral/smooth,
/area/lv624/ground/caves/rock)
"xE" = (
/atom/movable/effect/landmark/weed_node,
/turf/open/floor/plating/ground/dirt,
/area/lv624/ground/caves/central2)
"xT" = (
/turf/open/ground/coast{
	dir = 4
	},
/area/lv624/ground/caves/central2)
"yv" = (
/turf/closed/wall/r_wall,
/area/lv624/ground/caves/rock)
"yD" = (
/turf/open/floor/tile/dark,
/area/lv624/ground/caves/central1)
"ze" = (
/obj/structure/flora/ausbushes/fullgrass,
/turf/open/floor/plating/ground/dirt,
/area/lv624/ground/caves/central2)
"zH" = (
/atom/movable/effect/ai_node,
/turf/open/floor/plating/ground/dirt,
/area/lv624/ground/caves/central1)
"AC" = (
/obj/structure/flora/ausbushes/fullgrass,
/atom/movable/effect/landmark/weed_node,
/turf/open/floor/plating/ground/dirt,
/area/lv624/ground/caves/central2)
"AR" = (
/obj/structure/rack,
/obj/item/tool/pickaxe,
/turf/open/floor/tile/vault{
	dir = 8
	},
/area/lv624/ground/caves/central1)
"AW" = (
/atom/movable/effect/landmark/weed_node,
/turf/open/floor/tile/dark,
/area/lv624/ground/caves/central1)
"BW" = (
/turf/open/ground/coast/corner2{
	dir = 4
	},
/area/lv624/ground/caves/central2)
"BY" = (
/atom/movable/effect/landmark/weed_node,
/atom/movable/effect/landmark/xeno_resin_door,
/turf/open/floor/plating/ground/dirt,
/area/lv624/ground/caves/central1)
"Cb" = (
/turf/open/ground/coast{
	dir = 9
	},
/area/lv624/ground/caves/central2)
"CM" = (
/turf/open/ground/coast/corner{
	dir = 4
	},
/area/lv624/ground/caves/central2)
"Dr" = (
/atom/movable/effect/landmark/excavation_site_spawner,
/turf/open/floor/plating/ground/dirt,
/area/lv624/ground/caves/central1)
"Eg" = (
/obj/structure/rack,
/obj/item/stack/sheet/mineral/tritium{
	pixel_x = -4
	},
/turf/open/floor/tile/vault{
	dir = 8
	},
/area/lv624/ground/caves/central1)
"Eq" = (
/atom/movable/effect/landmark/weed_node,
/atom/movable/effect/landmark/xeno_resin_wall,
/turf/open/floor/plating/ground/dirt,
/area/lv624/ground/caves/central2)
"EQ" = (
/atom/movable/effect/ai_node,
/turf/open/floor/plating/ground/dirt,
/area/lv624/ground/caves/central2)
"GX" = (
/turf/closed/wall,
/area/lv624/ground/caves/central1)
"Hh" = (
/turf/closed/mineral/smooth,
/area/lv624/ground/caves/rock)
"Jo" = (
/atom/movable/effect/landmark/lv624/fog_blocker,
/turf/closed/mineral/smooth,
/area/lv624/ground/caves/rock)
"JQ" = (
/atom/movable/effect/landmark/xeno_resin_wall,
/turf/open/floor/plating/ground/dirt,
/area/lv624/ground/caves/central1)
"JV" = (
/turf/open/floor/plating/ground/dirt,
/area/lv624/ground/caves/central1)
"Lg" = (
/turf/open/ground/coast,
/area/lv624/ground/caves/central2)
"MB" = (
/obj/structure/rack,
/atom/movable/effect/landmark/lv624/fog_blocker/xeno_spawn,
/turf/open/floor/tile/vault{
	dir = 8
	},
/area/lv624/ground/caves/central1)
"Nw" = (
/turf/open/floor/plating/ground/dirt,
/area/lv624/ground/caves/central3)
"Nz" = (
/atom/movable/effect/landmark/excavation_site_spawner,
/turf/open/floor/plating/ground/dirt,
/area/lv624/ground/caves/central2)
"Ok" = (
/turf/open/ground/river,
/area/lv624/ground/caves/central2)
"Rz" = (
/turf/open/ground/coast{
	dir = 5
	},
/area/lv624/ground/caves/central2)
"RN" = (
/atom/movable/effect/landmark/weed_node,
/atom/movable/effect/ai_node,
/turf/open/floor/plating/ground/dirt,
/area/lv624/ground/caves/central2)
"Uf" = (
/obj/structure/rack,
/obj/item/stack/sheet/metal{
	amount = 50;
	pixel_x = 4;
	pixel_y = 4
	},
/obj/item/stack/sheet/metal{
	amount = 30
	},
/turf/open/floor/tile/vault{
	dir = 8
	},
/area/lv624/ground/caves/central1)
"Ux" = (
/turf/open/ground/coast{
	dir = 1
	},
/area/lv624/ground/caves/central2)
"WN" = (
/atom/movable/effect/landmark/xeno_resin_door,
/turf/open/floor/plating/ground/dirt,
/area/lv624/ground/caves/central1)
"Xi" = (
/obj/machinery/door/airlock/mainship/secure/locked/free_access{
	dir = 4;
	name = "\improper Mining Storage"
	},
/turf/open/floor/tile/dark,
/area/lv624/ground/caves/central1)
"XM" = (
/obj/structure/flora/ausbushes/reedbush,
/turf/open/ground/river,
/area/lv624/ground/caves/central2)
"XP" = (
/obj/structure/rack,
/obj/item/tool/shovel,
/turf/open/floor/tile/vault{
	dir = 8
	},
/area/lv624/ground/caves/central1)
"Yu" = (
/obj/structure/flora/ausbushes/fernybush,
/turf/open/ground/river,
/area/lv624/ground/caves/central2)

(1,1,1) = {"
Hh
Hh
Hh
Hh
Hh
Hh
Hh
Hh
Hh
Hh
cS
cS
cS
cS
cS
Hh
Hh
Hh
Hh
Hh
Hh
Hh
Hh
Hh
Hh
Hh
Hh
Nw
Nw
Nw
Nw
Nw
Nw
"}
(2,1,1) = {"
Hh
Hh
Hh
Hh
Hh
Hh
Hh
Hh
Hh
Hh
hY
hY
hY
hY
hY
Hh
Hh
Hh
Hh
Hh
Hh
Hh
Hh
Hh
Hh
Hh
Hh
Hh
Hh
Hh
Hh
Hh
Nw
"}
(3,1,1) = {"
Hh
Hh
Hh
Hh
Hh
Hh
Hh
Hh
Hh
Hh
hY
hY
xE
hY
hY
hY
xE
hY
hY
Hh
Hh
Hh
Hh
Hh
Hh
Hh
on
on
on
on
on
Hh
Hh
"}
(4,1,1) = {"
Hh
Hh
Hh
Hh
Hh
Hh
Hh
hc
hc
hc
hY
hY
hY
hY
hY
hY
hY
hY
hY
hY
hY
hY
Hh
Hh
Hh
Hh
on
on
on
on
on
Hh
Hh
"}
(5,1,1) = {"
Hh
Hh
Hh
Hh
Hh
Hh
Hh
hc
hc
hY
hY
EQ
hY
hY
hY
hY
hY
hY
EQ
hY
hY
EQ
hY
Hh
Hh
Hh
on
on
on
on
on
Hh
Hh
"}
(6,1,1) = {"
Hh
Hh
Hh
Hh
Hh
Hh
hY
xE
hY
hY
hY
hY
xE
hY
hY
hY
hY
xE
hY
hY
hY
xE
hY
hc
Hh
Hh
Hh
Hh
Hh
Hh
Hh
Hh
Hh
"}
(7,1,1) = {"
Hh
Hh
Hh
Hh
Hh
Hh
hY
hY
hY
hY
hY
hY
hY
hY
hY
hY
hY
hY
hY
hY
hc
hY
hY
hc
Hh
Hh
Hh
Hh
Hh
Hh
Hh
Hh
Hh
"}
(8,1,1) = {"
Hh
Hh
Hh
Hh
Hh
hY
hc
hc
hY
hY
hY
hY
hc
hY
xE
hY
hc
hc
hY
hY
hY
hY
hY
hc
hc
Hh
on
on
on
on
on
Hh
Hh
"}
(9,1,1) = {"
Hh
Hh
Hh
Hh
Hh
hY
hc
hc
hY
xE
hY
hY
hY
hY
hY
hY
hc
hc
hY
xE
hY
xE
hY
hc
hc
Hh
on
on
on
on
on
Hh
Hh
"}
(10,1,1) = {"
Hh
Hh
Hh
Hh
Hh
hY
hY
hY
hY
Nz
hY
hY
hY
hY
hY
xE
hY
hY
hY
hY
hY
hY
hY
hc
Hh
Hh
on
on
on
on
on
Hh
Hh
"}
(11,1,1) = {"
Hh
Hh
Hh
Hh
Hh
hY
hY
hY
hY
hY
hY
xE
hY
hY
hY
hY
hY
hY
hY
hY
hY
hY
hY
hc
Hh
Hh
Hh
Hh
Hh
Hh
Hh
Hh
Hh
"}
(12,1,1) = {"
Hh
Hh
Hh
Hh
Hh
EQ
hY
hY
hY
hY
hY
EQ
hY
ze
hY
hY
hY
hY
EQ
hY
hY
EQ
hY
hc
Hh
Hh
Hh
Hh
Hh
Hh
Hh
Hh
Hh
"}
(13,1,1) = {"
Hh
Hh
Hh
Hh
Hh
hY
hY
hc
hc
AC
hY
hY
hY
xE
hY
hY
hY
xE
hY
hc
xE
hY
hc
hc
Hh
Hh
on
on
on
on
on
Hh
Hh
"}
(14,1,1) = {"
Hh
Hh
Hh
Hh
hY
hY
hc
hc
hc
hY
lP
xT
xT
xT
xT
xT
mX
hY
hY
hY
hY
hY
hc
Hh
Hh
Hh
on
on
on
on
on
Hh
Hh
"}
(15,1,1) = {"
Hh
Hh
Hh
hY
hY
hY
hc
hc
hY
hY
Lg
Ok
Ok
Ok
Ok
Ok
Rz
xT
mX
ze
hY
hY
hc
Hh
Hh
Hh
on
on
on
on
on
Hh
Hh
"}
(16,1,1) = {"
Hh
Hh
Hh
hY
hY
xE
hY
ze
hY
hY
Lg
Ok
Ok
Ok
Ok
Ok
Ok
Ok
Ux
hY
hY
hY
hc
hc
Hh
Hh
Hh
Hh
Hh
Hh
Hh
Hh
Hh
"}
(17,1,1) = {"
Hh
Hh
Hh
hY
hY
hY
hY
hY
hY
xE
Lg
Ok
Ok
Ok
Ok
Ok
Ok
Ok
Ux
hY
xE
hY
hY
hc
hc
Hh
Hh
Hh
Hh
Hh
Hh
Hh
Hh
"}
(18,1,1) = {"
Hh
Hh
Hh
hY
hY
hY
xE
hY
lP
xT
ap
Ok
Ok
Ok
Ok
jJ
Ok
Ok
Ux
hY
hY
hY
hY
hY
hc
hc
hc
hc
Hh
Hh
on
on
on
"}
(19,1,1) = {"
Hh
Hh
Hh
hY
hY
hY
hY
hY
Lg
Ok
Ok
Ok
Ok
Ok
Ok
Ok
Ok
Ok
Ux
hY
hc
EQ
hY
hY
hY
hY
hY
hc
hc
Hh
on
on
on
"}
(20,1,1) = {"
Hh
Hh
hY
hY
hc
hY
hY
hY
Lg
Ok
Ok
Ok
Yu
Ok
Ok
Ok
Ok
Ok
BW
mX
hY
hY
EQ
hY
hc
hY
hY
hY
hc
Hh
on
on
on
"}
(21,1,1) = {"
Hh
hc
hY
hY
hY
EQ
hY
hY
Lg
Ok
Ok
Ok
Ok
Ok
Ok
Ok
Ok
Ok
Ok
Ux
xE
hY
hY
EQ
hY
hY
EQ
xE
hc
Hh
Hh
Hh
Hh
"}
(22,1,1) = {"
Hh
hc
hY
AC
hY
hY
xE
hY
Lg
Ok
Ok
Ok
Ok
Ok
Ok
Ok
XM
Ok
Ok
Ux
hY
hY
hc
hY
hY
hY
hY
hY
hc
Hh
Hh
Hh
Hh
"}
(23,1,1) = {"
Hh
hc
hY
hY
hY
hY
hY
hc
Lg
Ok
jJ
Ok
Ok
Ok
Ok
Ok
Ok
Ok
Ok
Ux
hY
ze
hY
hY
xE
hY
hY
hY
hc
hc
Hh
Hh
Hh
"}
(24,1,1) = {"
Hh
hc
hY
hY
hY
hY
hY
hY
Lg
Ok
Ok
Ok
Ok
Ok
Ok
Ok
Ok
Ok
Ok
Ux
hY
hY
hY
hY
hY
hY
hY
hY
hY
hc
Hh
Hh
Hh
"}
(25,1,1) = {"
Hh
hc
hY
hY
hY
hY
hY
hY
Lg
Ok
Ok
Ok
Yu
Ok
Ok
Ok
Ok
Ok
Ok
Ux
xE
hY
hY
hY
hY
hY
hY
hY
hY
hc
hc
Hh
Hh
"}
(26,1,1) = {"
Hh
hc
xE
hY
gv
hY
Eq
hY
Lg
Ok
Ok
Ok
Ok
Ok
Ok
Ok
Ok
Ok
Ok
Ux
hY
hY
hY
hY
hY
hY
hY
hY
hY
hc
hc
Hh
Hh
"}
(27,1,1) = {"
Hh
hc
hY
hY
hY
hY
ze
hY
Lg
Ok
Ok
Ok
Ok
Ok
Ok
Ok
jJ
Ok
Ok
Ux
hY
hY
hY
hY
hY
xE
EQ
hY
hY
hc
Hh
Hh
Hh
"}
(28,1,1) = {"
Hh
hc
hY
hc
hY
hY
hY
hY
Lg
Ok
XM
Ok
Ok
Ok
Ok
Ok
Ok
Ok
Ok
Ux
xE
hY
hY
hY
hY
hY
hY
hY
hc
hc
Hh
Hh
Hh
"}
(29,1,1) = {"
Hh
hc
hY
hY
hY
hY
hY
hY
Lg
Ok
Ok
Ok
Ok
Ok
Ok
Ok
Ok
Ok
Ok
BW
mX
hY
hY
hY
hc
hc
hY
hY
hc
Hh
Hh
Hh
Hh
"}
(30,1,1) = {"
Hh
hc
xE
ze
hc
hY
xE
hY
Lg
Ok
Ok
Ok
Ok
Ok
XM
Ok
Ok
Ok
Ok
Ok
Ux
hY
xE
hc
hc
hY
xE
hY
hc
Hh
Hh
Hh
Hh
"}
(31,1,1) = {"
Hh
hc
hY
hY
hc
EQ
hY
hY
Lg
Ok
Ok
Ok
Ok
Ok
Ok
Ok
Ok
Ok
Ok
Ok
Ux
hY
hY
hY
hY
hY
hY
hY
hc
Hh
Hh
Hh
Hh
"}
(32,1,1) = {"
Hh
hc
hY
hY
hY
hY
EQ
hY
Lg
Ok
Ok
Ok
Ok
Ok
Ok
Ok
Ok
Ok
Ok
Ok
Ux
hY
hY
hY
hY
hY
hY
hc
hc
Hh
Hh
Hh
Hh
"}
(33,1,1) = {"
Hh
hc
hY
hY
hY
ze
hY
hY
Lg
Ok
Ok
Ok
Ok
Ok
Ok
Ok
Ok
Ok
Yu
Ok
Ux
hY
xE
hY
EQ
hY
EQ
hc
Hh
Hh
Hh
Hh
Hh
"}
(34,1,1) = {"
Hh
hc
xE
hY
hc
hY
xE
hY
Lg
Ok
Ok
Ok
Ok
Ok
Ok
Ok
Ok
Ok
Ok
Ok
BW
mX
hY
hY
hY
hc
hc
hc
Hh
on
on
Hh
Hh
"}
(35,1,1) = {"
Hh
hc
hY
hY
hY
hY
hY
hY
Lg
Ok
Ok
Ok
Ok
Ok
Ok
XM
Ok
jJ
Ok
Ok
Ok
Rz
mX
hY
xE
hc
hc
hc
Hh
on
on
Hh
Hh
"}
(36,1,1) = {"
Hh
hc
xE
hY
hY
hY
hY
hc
Lg
Ok
Ok
jJ
Ok
Ok
Ok
Ok
Ok
Ok
Ok
Ok
Ok
Ok
Rz
mX
hY
hY
hY
hc
Hh
on
on
Hh
Hh
"}
(37,1,1) = {"
Hh
hc
hY
hY
hY
hY
hY
hY
hk
sp
Ok
Ok
Ok
Ok
Ok
Ok
Ok
Ok
Ok
Ok
Ok
Ok
Ok
Ux
hY
hY
hY
hc
Hh
on
on
Hh
Hh
"}
(38,1,1) = {"
Hh
hc
hY
hc
hc
hY
xE
hY
ze
Lg
Ok
Ok
Ok
Ok
Ok
Ok
Ok
Ok
Ok
Ok
Ok
Ok
Ok
Ux
RN
hY
hY
hc
Hh
on
on
Hh
on
"}
(39,1,1) = {"
Hh
hc
xE
hc
hc
hY
hY
hY
hY
Lg
Ok
Ok
Ok
Ok
Ok
jJ
Ok
Ok
Ok
Ok
Ok
Ok
Ok
Ux
hY
EQ
hY
hc
Hh
on
on
Hh
on
"}
(40,1,1) = {"
Hh
hc
hY
hY
hY
hY
hY
hY
hY
Lg
Ok
Ok
Ok
Ok
Ok
Ok
Ok
Ok
Ok
Ok
Ok
Ok
Ok
BW
mX
hY
hY
hc
Hh
Hh
Hh
Hh
on
"}
(41,1,1) = {"
Hh
hc
hc
hY
hY
hY
hY
hY
hY
Lg
Ok
Ok
Ok
Ok
Ok
Ok
Ok
Ok
Ok
Ok
Ok
Ok
Ok
Ok
Ux
xE
hY
hc
hc
Hh
Hh
Hh
Hh
"}
(42,1,1) = {"
Hh
Hh
hc
hc
hY
hY
RN
hY
hY
Lg
Ok
Ok
Ok
Ok
Ok
Ok
Ok
Ok
Ok
Ok
Ok
XM
Ok
Ok
Ux
hY
hY
ze
hc
Hh
Hh
Hh
Hh
"}
(43,1,1) = {"
Hh
Hh
Hh
hc
hY
hY
ze
hY
hY
Lg
XM
Ok
Ok
Ok
Ok
Ok
Ok
Ok
Ok
jJ
Ok
Ok
Ok
Ok
Ux
hY
ze
hY
hc
hc
Hh
hc
hc
"}
(44,1,1) = {"
Hh
Hh
Hh
hc
hY
hY
hY
hY
lP
tA
Ok
Ok
Ok
Ok
Ok
Ok
Ok
Ok
Ok
Ok
Ok
Ok
Ok
Ok
Ux
hY
hY
hY
hY
hc
hc
hc
hY
"}
(45,1,1) = {"
Hh
Hh
Hh
hc
hc
hc
hY
hY
Lg
Ok
Ok
Ok
Ok
Ok
Yu
Ok
Ok
Ok
Ok
Ok
Ok
Ok
Ok
Ok
Ux
xE
hY
hY
hY
xE
hY
hY
hY
"}
(46,1,1) = {"
Hh
Hh
Hh
Hh
hc
hc
xE
hY
Lg
Ok
Ok
Ok
Ok
Ok
Ok
Ok
Ok
Ok
Ok
Ok
Ok
Ok
Ok
Ok
Ux
hY
hY
hY
hY
Nz
hY
hY
hY
"}
(47,1,1) = {"
Hh
Hh
Hh
Hh
hc
hY
hY
hY
Lg
Ok
Ok
Ok
Ok
jJ
Ok
Ok
Ok
Ok
Ok
jJ
Ok
Ok
Ok
Ok
Ux
hY
hY
hY
hY
hY
hY
hY
hY
"}
(48,1,1) = {"
Hh
Hh
Hh
Hh
hc
hY
hY
hY
Lg
Ok
Ok
Ok
Ok
Ok
Ok
XM
Ok
Ok
Ok
Ok
Ok
Ok
Ok
Cb
CM
EQ
hY
hY
hY
hY
hY
hY
hY
"}
(49,1,1) = {"
Hh
Hh
Hh
Hh
hc
hY
hY
hY
Lg
Ok
Ok
Ok
Ok
Ok
Ok
Ok
Ok
Ok
Ok
Ok
Ok
Ok
Ok
Ux
hY
xE
EQ
hY
xE
hY
hY
hY
EQ
"}
(50,1,1) = {"
Hh
Hh
Hh
Hh
Hh
hY
xE
hY
Lg
Ok
Ok
Ok
Ok
Ok
Ok
Ok
Ok
Ok
Ok
Ok
Cb
gn
gn
CM
hY
gv
hY
hY
hc
hc
hY
RN
hY
"}
(51,1,1) = {"
Hh
Hh
Hh
Hh
Hh
hY
EQ
hY
Lg
Ok
Ok
jJ
Ok
Ok
Ok
Ok
Ok
Cb
gn
gn
CM
hY
hY
hY
xE
hY
hY
hY
hc
hc
hY
hY
hY
"}
(52,1,1) = {"
Hh
Hh
Hh
Hh
Hh
EQ
hY
hY
hk
gn
sp
Ok
Ok
Ok
Ok
Ok
Ok
Ux
hY
hY
hY
xE
hY
ze
hY
hY
hY
hY
hY
hY
hY
hY
Hh
"}
(53,1,1) = {"
Hh
Hh
Hh
Hh
Hh
hY
hY
gv
hY
hY
Lg
Ok
Ok
Ok
Cb
gn
gn
CM
hY
ze
hY
hY
hY
hY
hc
hc
hY
xE
hY
hY
hY
hY
Hh
"}
(54,1,1) = {"
Hh
Hh
Hh
Hh
Hh
hY
xE
hY
hY
hY
Lg
Ok
Ok
Ok
Ux
hY
hY
hY
hY
hY
hY
hY
hY
hY
hc
hc
hY
hY
hY
hY
xE
hY
Hh
"}
(55,1,1) = {"
Hh
Hh
Hh
Hh
Hh
hY
hY
hY
hY
xE
hk
gn
gn
gn
CM
hY
xE
hY
hY
hY
xE
hY
hY
xE
hY
hY
hY
hY
hY
hY
hY
hY
Hh
"}
(56,1,1) = {"
Hh
Hh
Hh
Hh
Hh
hY
hY
hY
hc
hc
hY
hY
xE
hY
hY
hY
hY
hY
hc
hc
hY
hY
hY
hY
hY
hY
EQ
hY
hY
hY
hY
EQ
Hh
"}
(57,1,1) = {"
Hh
Hh
Hh
Hh
Hh
hY
hY
hY
hc
hc
hY
EQ
hY
hY
hY
hY
EQ
hY
hc
hc
hY
hY
hY
hY
hY
EQ
hY
hc
hY
hY
hY
hY
Hh
"}
(58,1,1) = {"
Hh
Hh
Hh
Hh
Hh
EQ
hY
xE
hY
hY
EQ
hY
hY
hY
hY
hY
hY
hY
hY
hY
hY
hY
hY
hY
hY
hY
hY
hY
hY
hc
hc
Hh
Hh
"}
(59,1,1) = {"
Hh
Hh
Hh
Hh
Hh
Hh
hY
hY
hY
xE
hY
hY
hY
hc
hc
hY
hY
hY
hY
hY
hY
hY
hc
hc
hc
hY
hY
hY
hc
hc
Hh
Hh
Hh
"}
(60,1,1) = {"
Hh
Hh
Hh
Hh
Hh
Hh
hY
hY
hY
hY
hY
hY
hY
hc
hc
hY
hY
hY
hY
hY
hY
xE
hc
hc
hc
hY
hY
Eq
hc
Hh
Hh
Hh
Hh
"}
(61,1,1) = {"
Hh
Hh
Hh
Hh
Hh
Hh
hY
hY
hY
hY
hY
hY
hY
xE
hY
hY
hY
xE
hc
hc
hY
hY
hY
hY
hY
hY
hc
hc
Hh
Hh
Hh
Hh
Hh
"}
(62,1,1) = {"
Hh
Hh
Hh
Hh
Hh
Hh
Hh
hY
hY
hY
Nz
hY
hY
hY
hY
hY
hY
hY
hc
hc
hY
hY
hY
hY
hY
hY
hc
Hh
Hh
Hh
Hh
Hh
Hh
"}
(63,1,1) = {"
Hh
Hh
Hh
Hh
Hh
Hh
Hh
hY
hY
hY
hc
hY
hY
hY
hY
hY
hY
hY
hY
hY
hY
hY
hY
hY
hY
hY
Hh
Hh
Hh
Hh
Hh
Hh
Hh
"}
(64,1,1) = {"
Hh
Hh
Hh
Hh
Hh
Hh
Hh
Hh
hY
hY
xE
hY
hY
EQ
hY
hY
EQ
hY
hY
hY
hY
EQ
hY
hY
hY
EQ
Hh
Hh
Hh
Hh
Hh
Hh
Hh
"}
(65,1,1) = {"
Hh
Hh
Hh
Hh
Hh
Hh
Hh
Hh
hY
hY
hY
hY
hY
hY
hY
hY
Hh
Hh
hY
hY
xE
hY
hY
hY
xE
hY
Hh
Hh
Hh
Hh
Hh
Hh
Hh
"}
(66,1,1) = {"
Hh
Hh
Hh
Hh
Hh
Hh
Hh
Hh
Hh
hY
hY
hY
hY
xE
hY
Hh
Hh
Hh
Hh
hY
hY
hY
hY
hY
hY
hY
Hh
Hh
on
on
on
on
Hh
"}
(67,1,1) = {"
Hh
Hh
Hh
Hh
Hh
Hh
Hh
Hh
Hh
hY
hY
hY
hY
hY
hY
Hh
Hh
Hh
Hh
hc
hc
hY
hY
hY
hY
hY
Hh
Hh
on
on
on
on
Hh
"}
(68,1,1) = {"
Hh
Hh
Hh
Hh
Hh
Hh
Hh
Hh
Hh
hY
hY
xE
hY
hY
Hh
Hh
Hh
Hh
Hh
Hh
hc
hY
hY
hY
hY
hY
Hh
Hh
on
on
on
on
Hh
"}
(69,1,1) = {"
Hh
Hh
Hh
Hh
Hh
Hh
Hh
Hh
Hh
Hh
hY
hY
hY
hY
Hh
Hh
Hh
Hh
Hh
Hh
hc
hY
hY
xE
hY
hY
Hh
Hh
Hh
Hh
Hh
Hh
Hh
"}
(70,1,1) = {"
Hh
Hh
Hh
Hh
Hh
Hh
Hh
Hh
Hh
Hh
hY
hY
hY
hY
Hh
Hh
Hh
Hh
Hh
Hh
Hh
hY
hY
hY
hY
hY
Hh
Hh
on
on
on
on
Hh
"}
(71,1,1) = {"
on
on
on
on
Hh
on
on
on
on
Hh
hY
hY
hY
hY
hY
Hh
Hh
Hh
Hh
Hh
Hh
hY
hY
hY
hY
hY
Hh
Hh
on
on
on
on
Hh
"}
(72,1,1) = {"
on
on
on
on
Hh
on
on
on
on
Hh
WN
BY
WN
WN
WN
Hh
Hh
Hh
Hh
Hh
Hh
eH
WN
BY
WN
WN
Hh
Hh
on
on
on
on
Hh
"}
(73,1,1) = {"
on
on
on
on
Hh
on
on
on
on
Hh
JV
JV
JV
zH
JV
Hh
Hh
Hh
Hh
Hh
zH
JV
JV
JV
JV
zH
Hh
Hh
Hh
Hh
Hh
Hh
Hh
"}
(74,1,1) = {"
on
on
on
on
Hh
on
on
on
on
Hh
JQ
JV
Dr
JV
JQ
Hh
Hh
Hh
Hh
Hh
JV
JV
JV
Hh
Hh
Hh
Hh
wX
nP
uE
tv
MB
nP
"}
(75,1,1) = {"
Hh
Hh
Hh
Hh
Hh
Hh
Hh
Hh
Hh
Hh
JQ
JV
pX
JV
JQ
Hh
Hh
Hh
Hh
JV
JV
JV
JV
JV
Hh
Hh
Hh
Jo
yv
ty
yD
Eg
yv
"}
(76,1,1) = {"
on
on
on
on
Hh
on
on
on
on
Hh
JQ
JV
JV
JV
JQ
JQ
Hh
Hh
JV
JV
JV
pX
JV
JV
Hh
Hh
Hh
Jo
yv
jw
ln
km
vh
"}
(77,1,1) = {"
on
on
on
on
Hh
on
on
on
on
Hh
JQ
JQ
JV
JV
JV
JQ
Hh
JV
JV
JV
JV
JV
JV
Hh
Hh
Hh
Hh
Jo
yv
Uf
AW
rO
vh
"}
(78,1,1) = {"
on
on
on
on
Hh
on
on
on
on
Hh
Hh
JQ
JQ
JV
JV
JV
JV
JV
JV
pX
JV
JV
Hh
Hh
Hh
Hh
Hh
Jo
yv
XP
yD
AR
vh
"}
(79,1,1) = {"
Hh
Hh
Hh
Hh
Hh
Hh
Hh
Hh
Hh
Hh
Hh
Hh
JQ
zH
JV
JV
pX
JV
JV
JV
JV
JV
Hh
Hh
Hh
Hh
Hh
Jo
yv
GX
Xi
GX
vh
"}
(80,1,1) = {"
on
on
on
on
Hh
on
on
on
on
Hh
Hh
Hh
Hh
JV
zH
JV
JV
JV
JV
JV
JV
JV
WN
JV
Hh
Hh
Hh
Jo
qG
co
co
co
co
"}
