//MAP CONVERTED BY dmm2tgm.py THIS HEADER COMMENT PREVENTS RECONVERSION, DO NOT REMOVE
"a" = (
/obj/structure/catwalk,
/turf/open/liquid/water/river,
/area/lv624/ground/river2)
"c" = (
/obj/structure/grille/broken,
/turf/open/floor/plating,
/area/lv624/ground/river2)
"d" = (
/obj/machinery/atmospherics/pipe/simple/supply/hidden/layer1,
/obj/structure/cable,
/turf/open/floor,
/area/lv624/ground/river2)
"e" = (
/turf/open/floor/plating,
/area/lv624/ground/river2)
"g" = (
/obj/effect/turf_decal/warning_stripes/thin{
	dir = 8
	},
/obj/effect/landmark/weed_node,
/turf/open/floor,
/area/lv624/ground/river2)
"k" = (
/obj/effect/turf_decal/warning_stripes/thin{
	dir = 4
	},
/obj/effect/landmark/corpsespawner/colonist,
/turf/open/floor,
/area/lv624/ground/river2)
"n" = (
/obj/effect/turf_decal/warning_stripes/thin{
	dir = 4
	},
/turf/open/floor,
/area/lv624/ground/river2)
"p" = (
/obj/effect/landmark/corpsespawner/colonist,
/obj/effect/decal/cleanable/blood/gibs,
/turf/open/floor/plating,
/area/lv624/ground/river2)
"q" = (
/obj/structure/disposalpipe/segment{
	dir = 4
	},
/obj/machinery/atmospherics/pipe/simple/supply/hidden/layer1,
/obj/structure/cable,
/turf/open/floor,
/area/lv624/ground/river2)
"r" = (
/obj/effect/decal/cleanable/blood/gibs/xeno,
/turf/open/floor,
/area/lv624/ground/river2)
"t" = (
/obj/structure/fence,
/obj/structure/disposalpipe/segment{
	dir = 4
	},
/turf/open/floor/plating,
/area/lv624/ground/river2)
"u" = (
/obj/machinery/atmospherics/pipe/simple/supply/hidden/layer1,
/obj/effect/ai_node,
/obj/effect/decal/cleanable/blood/gibs,
/obj/structure/cable,
/turf/open/floor,
/area/lv624/ground/river2)
"w" = (
/obj/structure/grille/smoothing,
/turf/open/floor/plating,
/area/lv624/ground/river2)
"y" = (
/obj/effect/spawner/random/weaponry/ammo/sidearm,
/turf/open/floor,
/area/lv624/ground/river2)
"A" = (
/obj/effect/turf_decal/warning_stripes/thin{
	dir = 8
	},
/turf/open/floor,
/area/lv624/ground/river2)
"C" = (
/obj/effect/turf_decal/warning_stripes/thin{
	dir = 8
	},
/obj/structure/disposalpipe/segment{
	dir = 4
	},
/obj/effect/decal/cleanable/blood/gibs/xeno,
/turf/open/floor,
/area/lv624/ground/river2)
"D" = (
/obj/structure/fence,
/turf/open/floor/plating,
/area/lv624/ground/river2)
"F" = (
/obj/machinery/atmospherics/pipe/simple/supply/hidden/layer1,
/obj/effect/landmark/corpsespawner/colonist,
/obj/structure/cable,
/turf/open/floor,
/area/lv624/ground/river2)
"H" = (
/obj/structure/disposalpipe/segment{
	dir = 4
	},
/turf/open/floor,
/area/lv624/ground/river2)
"J" = (
/turf/open/floor/plating/dmg1,
/area/lv624/ground/river2)
"K" = (
/obj/effect/landmark/weed_node,
/turf/open/floor,
/area/lv624/ground/river2)
"M" = (
/obj/structure/flora/ausbushes/reedbush,
/obj/structure/catwalk,
/turf/open/liquid/water/river,
/area/lv624/ground/river2)
"N" = (
/obj/effect/turf_decal/warning_stripes/thin{
	dir = 4
	},
/obj/effect/decal/cleanable/blood/gibs,
/turf/open/floor,
/area/lv624/ground/river2)
"P" = (
/turf/open/liquid/water/river/deep,
/area/lv624/ground/river2)
"R" = (
/turf/open/floor,
/area/lv624/ground/river2)
"T" = (
/turf/open/floor/plating/dmg3,
/area/lv624/ground/river2)
"V" = (
/obj/structure/grille/broken,
/turf/open/liquid/water/river/deep,
/area/lv624/ground/river2)
"W" = (
/turf/closed/wall,
/area/lv624/ground/river2)
"X" = (
/obj/machinery/floodlight/colony{
	dir = 1
	},
/obj/structure/disposalpipe/segment{
	dir = 4
	},
/obj/structure/catwalk,
/turf/open/liquid/water/river,
/area/lv624/ground/river2)
"Y" = (
/obj/structure/catwalk,
/turf/open/liquid/water/river/deep,
/area/lv624/ground/river2)
"Z" = (
/obj/effect/turf_decal/warning_stripes/thin{
	dir = 4
	},
/obj/structure/disposalpipe/segment{
	dir = 4
	},
/turf/open/floor,
/area/lv624/ground/river2)

(1,1,1) = {"
X
a
a
Y
Y
Y
Y
a
a
a
"}
(2,1,1) = {"
D
W
W
c
e
p
c
w
W
W
"}
(3,1,1) = {"
C
A
A
A
A
A
A
A
g
A
"}
(4,1,1) = {"
q
d
d
d
u
d
d
d
F
d
"}
(5,1,1) = {"
H
K
R
R
R
y
r
R
R
R
"}
(6,1,1) = {"
Z
k
N
n
J
J
n
n
n
n
"}
(7,1,1) = {"
t
W
W
T
V
e
e
w
W
W
"}
(8,1,1) = {"
X
a
a
P
P
V
Y
a
M
a
"}
