//MAP CONVERTED BY dmm2tgm.py THIS HEADER COMMENT PREVENTS RECONVERSION, DO NOT REMOVE
"a" = (
/obj/effect/decal/warning_stripes/thin{
	dir = 4
	},
/obj/effect/decal/cleanable/blood/gibs,
/turf/open/floor,
/area/space)
"b" = (
/obj/machinery/floodlight/colony{
	dir = 1
	},
/obj/structure/disposalpipe/segment{
	dir = 4
	},
/obj/structure/catwalk,
/turf/open/ground/river,
/area/space)
"d" = (
/turf/open/floor/plating,
/area/space)
"e" = (
/obj/effect/decal/warning_stripes/thin{
	dir = 4
	},
/turf/open/floor,
/area/space)
"g" = (
/obj/structure/catwalk,
/turf/open/ground/river,
/area/space)
"l" = (
/obj/structure/grille,
/turf/open/floor/plating,
/area/space)
"n" = (
/turf/open/floor,
/area/space)
"o" = (
/obj/structure/grille/broken,
/turf/open/ground/river,
/area/space)
"q" = (
/obj/effect/decal/warning_stripes/thin{
	dir = 8
	},
/obj/structure/disposalpipe/segment{
	dir = 4
	},
/obj/effect/decal/cleanable/blood/gibs/xeno,
/turf/open/floor,
/area/space)
"r" = (
/obj/structure/catwalk,
/turf/open/ground/coast{
	dir = 5
	},
/area/space)
"t" = (
/obj/effect/decal/cleanable/blood/gibs/xeno,
/turf/open/floor,
/area/space)
"u" = (
/obj/structure/catwalk,
/turf/open/ground/coast{
	dir = 1
	},
/area/space)
"v" = (
/obj/effect/decal/warning_stripes/thin{
	dir = 4
	},
/obj/effect/landmark/corpsespawner/colonist,
/turf/open/floor,
/area/space)
"x" = (
/turf/open/floor/plating/dmg1,
/area/space)
"y" = (
/obj/structure/flora/ausbushes/reedbush,
/obj/structure/catwalk,
/turf/open/ground/river,
/area/space)
"z" = (
/obj/machinery/atmospherics/pipe/simple/supply/hidden/layer1,
/obj/effect/landmark/corpsespawner/colonist,
/turf/open/floor,
/area/space)
"A" = (
/obj/effect/decal/warning_stripes/thin{
	dir = 4
	},
/obj/structure/disposalpipe/segment{
	dir = 4
	},
/turf/open/floor,
/area/space)
"B" = (
/obj/structure/fence,
/turf/open/floor/plating,
/area/space)
"D" = (
/obj/structure/disposalpipe/segment{
	dir = 4
	},
/obj/machinery/atmospherics/pipe/simple/supply/hidden/layer1,
/turf/open/floor,
/area/space)
"G" = (
/obj/structure/disposalpipe/segment{
	dir = 4
	},
/turf/open/floor,
/area/space)
"H" = (
/obj/machinery/atmospherics/pipe/simple/supply/hidden/layer1,
/obj/effect/ai_node,
/obj/effect/decal/cleanable/blood/gibs,
/turf/open/floor,
/area/space)
"J" = (
/obj/structure/grille/broken,
/turf/open/floor/plating,
/area/space)
"M" = (
/turf/closed/wall,
/area/space)
"N" = (
/obj/structure/fence,
/obj/structure/disposalpipe/segment{
	dir = 4
	},
/turf/open/floor/plating,
/area/space)
"O" = (
/turf/open/floor/plating/dmg3,
/area/space)
"P" = (
/obj/effect/landmark/weed_node,
/turf/open/floor,
/area/space)
"Q" = (
/obj/effect/decal/warning_stripes/thin{
	dir = 8
	},
/turf/open/floor,
/area/space)
"R" = (
/obj/machinery/atmospherics/pipe/simple/supply/hidden/layer1,
/turf/open/floor,
/area/space)
"U" = (
/obj/structure/catwalk,
/turf/open/ground/coast/corner{
	dir = 8
	},
/area/space)
"V" = (
/obj/effect/landmark/corpsespawner/colonist,
/obj/effect/decal/cleanable/blood/gibs,
/turf/open/floor/plating,
/area/space)
"W" = (
/turf/open/ground/river,
/area/space)
"Z" = (
/obj/effect/decal/warning_stripes/thin{
	dir = 8
	},
/obj/effect/landmark/weed_node,
/turf/open/floor,
/area/space)

(1,1,1) = {"
b
g
g
g
g
g
g
g
r
U
"}
(2,1,1) = {"
B
M
M
J
d
V
J
l
M
M
"}
(3,1,1) = {"
q
Q
Q
Q
Q
Q
Q
Q
Z
Q
"}
(4,1,1) = {"
D
R
R
R
H
R
R
R
z
R
"}
(5,1,1) = {"
G
P
n
n
n
n
t
n
n
n
"}
(6,1,1) = {"
A
v
a
e
x
x
e
e
e
e
"}
(7,1,1) = {"
N
M
M
O
o
d
d
l
M
M
"}
(8,1,1) = {"
b
g
g
W
W
o
g
g
y
u
"}
