//MAP CONVERTED BY dmm2tgm.py THIS HEADER COMMENT PREVENTS RECONVERSION, DO NOT REMOVE
"bL" = (
/atom/movable/effect/decal/cleanable/blood/gibs/xeno/body,
/turf/open/floor/plating/ground/dirt,
/area/lv624/ground/caves/central2)
"cS" = (
/obj/structure/flora/ausbushes/fullgrass,
/atom/movable/effect/decal/cleanable/dirt,
/atom/movable/effect/ai_node,
/turf/open/floor/plating/ground/dirt,
/area/lv624/ground/caves/central2)
"dX" = (
/obj/structure/rack,
/turf/open/floor/tile/vault{
	dir = 8
	},
/area/lv624/ground/caves/central1)
"fF" = (
/atom/movable/effect/decal/cleanable/blood/splatter,
/turf/open/floor/plating/ground/dirt,
/area/lv624/ground/caves/central2)
"fJ" = (
/atom/movable/effect/ai_node,
/turf/open/floor/plating/ground/dirt,
/area/lv624/ground/caves/central1)
"fM" = (
/obj/structure/rack,
/obj/item/stack/sheet/mineral/iron{
	amount = 5
	},
/obj/item/stack/sheet/mineral/platinum,
/obj/machinery/light{
	dir = 8
	},
/atom/movable/effect/landmark/lv624/fog_blocker/xeno_spawn,
/turf/open/floor/tile/vault{
	dir = 8
	},
/area/lv624/ground/caves/central1)
"fY" = (
/obj/structure/rack,
/obj/item/tool/shovel,
/atom/movable/effect/landmark/lv624/fog_blocker/xeno_spawn,
/turf/open/floor/tile/vault{
	dir = 8
	},
/area/lv624/ground/caves/central1)
"gJ" = (
/atom/movable/effect/landmark/xeno_resin_door,
/turf/open/floor/plating/ground/dirt,
/area/lv624/ground/caves/central2)
"gM" = (
/turf/open/floor/plating/ground/dirt,
/area/lv624/ground/caves/central2)
"hp" = (
/obj/machinery/miner/damaged/platinum,
/turf/open/floor/plating/ground/dirt,
/area/lv624/ground/caves/central2)
"hq" = (
/turf/closed/wall/r_wall,
/area/lv624/ground/caves/central1)
"ib" = (
/atom/movable/effect/landmark/weed_node,
/obj/structure/flora/ausbushes/fullgrass,
/atom/movable/effect/ai_node,
/turf/open/floor/plating/ground/dirt,
/area/lv624/ground/caves/central2)
"id" = (
/atom/movable/effect/landmark/lv624/fog_blocker/xeno_spawn,
/turf/open/floor/plating/ground/dirt,
/area/lv624/ground/caves/central2)
"iJ" = (
/atom/movable/effect/landmark/weed_node,
/turf/open/floor/plating/ground/dirt,
/area/lv624/ground/caves/central2)
"jO" = (
/atom/movable/effect/spawner/random/ammo/sidearm,
/atom/movable/effect/ai_node,
/turf/open/floor/plating/ground/dirt,
/area/lv624/ground/caves/central2)
"kT" = (
/atom/movable/effect/decal/cleanable/blood/drip,
/atom/movable/effect/ai_node,
/turf/open/floor/plating/ground/dirt,
/area/lv624/ground/caves/central2)
"lD" = (
/obj/structure/flora/ausbushes/fullgrass,
/atom/movable/effect/landmark/lv624/fog_blocker/xeno_spawn,
/turf/open/floor/plating/ground/dirt,
/area/lv624/ground/caves/central2)
"lF" = (
/obj/structure/rack,
/obj/item/stack/sheet/mineral/diamond{
	amount = 2
	},
/turf/open/floor/tile/vault{
	dir = 8
	},
/area/lv624/ground/caves/central1)
"oW" = (
/atom/movable/effect/decal/cleanable/blood/xeno,
/turf/open/floor/plating/ground/dirt,
/area/lv624/ground/caves/central2)
"pI" = (
/atom/movable/effect/decal/cleanable/dirt,
/atom/movable/effect/ai_node,
/turf/open/floor/plating/ground/dirt,
/area/lv624/ground/caves/central2)
"qh" = (
/atom/movable/effect/landmark/xeno_silo_spawn,
/turf/open/floor/plating/ground/dirt,
/area/lv624/ground/caves/central2)
"qL" = (
/atom/movable/effect/spawner/random/gun/sidearms,
/turf/open/floor/plating/ground/dirt,
/area/lv624/ground/caves/central2)
"re" = (
/atom/movable/effect/decal/cleanable/dirt,
/atom/movable/effect/ai_node,
/atom/movable/effect/landmark/lv624/fog_blocker/xeno_spawn,
/turf/open/floor/plating/ground/dirt,
/area/lv624/ground/caves/central2)
"rC" = (
/turf/open/floor,
/area/lv624/ground/caves/central1)
"rT" = (
/obj/machinery/door/airlock/mainship/secure/locked/free_access{
	dir = 4;
	name = "\improper Mining Storage"
	},
/turf/open/floor/tile/dark,
/area/lv624/ground/caves/central1)
"ss" = (
/turf/closed/mineral/smooth,
/area/lv624/ground/caves/rock)
"sL" = (
/atom/movable/effect/landmark/lv624/fog_blocker/xeno_spawn,
/turf/closed/mineral/smooth,
/area/lv624/ground/caves/rock)
"sR" = (
/turf/open/floor/tile/dark,
/area/lv624/ground/caves/central1)
"th" = (
/turf/open/floor/plating/ground/dirt,
/area/lv624/ground/caves/central3)
"ty" = (
/obj/structure/flora/ausbushes/fullgrass,
/atom/movable/effect/decal/cleanable/blood/drip,
/atom/movable/effect/ai_node,
/turf/open/floor/plating/ground/dirt,
/area/lv624/ground/caves/central2)
"ui" = (
/atom/movable/effect/landmark/lv624/fog_blocker,
/atom/movable/effect/landmark/lv624/fog_blocker/xeno_spawn,
/turf/closed/mineral/smooth,
/area/lv624/ground/caves/rock)
"um" = (
/atom/movable/effect/spawner/random/trash,
/atom/movable/effect/landmark/lv624/fog_blocker/xeno_spawn,
/turf/open/floor/plating/ground/dirt,
/area/lv624/ground/caves/central2)
"uX" = (
/obj/structure/rack,
/obj/item/stack/sheet/mineral/tritium{
	pixel_x = -4
	},
/turf/open/floor/tile/vault{
	dir = 8
	},
/area/lv624/ground/caves/central1)
"wf" = (
/turf/open/floor/plating/ground/dirt,
/area/lv624/ground/caves/central1)
"wg" = (
/atom/movable/effect/landmark/weed_node,
/turf/open/floor/plating/ground/dirt,
/area/lv624/ground/caves/central1)
"wp" = (
/obj/structure/flora/ausbushes/fullgrass,
/atom/movable/effect/ai_node,
/turf/open/floor/plating/ground/dirt,
/area/lv624/ground/caves/central2)
"wS" = (
/obj/structure/rack,
/obj/item/stack/sheet/mineral/silver{
	amount = 20
	},
/turf/open/floor/tile/vault{
	dir = 8
	},
/area/lv624/ground/caves/central1)
"xP" = (
/obj/structure/rack,
/obj/item/stack/sheet/mineral/gold{
	amount = 2
	},
/obj/item/stack/sheet/mineral/platinum{
	pixel_x = -6
	},
/turf/open/floor/tile/vault{
	dir = 8
	},
/area/lv624/ground/caves/central1)
"zH" = (
/obj/structure/rack,
/obj/item/stack/sheet/metal{
	amount = 50;
	pixel_x = 4;
	pixel_y = 4
	},
/obj/item/stack/sheet/metal{
	amount = 30
	},
/turf/open/floor/tile/vault{
	dir = 8
	},
/area/lv624/ground/caves/central1)
"Ad" = (
/turf/closed/wall/r_wall,
/area/lv624/ground/caves/rock)
"Af" = (
/atom/movable/effect/spawner/random/clothing,
/atom/movable/effect/ai_node,
/turf/open/floor/plating/ground/dirt,
/area/lv624/ground/caves/central2)
"Aj" = (
/turf/closed/mineral/smooth/indestructible,
/area/lv624/ground/caves/rock)
"AJ" = (
/atom/movable/effect/landmark/xeno_resin_wall,
/turf/open/floor/plating/ground/dirt,
/area/lv624/ground/caves/central2)
"CU" = (
/atom/movable/effect/decal/cleanable/blood/drip,
/turf/open/floor/plating/ground/dirt,
/area/lv624/ground/caves/central2)
"Di" = (
/obj/structure/rack,
/obj/item/tool/shovel,
/turf/open/floor/tile/vault{
	dir = 8
	},
/area/lv624/ground/caves/central1)
"Gy" = (
/atom/movable/effect/landmark/excavation_site_spawner,
/turf/open/floor/plating/ground/dirt,
/area/lv624/ground/caves/central1)
"Hm" = (
/atom/movable/effect/landmark/weed_node,
/atom/movable/effect/decal/cleanable/dirt,
/turf/open/floor/plating/ground/dirt,
/area/lv624/ground/caves/central2)
"HK" = (
/atom/movable/effect/spawner/random/kitchen,
/turf/open/floor/plating/ground/dirt,
/area/lv624/ground/caves/central2)
"HW" = (
/obj/structure/rack,
/atom/movable/effect/landmark/lv624/fog_blocker/xeno_spawn,
/turf/open/floor/tile/vault{
	dir = 8
	},
/area/lv624/ground/caves/central1)
"Ix" = (
/obj/machinery/miner/damaged/platinum,
/turf/open/floor/plating/ground/dirt,
/area/lv624/ground/caves/central1)
"JN" = (
/obj/structure/flora/ausbushes/fullgrass,
/turf/open/floor/plating/ground/dirt,
/area/lv624/ground/caves/central2)
"KM" = (
/atom/movable/effect/landmark/xeno_resin_door,
/turf/open/floor/plating/ground/dirt,
/area/lv624/ground/caves/central3)
"KY" = (
/atom/movable/effect/landmark/xeno_resin_wall,
/turf/open/floor/plating/ground/dirt,
/area/lv624/ground/caves/central1)
"Lr" = (
/atom/movable/effect/landmark/weed_node,
/atom/movable/effect/decal/cleanable/blood/splatter,
/turf/open/floor/plating/ground/dirt,
/area/lv624/ground/caves/central2)
"Lx" = (
/atom/movable/effect/spawner/random/trash,
/turf/open/floor/plating/ground/dirt,
/area/lv624/ground/caves/central2)
"LS" = (
/atom/movable/effect/landmark/excavation_site_spawner,
/turf/open/floor/plating/ground/dirt,
/area/lv624/ground/caves/central2)
"NO" = (
/atom/movable/effect/decal/cleanable/dirt,
/atom/movable/effect/landmark/lv624/fog_blocker/xeno_spawn,
/turf/open/floor/plating/ground/dirt,
/area/lv624/ground/caves/central2)
"Ol" = (
/obj/structure/rack,
/obj/item/tool/pickaxe,
/turf/open/floor/tile/vault{
	dir = 8
	},
/area/lv624/ground/caves/central1)
"OI" = (
/atom/movable/effect/landmark/xeno_resin_door,
/turf/open/floor/plating/ground/dirt,
/area/lv624/ground/caves/central1)
"OS" = (
/atom/movable/effect/landmark/lv624/fog_blocker,
/turf/closed/mineral/smooth,
/area/lv624/ground/caves/rock)
"RN" = (
/atom/movable/effect/landmark/corpsespawner/colonist,
/atom/movable/effect/decal/cleanable/blood/splatter,
/turf/open/floor/plating/ground/dirt,
/area/lv624/ground/caves/central2)
"SA" = (
/atom/movable/effect/ai_node,
/atom/movable/effect/landmark/lv624/fog_blocker/xeno_spawn,
/turf/open/floor/plating/ground/dirt,
/area/lv624/ground/caves/central2)
"SJ" = (
/atom/movable/effect/landmark/xeno_resin_wall,
/atom/movable/effect/landmark/lv624/fog_blocker/xeno_spawn,
/turf/open/floor/plating/ground/dirt,
/area/lv624/ground/caves/central2)
"Tz" = (
/atom/movable/effect/landmark/weed_node,
/atom/movable/effect/ai_node,
/turf/open/floor/plating/ground/dirt,
/area/lv624/ground/caves/central2)
"Xy" = (
/atom/movable/effect/ai_node,
/turf/open/floor/plating/ground/dirt,
/area/lv624/ground/caves/central2)
"Ya" = (
/atom/movable/effect/decal/cleanable/dirt,
/turf/open/floor/plating/ground/dirt,
/area/lv624/ground/caves/central2)
"Yf" = (
/atom/movable/effect/landmark/weed_node,
/atom/movable/effect/ai_node,
/turf/open/floor/plating/ground/dirt,
/area/lv624/ground/caves/central1)
"Yo" = (
/atom/movable/effect/landmark/xeno_resin_wall,
/atom/movable/effect/landmark/weed_node,
/turf/open/floor/plating/ground/dirt,
/area/lv624/ground/caves/central2)
"Zt" = (
/atom/movable/effect/landmark/lv624/fog_blocker/xeno_spawn,
/turf/closed/wall/r_wall,
/area/lv624/ground/caves/rock)

(1,1,1) = {"
ss
ss
ss
ss
ss
ss
ss
ss
ss
ss
KM
KM
KM
KM
KM
ss
ss
ss
ss
ss
ss
ss
ss
ss
ss
ss
ss
th
th
th
th
th
th
"}
(2,1,1) = {"
ss
ss
ss
ss
ss
ss
ss
ss
ss
ss
gM
gM
gM
iJ
gM
ss
ss
ss
ss
ss
ss
ss
ss
ss
ss
ss
ss
ss
ss
ss
ss
ss
th
"}
(3,1,1) = {"
ss
ss
ss
ss
ss
ss
ss
ss
ss
ss
iJ
gM
gM
gM
gM
AJ
ss
ss
ss
ss
ss
ss
ss
ss
ss
ss
Aj
Aj
Aj
Aj
Aj
ss
ss
"}
(4,1,1) = {"
ss
ss
ss
ss
ss
ss
ss
ss
ss
ss
gM
Xy
gM
AJ
iJ
AJ
AJ
ss
ss
ss
ss
ss
Aj
Aj
Aj
Aj
ss
ss
ss
ss
Aj
ss
ss
"}
(5,1,1) = {"
ss
ss
ss
ss
ss
ss
ss
ss
ss
ss
gM
iJ
Xy
gM
gM
Xy
AJ
AJ
ss
ss
ss
ss
Aj
Aj
Aj
Aj
ss
ss
ss
ss
Aj
ss
ss
"}
(6,1,1) = {"
ss
ss
ss
ss
ss
ss
ss
ss
ss
AJ
gM
AJ
gM
gM
gM
gM
gM
AJ
AJ
AJ
ss
ss
ss
ss
ss
ss
ss
ss
ss
ss
ss
ss
ss
"}
(7,1,1) = {"
ss
ss
ss
ss
ss
ss
ss
ss
ss
AJ
gM
gM
gM
Yo
AJ
iJ
hp
gM
iJ
AJ
ss
ss
ss
ss
ss
ss
ss
ss
ss
ss
ss
ss
ss
"}
(8,1,1) = {"
ss
ss
ss
ss
ss
ss
ss
ss
ss
AJ
AJ
iJ
gM
AJ
AJ
gM
iJ
gM
gM
AJ
AJ
ss
Aj
Aj
Aj
Aj
ss
ss
ss
ss
Aj
ss
ss
"}
(9,1,1) = {"
ss
ss
ss
ss
ss
ss
ss
ss
ss
ss
AJ
gM
gM
gM
Xy
Xy
gM
AJ
gM
AJ
AJ
ss
Aj
Aj
Aj
Aj
ss
ss
ss
ss
Aj
ss
ss
"}
(10,1,1) = {"
ss
ss
ss
ss
ss
ss
ss
ss
ss
ss
AJ
AJ
LS
gM
iJ
gM
gM
gM
iJ
AJ
ss
ss
Aj
Aj
Aj
Aj
ss
ss
ss
ss
Aj
ss
ss
"}
(11,1,1) = {"
ss
ss
ss
ss
ss
ss
ss
ss
ss
ss
ss
AJ
AJ
gJ
gJ
AJ
AJ
gJ
gJ
AJ
ss
ss
ss
ss
ss
ss
ss
ss
ss
ss
ss
ss
ss
"}
(12,1,1) = {"
ss
ss
ss
ss
ss
ss
ss
ss
ss
ss
ss
AJ
AJ
gM
gM
AJ
AJ
gM
gM
AJ
ss
ss
ss
ss
ss
ss
ss
ss
ss
ss
ss
ss
ss
"}
(13,1,1) = {"
ss
ss
ss
ss
ss
ss
ss
ss
ss
ss
ss
AJ
AJ
gM
iJ
gM
gM
Xy
AJ
AJ
ss
ss
Aj
Aj
Aj
Aj
ss
ss
ss
ss
Aj
ss
ss
"}
(14,1,1) = {"
ss
ss
ss
ss
ss
ss
ss
ss
ss
ss
ss
gM
gM
gM
Xy
gM
ty
iJ
AJ
ss
ss
ss
Aj
Aj
Aj
Aj
ss
ss
ss
ss
Aj
ss
ss
"}
(15,1,1) = {"
ss
ss
ss
ss
ss
ss
ss
ss
ss
ss
ss
iJ
iJ
gM
AJ
gM
gM
gM
AJ
ss
ss
ss
Aj
Aj
Aj
Aj
ss
ss
ss
ss
Aj
ss
ss
"}
(16,1,1) = {"
ss
ss
ss
ss
ss
ss
ss
ss
ss
ss
ss
gM
gM
gM
gM
Ya
AJ
gM
AJ
AJ
ss
ss
ss
ss
ss
ss
ss
ss
ss
ss
ss
ss
ss
"}
(17,1,1) = {"
ss
ss
ss
ss
ss
ss
ss
ss
ss
ss
AJ
AJ
gM
Xy
Ya
Lx
gM
Tz
gM
AJ
AJ
ss
ss
ss
ss
ss
ss
ss
ss
ss
ss
ss
ss
"}
(18,1,1) = {"
ss
ss
ss
ss
ss
ss
ss
ss
ss
ss
ss
AJ
gM
gM
iJ
gM
gM
Ya
gM
gM
AJ
ss
ss
ss
ss
ss
ss
ss
ss
ss
Aj
Aj
Aj
"}
(19,1,1) = {"
ss
ss
ss
ss
ss
ss
ss
ss
ss
ss
ss
AJ
iJ
Ya
gM
gM
gM
gM
AJ
gM
AJ
AJ
ss
ss
ss
ss
ss
ss
ss
ss
Aj
Aj
Aj
"}
(20,1,1) = {"
ss
ss
ss
ss
ss
ss
ss
ss
ss
ss
ss
AJ
gM
gM
AJ
AJ
Ya
cS
iJ
Ya
HK
AJ
ss
ss
ss
ss
ss
ss
ss
ss
Aj
Aj
Aj
"}
(21,1,1) = {"
ss
ss
ss
ss
ss
ss
ss
ss
ss
ss
AJ
AJ
gM
Xy
gM
gM
CU
gM
Xy
AJ
gM
AJ
ss
ss
ss
ss
ss
ss
ss
ss
ss
ss
ss
"}
(22,1,1) = {"
ss
ss
ss
ss
ss
ss
ss
ss
ss
ss
AJ
gM
iJ
iJ
gM
Hm
gM
Ya
LS
gM
gM
AJ
AJ
ss
ss
ss
ss
ss
ss
ss
ss
ss
ss
"}
(23,1,1) = {"
ss
ss
ss
ss
ss
ss
ss
ss
ss
ss
AJ
gM
gM
hp
gM
Ya
AJ
gM
gM
gM
iJ
gM
AJ
ss
ss
ss
ss
ss
ss
ss
ss
ss
ss
"}
(24,1,1) = {"
ss
ss
ss
ss
ss
ss
ss
ss
ss
ss
AJ
AJ
gM
Tz
gM
gM
gM
Ya
ib
AJ
AJ
gM
AJ
ss
ss
ss
ss
ss
ss
ss
ss
ss
ss
"}
(25,1,1) = {"
ss
ss
ss
ss
ss
ss
ss
ss
ss
ss
ss
AJ
gM
gM
AJ
gM
gM
gM
gM
AJ
AJ
gM
AJ
ss
ss
ss
ss
ss
ss
ss
ss
ss
ss
"}
(26,1,1) = {"
ss
ss
ss
ss
ss
ss
ss
ss
ss
ss
ss
AJ
gM
Ya
AJ
AJ
gM
bL
gM
oW
gM
gM
AJ
ss
ss
ss
ss
ss
ss
ss
ss
ss
ss
"}
(27,1,1) = {"
ss
ss
ss
ss
ss
ss
ss
ss
ss
ss
AJ
AJ
AJ
Xy
gM
RN
CU
iJ
Af
gM
iJ
Xy
AJ
ss
ss
ss
ss
ss
ss
ss
ss
ss
ss
"}
(28,1,1) = {"
ss
ss
ss
ss
ss
ss
ss
ss
ss
ss
AJ
AJ
AJ
gM
gM
gM
JN
gM
gM
gM
gM
gM
AJ
AJ
ss
ss
ss
ss
ss
ss
ss
ss
ss
"}
(29,1,1) = {"
ss
ss
ss
ss
ss
ss
ss
ss
ss
ss
ss
AJ
Ya
gM
iJ
Ya
AJ
AJ
gM
gM
AJ
gM
gM
AJ
ss
ss
ss
ss
ss
ss
ss
ss
ss
"}
(30,1,1) = {"
ss
ss
ss
ss
ss
ss
ss
ss
ss
ss
ss
AJ
iJ
gM
Ya
Ya
gM
AJ
Xy
Lr
gM
gM
gM
AJ
AJ
ss
ss
ss
ss
ss
ss
ss
ss
"}
(31,1,1) = {"
ss
ss
ss
ss
ss
ss
ss
ss
ss
ss
ss
AJ
gM
Xy
gM
gM
gM
Xy
gM
Xy
AJ
iJ
gM
gM
AJ
ss
ss
ss
ss
ss
ss
ss
ss
"}
(32,1,1) = {"
ss
ss
ss
ss
ss
ss
ss
ss
ss
ss
AJ
AJ
gM
iJ
LS
gM
gM
iJ
gM
gM
Xy
gM
JN
Af
AJ
ss
ss
ss
ss
ss
ss
ss
ss
"}
(33,1,1) = {"
ss
ss
ss
ss
ss
ss
ss
ss
ss
ss
ss
AJ
AJ
gM
AJ
gM
gM
gM
AJ
AJ
gM
gM
gM
gM
ss
ss
ss
ss
ss
ss
ss
ss
ss
"}
(34,1,1) = {"
ss
ss
ss
ss
ss
ss
ss
ss
ss
ss
ss
ss
AJ
gM
AJ
gM
CU
gM
AJ
gM
gM
RN
iJ
ss
ss
Aj
ss
ss
ss
ss
Aj
ss
ss
"}
(35,1,1) = {"
ss
ss
ss
ss
ss
ss
ss
ss
ss
ss
ss
ss
ss
gM
gM
gM
gM
Ya
gM
Ya
gM
gM
ss
ss
ss
Aj
ss
ss
ss
ss
Aj
ss
ss
"}
(36,1,1) = {"
ss
ss
ss
ss
ss
ss
ss
ss
ss
ss
ss
ss
AJ
Xy
qL
Xy
iJ
Xy
Ya
Ya
Xy
ss
ss
ss
ss
Aj
ss
ss
ss
ss
Aj
ss
ss
"}
(37,1,1) = {"
ss
ss
ss
ss
ss
ss
ss
ss
ss
ss
ss
ss
AJ
iJ
gM
Ya
AJ
gM
gM
AJ
fF
ss
ss
ss
ss
Aj
ss
ss
ss
ss
Aj
ss
ss
"}
(38,1,1) = {"
ss
ss
ss
ss
ss
ss
ss
ss
ss
ss
ss
ss
AJ
AJ
gM
Ya
AJ
gM
gM
gM
gM
ss
ss
ss
ss
Aj
ss
ss
ss
ss
Aj
ss
Aj
"}
(39,1,1) = {"
ss
ss
ss
ss
ss
ss
ss
ss
ss
ss
sL
sL
SJ
id
id
SA
NO
SA
gM
Hm
gM
ss
ss
ss
ss
Aj
ss
ss
ss
ss
Aj
ss
Aj
"}
(40,1,1) = {"
ss
ss
ss
ss
ss
ss
ss
ss
ss
ss
sL
ss
AJ
gM
AJ
gM
Xy
id
CU
gM
pI
ss
ss
ss
ss
ss
ss
ss
ss
ss
ss
ss
Aj
"}
(41,1,1) = {"
ss
ss
ss
ss
ss
ss
ss
ss
ss
ss
sL
ss
AJ
gM
AJ
AJ
gM
id
AJ
AJ
gM
Xy
ss
ss
ss
ss
ss
ss
ss
ss
ss
ss
ss
"}
(42,1,1) = {"
ss
ss
ss
ss
ss
ss
ss
ss
ss
ss
sL
ss
ss
gM
gM
gM
iJ
id
gM
gM
gM
Ya
gM
ss
ss
ss
ss
AJ
AJ
ss
ss
ss
ss
"}
(43,1,1) = {"
ss
ss
ss
ss
ss
ss
ss
ss
ss
ss
sL
ss
ss
gM
iJ
gM
gM
id
id
id
gM
Tz
gM
gM
gJ
Xy
gM
gM
AJ
AJ
ss
ss
gM
"}
(44,1,1) = {"
ss
ss
ss
ss
ss
ss
ss
ss
ss
ss
sL
ss
ss
gM
Ya
gM
qh
gM
Ya
id
gM
gM
gM
AJ
AJ
gM
iJ
gM
iJ
gM
gM
gM
gM
"}
(45,1,1) = {"
ss
ss
ss
ss
ss
ss
ss
ss
ss
ss
sL
ss
AJ
gM
gM
gM
gM
gM
gM
SJ
SJ
id
CU
AJ
AJ
gM
CU
gM
CU
gM
gM
iJ
gM
"}
(46,1,1) = {"
ss
ss
ss
ss
ss
ss
ss
ss
ss
ss
sL
AJ
AJ
JN
Ya
gM
Ya
iJ
gM
AJ
gM
SA
JN
gM
gJ
gM
gM
iJ
gM
LS
gM
Xy
gM
"}
(47,1,1) = {"
ss
ss
ss
ss
ss
ss
ss
ss
ss
ss
sL
AJ
iJ
gM
CU
iJ
gM
Xy
gM
gM
gM
id
gM
iJ
gJ
gM
gM
CU
gM
gM
Xy
gM
gM
"}
(48,1,1) = {"
ss
ss
ss
ss
ss
ss
ss
ss
ss
ss
sL
AJ
Xy
gM
gM
gM
Xy
gM
gM
gM
iJ
um
gM
CU
gJ
Xy
gM
gM
gM
Xy
ss
ss
ss
"}
(49,1,1) = {"
ss
ss
ss
ss
ss
ss
ss
ss
ss
ss
sL
AJ
gM
AJ
gM
RN
CU
AJ
gM
gM
AJ
id
gM
iJ
AJ
ss
ss
gM
gM
ss
ss
ss
ss
"}
(50,1,1) = {"
ss
ss
ss
ss
ss
ss
ss
ss
ss
ss
sL
AJ
gM
AJ
AJ
gM
iJ
gM
gM
gM
AJ
id
Ya
gM
AJ
ss
ss
ss
ss
ss
ss
ss
ss
"}
(51,1,1) = {"
ss
ss
ss
ss
ss
ss
ss
ss
ss
ss
sL
SJ
SA
id
id
id
SA
id
lD
id
id
re
gM
gM
AJ
ss
ss
ss
ss
ss
ss
ss
ss
"}
(52,1,1) = {"
ss
ss
ss
ss
ss
ss
ss
ss
ss
ss
ss
AJ
gM
gM
iJ
gM
gM
kT
gM
gM
fF
iJ
gM
AJ
AJ
ss
ss
ss
ss
ss
ss
ss
ss
"}
(53,1,1) = {"
ss
ss
ss
ss
ss
ss
ss
ss
ss
ss
AJ
AJ
gM
gM
gM
AJ
AJ
Ya
gM
AJ
gM
Ya
gM
AJ
AJ
ss
ss
ss
ss
ss
ss
ss
ss
"}
(54,1,1) = {"
ss
ss
ss
ss
ss
ss
ss
ss
ss
ss
AJ
gM
Ya
Ya
gM
AJ
AJ
Ya
gM
gM
LS
Xy
Ya
jO
AJ
ss
ss
ss
ss
ss
ss
ss
ss
"}
(55,1,1) = {"
ss
ss
ss
ss
ss
ss
ss
ss
ss
AJ
AJ
Xy
hp
iJ
gM
Xy
Ya
Ya
gM
CU
iJ
gM
Hm
gM
AJ
ss
ss
ss
ss
ss
ss
ss
ss
"}
(56,1,1) = {"
ss
ss
ss
ss
ss
ss
ss
ss
ss
AJ
AJ
gM
Xy
gM
wp
gM
iJ
Xy
gM
JN
AJ
gM
gM
gM
AJ
ss
ss
ss
ss
ss
ss
ss
ss
"}
(57,1,1) = {"
ss
ss
ss
ss
ss
ss
ss
ss
ss
AJ
AJ
gM
AJ
AJ
gM
gM
gM
gM
Xy
RN
gM
Xy
Ya
AJ
AJ
ss
ss
ss
ss
ss
ss
ss
ss
"}
(58,1,1) = {"
ss
ss
ss
ss
ss
ss
ss
ss
ss
AJ
AJ
gM
gM
gM
gM
Ya
gM
AJ
gM
gM
gM
Ya
AJ
AJ
ss
ss
ss
ss
ss
ss
ss
ss
ss
"}
(59,1,1) = {"
ss
ss
ss
ss
ss
ss
ss
ss
ss
ss
AJ
gM
gM
gM
CU
gM
Ya
gM
Ya
iJ
Ya
AJ
AJ
ss
ss
ss
ss
ss
ss
ss
ss
ss
ss
"}
(60,1,1) = {"
ss
ss
ss
ss
ss
ss
ss
ss
ss
ss
AJ
Xy
gM
Tz
gM
Tz
gM
gM
pI
gM
AJ
AJ
ss
ss
ss
ss
ss
ss
ss
ss
ss
ss
ss
"}
(61,1,1) = {"
ss
ss
ss
ss
ss
ss
ss
ss
ss
ss
AJ
AJ
gM
gM
AJ
gM
gM
AJ
gM
gM
AJ
ss
ss
ss
ss
ss
ss
ss
ss
ss
ss
ss
ss
"}
(62,1,1) = {"
ss
ss
ss
ss
ss
ss
ss
ss
ss
ss
ss
AJ
gM
gM
AJ
gM
Ya
gM
gM
gM
AJ
ss
ss
ss
ss
ss
ss
ss
ss
ss
ss
ss
ss
"}
(63,1,1) = {"
ss
ss
ss
ss
ss
ss
ss
ss
ss
ss
ss
AJ
AJ
gM
gM
Ya
Ya
JN
iJ
gM
AJ
ss
ss
ss
ss
ss
ss
ss
ss
ss
ss
ss
ss
"}
(64,1,1) = {"
ss
ss
ss
ss
ss
ss
ss
ss
ss
ss
ss
ss
AJ
Xy
gM
gM
gM
gM
Xy
AJ
AJ
ss
ss
ss
ss
ss
ss
ss
ss
ss
ss
ss
ss
"}
(65,1,1) = {"
ss
ss
ss
ss
ss
ss
ss
ss
ss
ss
ss
ss
AJ
AJ
Xy
gM
iJ
gM
Ya
AJ
AJ
ss
ss
ss
ss
ss
ss
ss
ss
ss
ss
ss
ss
"}
(66,1,1) = {"
ss
ss
ss
ss
ss
ss
ss
ss
ss
ss
ss
ss
ss
AJ
gM
CU
AJ
gM
gM
Ya
AJ
ss
ss
Aj
Aj
Aj
ss
ss
ss
ss
ss
Aj
ss
"}
(67,1,1) = {"
ss
ss
ss
ss
ss
ss
ss
ss
ss
ss
ss
ss
ss
AJ
gM
Lx
fF
gM
iJ
Ya
AJ
ss
ss
Aj
Aj
Aj
ss
ss
ss
ss
ss
Aj
ss
"}
(68,1,1) = {"
ss
ss
ss
ss
ss
ss
ss
ss
ss
ss
ss
ss
ss
AJ
gM
iJ
gM
gM
JN
Ya
AJ
ss
ss
Aj
Aj
Aj
ss
ss
ss
ss
ss
Aj
ss
"}
(69,1,1) = {"
ss
ss
ss
ss
ss
ss
ss
ss
ss
ss
ss
ss
ss
AJ
gM
JN
gM
gM
gM
gM
AJ
ss
ss
ss
ss
ss
ss
ss
ss
ss
ss
ss
ss
"}
(70,1,1) = {"
ss
ss
ss
ss
ss
ss
ss
ss
ss
ss
ss
ss
ss
AJ
gM
gM
gM
gM
iJ
gM
AJ
ss
ss
Aj
Aj
Aj
ss
ss
ss
ss
ss
Aj
ss
"}
(71,1,1) = {"
Aj
Aj
Aj
Aj
ss
Aj
ss
ss
ss
Aj
Aj
Aj
ss
AJ
Xy
iJ
gM
gM
Xy
gM
AJ
ss
ss
Aj
Aj
Aj
ss
ss
ss
ss
ss
Aj
ss
"}
(72,1,1) = {"
Aj
Aj
Aj
Aj
ss
Aj
Aj
Aj
Aj
ss
Aj
Aj
KY
KY
OI
OI
KY
KY
OI
OI
KY
Aj
Aj
Aj
Aj
Aj
ss
ss
Aj
Aj
Aj
Aj
ss
"}
(73,1,1) = {"
Aj
Aj
Aj
Aj
ss
Aj
Aj
Aj
Aj
ss
Aj
KY
KY
wf
wf
wf
KY
KY
wg
wf
KY
KY
KY
Aj
Aj
Aj
ss
ss
ss
ss
ss
ss
ss
"}
(74,1,1) = {"
Aj
Aj
Aj
Aj
ss
Aj
Aj
Aj
Aj
ss
KY
KY
Gy
wf
wf
wg
wf
wf
wf
wf
wf
wf
KY
ss
ss
ss
ss
ui
Zt
fY
fM
HW
Zt
"}
(75,1,1) = {"
ss
ss
ss
ss
ss
ss
ss
ss
ss
ss
KY
wf
wf
wf
wf
wf
wf
wf
wf
wf
wf
wf
KY
KY
ss
ss
ss
OS
Ad
xP
sR
uX
Ad
"}
(76,1,1) = {"
Aj
Aj
Aj
Aj
ss
Aj
Aj
Aj
Aj
ss
KY
wf
wg
wf
fJ
wg
wf
wf
Yf
wf
wg
wf
wf
KY
ss
ss
ss
OS
Ad
lF
sR
wS
hq
"}
(77,1,1) = {"
Aj
Aj
Aj
Aj
ss
Aj
Aj
Aj
Aj
ss
KY
KY
wf
wf
wf
wf
Ix
wf
wf
wf
wf
wf
wf
ss
ss
ss
ss
OS
Ad
zH
sR
dX
hq
"}
(78,1,1) = {"
Aj
Aj
Aj
Aj
ss
Aj
Aj
Aj
Aj
ss
ss
KY
KY
wf
wf
wf
wf
wf
wf
wf
wf
wf
ss
ss
ss
ss
ss
OS
Ad
Di
sR
Ol
hq
"}
(79,1,1) = {"
ss
ss
ss
ss
ss
ss
ss
ss
ss
ss
ss
ss
KY
wg
wf
wg
wf
wg
wf
wf
wg
wf
ss
ss
ss
ss
ss
OS
Ad
hq
rT
hq
hq
"}
(80,1,1) = {"
Aj
Aj
Aj
Aj
ss
Aj
Aj
Aj
Aj
ss
ss
ss
ss
wf
fJ
wf
wf
wf
fJ
wf
wf
fJ
OI
wf
ss
ss
ss
OS
ss
rC
rC
rC
rC
"}
