//MAP CONVERTED BY dmm2tgm.py THIS HEADER COMMENT PREVENTS RECONVERSION, DO NOT REMOVE
"ar" = (
/obj/effect/ai_node,
/turf/open/floor/plating/ground/dirt,
/area/lv624/ground/caves/central2)
"aR" = (
/turf/open/ground/coast{
	dir = 9
	},
/area/lv624/ground/caves/central2)
"bt" = (
/obj/structure/rack,
/obj/item/stack/sheet/mineral/diamond{
	amount = 2
	},
/turf/open/floor/tile/vault{
	dir = 8
	},
/area/lv624/ground/caves/central1)
"bS" = (
/obj/effect/landmark/xeno_resin_door,
/turf/open/floor/plating/ground/dirt,
/area/lv624/ground/caves/central1)
"eZ" = (
/turf/open/ground/coast/corner2{
	dir = 1
	},
/area/lv624/ground/caves/central2)
"ga" = (
/turf/open/ground/coast{
	dir = 6
	},
/area/lv624/ground/caves/central2)
"gy" = (
/turf/open/floor/plating/ground/dirt,
/area/lv624/ground/caves/central3)
"hO" = (
/obj/effect/ai_node,
/turf/open/floor/tile/dark,
/area/lv624/ground/caves/central1)
"iI" = (
/turf/open/ground/coast/corner{
	dir = 8
	},
/area/lv624/ground/caves/central2)
"iX" = (
/obj/effect/landmark/weed_node,
/obj/effect/ai_node,
/turf/open/floor/plating/ground/dirt,
/area/lv624/ground/caves/central2)
"jD" = (
/obj/effect/landmark/excavation_site_spawner,
/turf/open/floor/plating/ground/dirt,
/area/lv624/ground/caves/central1)
"jP" = (
/obj/effect/ai_node,
/turf/open/floor/plating/ground/dirt,
/area/lv624/ground/caves/central1)
"ka" = (
/turf/open/ground/coast/corner2{
	dir = 4
	},
/area/lv624/ground/caves/central2)
"kq" = (
/turf/open/floor/tile/dark,
/area/lv624/ground/caves/central1)
"lb" = (
/obj/structure/jungle/plantbot1/alien,
/turf/open/ground/river,
/area/lv624/ground/caves/central2)
"ly" = (
/turf/open/ground/coast{
	dir = 8
	},
/area/lv624/ground/caves/central2)
"ns" = (
/obj/structure/flora/ausbushes/reedbush,
/turf/open/ground/river,
/area/lv624/ground/caves/central2)
"oz" = (
/turf/closed/wall/r_wall,
/area/lv624/ground/caves/central1)
"qQ" = (
/obj/effect/landmark/lv624/fog_blocker,
/obj/effect/landmark/lv624/fog_blocker/xeno_spawn,
/turf/closed/mineral/smooth,
/area/lv624/ground/caves/rock)
"rR" = (
/turf/closed/wall/r_wall,
/area/lv624/ground/caves/rock)
"rS" = (
/obj/structure/rack,
/turf/open/floor/tile/vault{
	dir = 8
	},
/area/lv624/ground/caves/central1)
"sv" = (
/obj/effect/landmark/xeno_resin_wall,
/turf/open/floor/plating/ground/dirt,
/area/lv624/ground/caves/central1)
"sG" = (
/turf/open/floor,
/area/lv624/ground/caves/central1)
"sS" = (
/obj/effect/landmark/xeno_resin_door,
/turf/open/floor/plating/ground/dirt,
/area/lv624/ground/caves/central3)
"tH" = (
/obj/machinery/miner/damaged/platinum,
/turf/open/floor/plating/ground/dirt,
/area/lv624/ground/caves/central2)
"uD" = (
/obj/effect/landmark/xeno_resin_wall,
/turf/open/floor/plating/ground/dirt,
/area/lv624/ground/caves/central2)
"uS" = (
/turf/open/ground/river,
/area/lv624/ground/caves/central2)
"xw" = (
/obj/structure/rack,
/obj/item/stack/sheet/mineral/tritium{
	pixel_x = -4
	},
/turf/open/floor/tile/vault{
	dir = 8
	},
/area/lv624/ground/caves/central1)
"xG" = (
/obj/structure/flora/ausbushes/fullgrass,
/turf/open/floor/plating/ground/dirt,
/area/lv624/ground/caves/central2)
"ye" = (
/obj/effect/landmark/xeno_resin_door,
/obj/effect/ai_node,
/turf/open/floor/plating/ground/dirt,
/area/lv624/ground/caves/central1)
"zc" = (
/obj/effect/landmark/weed_node,
/obj/effect/landmark/xeno_resin_wall,
/turf/open/floor/plating/ground/dirt,
/area/lv624/ground/caves/central2)
"zr" = (
/obj/effect/landmark/lv624/fog_blocker,
/turf/closed/mineral/smooth,
/area/lv624/ground/caves/rock)
"zx" = (
/obj/effect/landmark/weed_node,
/obj/effect/landmark/xeno_resin_door,
/turf/open/floor/plating/ground/dirt,
/area/lv624/ground/caves/central1)
"Al" = (
/obj/structure/rack,
/obj/item/stack/sheet/metal{
	amount = 50;
	pixel_x = 4;
	pixel_y = 4
	},
/obj/item/stack/sheet/metal{
	amount = 30
	},
/turf/open/floor/tile/vault{
	dir = 8
	},
/area/lv624/ground/caves/central1)
"Ap" = (
/obj/structure/rack,
/obj/item/tool/shovel,
/obj/effect/landmark/lv624/fog_blocker/xeno_spawn,
/turf/open/floor/tile/vault{
	dir = 8
	},
/area/lv624/ground/caves/central1)
"BT" = (
/obj/structure/rack,
/obj/item/stack/sheet/mineral/iron{
	amount = 5
	},
/obj/item/stack/sheet/mineral/platinum,
/obj/machinery/light{
	dir = 8
	},
/obj/effect/landmark/lv624/fog_blocker/xeno_spawn,
/turf/open/floor/tile/vault{
	dir = 8
	},
/area/lv624/ground/caves/central1)
"Ch" = (
/turf/open/ground/coast/corner,
/area/lv624/ground/caves/central2)
"Cr" = (
/turf/open/ground/coast/corner2{
	dir = 8
	},
/area/lv624/ground/caves/central2)
"Dh" = (
/obj/effect/landmark/weed_node,
/turf/open/floor/tile/dark,
/area/lv624/ground/caves/central1)
"Du" = (
/obj/structure/rack,
/obj/item/stack/sheet/mineral/silver{
	amount = 20
	},
/turf/open/floor/tile/vault{
	dir = 8
	},
/area/lv624/ground/caves/central1)
"DA" = (
/turf/closed/mineral/smooth/indestructible,
/area/lv624/ground/caves/rock)
"EG" = (
/obj/structure/rack,
/obj/effect/landmark/lv624/fog_blocker/xeno_spawn,
/turf/open/floor/tile/vault{
	dir = 8
	},
/area/lv624/ground/caves/central1)
"EZ" = (
/obj/structure/jungle/plantbot1/alien,
/turf/open/ground/coast/corner2,
/area/lv624/ground/caves/central2)
"Fa" = (
/obj/structure/rack,
/obj/item/tool/shovel,
/turf/open/floor/tile/vault{
	dir = 8
	},
/area/lv624/ground/caves/central1)
"FB" = (
/turf/closed/mineral/smooth,
/area/lv624/ground/caves/rock)
"FZ" = (
/turf/open/ground/coast/corner{
	dir = 4
	},
/area/lv624/ground/caves/central2)
"Hl" = (
/turf/open/ground/coast{
	dir = 4
	},
/area/lv624/ground/caves/central2)
"HI" = (
/turf/open/floor/plating/ground/dirt,
/area/lv624/ground/caves/central1)
"Jn" = (
/obj/structure/flora/ausbushes/fullgrass,
/obj/effect/landmark/weed_node,
/turf/open/floor/plating/ground/dirt,
/area/lv624/ground/caves/central2)
"KT" = (
/obj/structure/rack,
/obj/item/stack/sheet/mineral/gold{
	amount = 2
	},
/obj/item/stack/sheet/mineral/platinum{
	pixel_x = -6
	},
/turf/open/floor/tile/vault{
	dir = 8
	},
/area/lv624/ground/caves/central1)
"My" = (
/obj/machinery/door/airlock/mainship/secure/locked/free_access{
	dir = 4;
	name = "\improper Mining Storage"
	},
/turf/open/floor/tile/dark,
/area/lv624/ground/caves/central1)
"NP" = (
/turf/open/floor/plating/ground/dirt,
/area/lv624/ground/caves/central2)
"Pr" = (
/obj/effect/landmark/lv624/fog_blocker/xeno_spawn,
/turf/closed/wall/r_wall,
/area/lv624/ground/caves/rock)
"Qk" = (
/turf/closed/wall,
/area/lv624/ground/caves/central1)
"Rk" = (
/turf/open/ground/coast{
	dir = 1
	},
/area/lv624/ground/caves/central2)
"RB" = (
/turf/open/ground/coast/corner{
	dir = 1
	},
/area/lv624/ground/caves/central2)
"RS" = (
/obj/effect/landmark/weed_node,
/turf/open/ground/coast{
	dir = 1
	},
/area/lv624/ground/caves/central2)
"Se" = (
/obj/structure/rack,
/obj/item/tool/pickaxe,
/turf/open/floor/tile/vault{
	dir = 8
	},
/area/lv624/ground/caves/central1)
"UA" = (
/turf/open/ground/coast,
/area/lv624/ground/caves/central2)
"UH" = (
/turf/open/ground/coast/corner2,
/area/lv624/ground/caves/central2)
"Vq" = (
/obj/effect/landmark/weed_node,
/turf/open/floor/plating/ground/dirt,
/area/lv624/ground/caves/central1)
"Ws" = (
/obj/structure/flora/ausbushes/reedbush,
/turf/open/ground/coast/corner2,
/area/lv624/ground/caves/central2)
"Wy" = (
/turf/open/ground/coast{
	dir = 5
	},
/area/lv624/ground/caves/central2)
"WS" = (
/obj/structure/flora/ausbushes/fernybush,
/turf/open/ground/river,
/area/lv624/ground/caves/central2)
"YD" = (
/obj/effect/landmark/weed_node,
/turf/open/floor/plating/ground/dirt,
/area/lv624/ground/caves/central2)
"Zc" = (
/obj/effect/landmark/excavation_site_spawner,
/turf/open/floor/plating/ground/dirt,
/area/lv624/ground/caves/central2)

(1,1,1) = {"
FB
FB
FB
FB
FB
FB
FB
FB
FB
FB
sS
sS
sS
sS
sS
FB
FB
FB
FB
FB
FB
FB
FB
FB
FB
FB
FB
gy
gy
gy
gy
gy
gy
"}
(2,1,1) = {"
FB
FB
FB
FB
FB
FB
FB
FB
FB
FB
NP
NP
NP
NP
NP
FB
FB
FB
FB
FB
FB
FB
FB
FB
FB
FB
FB
FB
FB
FB
FB
FB
gy
"}
(3,1,1) = {"
FB
FB
FB
FB
FB
FB
FB
FB
FB
FB
NP
NP
YD
NP
NP
NP
YD
NP
NP
FB
FB
FB
FB
FB
FB
FB
DA
DA
DA
DA
DA
FB
FB
"}
(4,1,1) = {"
FB
FB
FB
FB
FB
FB
FB
uD
uD
uD
NP
NP
NP
NP
NP
NP
NP
NP
NP
NP
NP
NP
FB
FB
FB
FB
DA
DA
DA
DA
DA
FB
FB
"}
(5,1,1) = {"
FB
FB
FB
FB
FB
FB
FB
uD
uD
NP
NP
ar
NP
NP
NP
NP
NP
NP
ar
NP
NP
ar
NP
FB
FB
FB
DA
DA
DA
DA
DA
FB
FB
"}
(6,1,1) = {"
FB
FB
FB
FB
FB
FB
NP
YD
NP
NP
NP
NP
YD
NP
NP
NP
NP
YD
NP
NP
NP
YD
NP
uD
FB
FB
FB
FB
FB
FB
FB
FB
FB
"}
(7,1,1) = {"
FB
FB
FB
FB
FB
FB
NP
NP
NP
NP
NP
NP
NP
NP
NP
NP
NP
NP
NP
NP
uD
NP
NP
uD
FB
FB
FB
FB
FB
FB
FB
FB
FB
"}
(8,1,1) = {"
FB
FB
FB
FB
FB
NP
uD
uD
NP
NP
NP
NP
uD
NP
YD
NP
uD
uD
NP
NP
NP
NP
NP
uD
uD
FB
DA
DA
DA
DA
DA
FB
FB
"}
(9,1,1) = {"
FB
FB
FB
FB
FB
NP
uD
uD
NP
YD
NP
NP
NP
NP
NP
NP
uD
uD
NP
YD
NP
YD
NP
uD
uD
FB
DA
DA
DA
DA
DA
FB
FB
"}
(10,1,1) = {"
FB
FB
FB
FB
FB
NP
NP
NP
NP
Zc
NP
NP
NP
NP
NP
YD
NP
NP
NP
NP
NP
NP
NP
uD
FB
FB
DA
DA
DA
DA
DA
FB
FB
"}
(11,1,1) = {"
FB
FB
FB
FB
FB
NP
NP
NP
NP
NP
NP
YD
NP
NP
NP
NP
NP
NP
NP
NP
NP
NP
NP
uD
FB
FB
FB
FB
FB
FB
FB
FB
FB
"}
(12,1,1) = {"
FB
FB
FB
FB
FB
ar
NP
NP
NP
NP
NP
ar
NP
xG
NP
NP
NP
NP
ar
NP
NP
ar
NP
uD
FB
FB
FB
FB
FB
FB
FB
FB
FB
"}
(13,1,1) = {"
FB
FB
FB
FB
FB
NP
NP
uD
uD
Jn
NP
NP
NP
YD
NP
NP
NP
YD
NP
uD
YD
NP
uD
uD
FB
FB
DA
DA
DA
DA
DA
FB
FB
"}
(14,1,1) = {"
FB
FB
FB
FB
NP
NP
uD
uD
uD
NP
Ch
Hl
Hl
Hl
Hl
Hl
iI
NP
NP
NP
NP
NP
uD
FB
FB
FB
DA
DA
DA
DA
DA
FB
FB
"}
(15,1,1) = {"
FB
FB
FB
NP
NP
NP
uD
uD
NP
NP
UA
uS
uS
uS
uS
uS
Wy
Hl
iI
xG
NP
NP
uD
FB
FB
FB
DA
DA
DA
DA
DA
FB
FB
"}
(16,1,1) = {"
FB
FB
FB
NP
NP
YD
NP
xG
NP
NP
UA
uS
uS
uS
uS
uS
uS
uS
Rk
NP
NP
NP
uD
uD
FB
FB
FB
FB
FB
FB
FB
FB
FB
"}
(17,1,1) = {"
FB
FB
FB
NP
NP
NP
NP
NP
NP
YD
UA
uS
uS
uS
uS
uS
uS
uS
Rk
NP
YD
NP
NP
uD
uD
FB
FB
FB
FB
FB
FB
FB
FB
"}
(18,1,1) = {"
FB
FB
FB
NP
NP
NP
YD
NP
NP
Ch
ga
uS
uS
uS
uS
lb
uS
uS
Rk
NP
NP
NP
NP
NP
uD
uD
uD
uD
FB
FB
DA
DA
DA
"}
(19,1,1) = {"
FB
FB
FB
NP
NP
NP
NP
NP
NP
UA
uS
uS
uS
uS
uS
uS
uS
uS
Rk
NP
uD
ar
NP
NP
NP
NP
NP
uD
uD
FB
DA
DA
DA
"}
(20,1,1) = {"
FB
FB
NP
NP
uD
NP
NP
NP
NP
UA
uS
uS
WS
uS
uS
uS
uS
uS
ka
iI
NP
NP
ar
NP
uD
NP
NP
NP
uD
FB
DA
DA
DA
"}
(21,1,1) = {"
FB
uD
NP
NP
NP
ar
NP
NP
NP
UA
uS
uS
uS
uS
uS
uS
uS
uS
uS
Rk
YD
NP
NP
ar
NP
NP
ar
YD
uD
FB
FB
FB
FB
"}
(22,1,1) = {"
FB
uD
NP
Jn
NP
NP
YD
NP
NP
UA
uS
uS
uS
uS
uS
uS
ns
uS
uS
Rk
NP
NP
uD
NP
NP
NP
NP
NP
uD
FB
FB
FB
FB
"}
(23,1,1) = {"
FB
uD
NP
NP
NP
NP
NP
uD
NP
UA
lb
uS
uS
uS
uS
uS
uS
uS
uS
ka
iI
xG
NP
NP
YD
NP
NP
NP
uD
uD
FB
FB
FB
"}
(24,1,1) = {"
FB
uD
NP
NP
NP
NP
NP
NP
NP
RB
eZ
uS
uS
Cr
ly
eZ
uS
uS
uS
uS
Rk
NP
NP
NP
NP
NP
NP
NP
NP
uD
FB
FB
FB
"}
(25,1,1) = {"
FB
uD
NP
NP
NP
NP
NP
NP
NP
NP
UA
uS
WS
Rk
YD
RB
eZ
uS
uS
uS
RS
NP
NP
NP
NP
NP
NP
NP
NP
uD
uD
FB
FB
"}
(26,1,1) = {"
FB
uD
YD
NP
tH
NP
zc
NP
NP
NP
UA
uS
uS
ka
iI
NP
UA
uS
uS
Cr
FZ
NP
NP
NP
NP
NP
NP
NP
NP
uD
uD
FB
FB
"}
(27,1,1) = {"
FB
uD
NP
NP
NP
NP
xG
NP
NP
NP
UA
uS
uS
uS
ka
Hl
EZ
uS
uS
Rk
NP
NP
NP
NP
NP
YD
ar
NP
NP
uD
FB
FB
FB
"}
(28,1,1) = {"
FB
uD
NP
uD
NP
NP
NP
NP
NP
Ch
Ws
uS
uS
uS
uS
uS
uS
uS
uS
Rk
YD
NP
NP
NP
NP
NP
NP
NP
uD
uD
FB
FB
FB
"}
(29,1,1) = {"
FB
uD
NP
NP
NP
NP
NP
NP
NP
UA
uS
uS
uS
uS
uS
uS
uS
uS
uS
ka
iI
NP
NP
NP
uD
uD
NP
NP
uD
FB
FB
FB
FB
"}
(30,1,1) = {"
FB
uD
YD
xG
uD
NP
YD
NP
NP
UA
uS
uS
uS
uS
ns
uS
uS
uS
uS
uS
Rk
NP
YD
uD
uD
NP
YD
NP
uD
FB
FB
FB
FB
"}
(31,1,1) = {"
FB
uD
NP
NP
uD
ar
NP
NP
NP
UA
uS
uS
uS
uS
uS
uS
uS
uS
uS
uS
Rk
NP
NP
NP
NP
NP
NP
NP
uD
FB
FB
FB
FB
"}
(32,1,1) = {"
FB
uD
NP
NP
NP
NP
ar
NP
NP
UA
uS
uS
uS
uS
uS
uS
uS
uS
uS
uS
Rk
NP
NP
NP
NP
NP
NP
uD
uD
FB
FB
FB
FB
"}
(33,1,1) = {"
FB
uD
NP
NP
NP
xG
NP
NP
NP
RB
eZ
uS
uS
uS
uS
uS
uS
uS
WS
uS
Rk
NP
YD
NP
ar
NP
ar
uD
FB
FB
FB
FB
FB
"}
(34,1,1) = {"
FB
uD
YD
NP
uD
NP
YD
NP
NP
NP
UA
uS
uS
uS
uS
uS
uS
uS
uS
uS
ka
iI
NP
NP
NP
uD
uD
uD
FB
DA
DA
FB
FB
"}
(35,1,1) = {"
FB
uD
NP
NP
NP
NP
NP
NP
NP
NP
UA
uS
uS
uS
uS
ns
uS
lb
uS
uS
uS
Wy
iI
NP
YD
uD
uD
uD
FB
DA
DA
FB
FB
"}
(36,1,1) = {"
FB
uD
YD
NP
NP
NP
NP
uD
NP
NP
UA
lb
uS
uS
uS
uS
uS
uS
uS
uS
uS
uS
Wy
iI
NP
NP
NP
uD
FB
DA
DA
FB
FB
"}
(37,1,1) = {"
FB
uD
NP
NP
NP
NP
NP
NP
NP
NP
UA
uS
uS
uS
uS
uS
uS
uS
uS
uS
uS
uS
uS
Rk
NP
NP
NP
uD
FB
DA
DA
FB
FB
"}
(38,1,1) = {"
FB
uD
NP
uD
uD
NP
YD
NP
xG
Ch
UH
uS
uS
uS
uS
Cr
ly
eZ
uS
uS
uS
uS
uS
Rk
iX
NP
NP
uD
FB
DA
DA
FB
DA
"}
(39,1,1) = {"
FB
uD
YD
uD
uD
NP
NP
NP
NP
UA
uS
uS
uS
uS
Cr
FZ
NP
UA
uS
lb
uS
uS
uS
Rk
NP
ar
NP
uD
FB
DA
DA
FB
DA
"}
(40,1,1) = {"
FB
uD
NP
NP
NP
NP
NP
NP
NP
UA
uS
uS
uS
uS
Rk
NP
YD
UA
uS
uS
uS
uS
uS
ka
iI
NP
NP
uD
FB
FB
FB
FB
DA
"}
(41,1,1) = {"
FB
uD
uD
NP
NP
NP
NP
NP
NP
UA
uS
uS
uS
uS
Rk
NP
NP
RB
eZ
uS
uS
uS
uS
uS
Rk
YD
NP
uD
uD
FB
FB
FB
FB
"}
(42,1,1) = {"
FB
FB
uD
uD
NP
NP
iX
NP
NP
UA
uS
uS
uS
uS
Rk
NP
YD
NP
UA
uS
uS
ns
uS
uS
Rk
NP
NP
xG
uD
FB
FB
FB
FB
"}
(43,1,1) = {"
FB
FB
FB
uD
NP
NP
xG
NP
NP
UA
ns
uS
uS
uS
ka
iI
NP
NP
UA
lb
uS
uS
uS
uS
Rk
NP
xG
NP
uD
uD
FB
uD
uD
"}
(44,1,1) = {"
FB
FB
FB
uD
NP
NP
NP
NP
Ch
UH
uS
uS
uS
uS
uS
ka
Hl
Hl
UH
uS
uS
uS
uS
uS
Rk
NP
NP
NP
NP
uD
uD
uD
NP
"}
(45,1,1) = {"
FB
FB
FB
uD
uD
uD
NP
NP
UA
uS
uS
uS
uS
uS
WS
uS
uS
uS
uS
uS
uS
uS
uS
uS
ka
iI
YD
NP
NP
YD
NP
NP
NP
"}
(46,1,1) = {"
FB
FB
FB
FB
uD
uD
YD
NP
UA
uS
uS
uS
uS
uS
uS
uS
uS
uS
uS
uS
uS
uS
uS
uS
Cr
FZ
NP
NP
NP
Zc
NP
NP
NP
"}
(47,1,1) = {"
FB
FB
FB
FB
uD
NP
NP
NP
UA
uS
uS
uS
uS
lb
uS
uS
uS
uS
uS
lb
uS
uS
uS
uS
Rk
NP
NP
NP
NP
NP
NP
NP
NP
"}
(48,1,1) = {"
FB
FB
FB
FB
uD
NP
NP
NP
RB
eZ
uS
uS
uS
uS
uS
ns
uS
uS
uS
uS
uS
uS
uS
aR
FZ
ar
NP
NP
NP
NP
NP
NP
NP
"}
(49,1,1) = {"
FB
FB
FB
FB
uD
NP
NP
NP
NP
UA
uS
uS
uS
uS
uS
uS
uS
uS
uS
uS
uS
uS
uS
Rk
NP
YD
ar
NP
YD
NP
NP
NP
ar
"}
(50,1,1) = {"
FB
FB
FB
FB
FB
NP
YD
NP
NP
UA
uS
uS
uS
uS
uS
uS
uS
uS
uS
uS
aR
ly
ly
FZ
NP
tH
NP
NP
uD
uD
NP
iX
NP
"}
(51,1,1) = {"
FB
FB
FB
FB
FB
NP
ar
NP
NP
UA
uS
lb
uS
uS
uS
uS
uS
aR
ly
ly
FZ
NP
NP
NP
YD
NP
NP
NP
uD
uD
NP
NP
NP
"}
(52,1,1) = {"
FB
FB
FB
FB
FB
ar
NP
NP
NP
UA
eZ
uS
uS
uS
uS
uS
uS
Rk
NP
NP
NP
YD
NP
xG
NP
NP
NP
NP
NP
NP
NP
NP
FB
"}
(53,1,1) = {"
FB
FB
FB
FB
FB
NP
NP
tH
NP
RB
ly
ly
ly
ly
ly
ly
ly
FZ
NP
xG
NP
NP
NP
NP
uD
uD
NP
YD
NP
NP
NP
NP
FB
"}
(54,1,1) = {"
FB
FB
FB
FB
FB
NP
YD
NP
NP
NP
NP
NP
NP
NP
NP
NP
NP
NP
NP
NP
NP
NP
NP
NP
uD
uD
NP
NP
NP
NP
YD
NP
FB
"}
(55,1,1) = {"
FB
FB
FB
FB
FB
NP
NP
NP
NP
YD
NP
NP
NP
NP
NP
NP
YD
NP
NP
NP
YD
NP
NP
YD
NP
NP
NP
NP
NP
NP
NP
NP
FB
"}
(56,1,1) = {"
FB
FB
FB
FB
FB
NP
NP
NP
uD
uD
NP
NP
YD
NP
NP
NP
NP
NP
uD
uD
NP
NP
NP
NP
NP
NP
ar
NP
NP
NP
NP
ar
FB
"}
(57,1,1) = {"
FB
FB
FB
FB
FB
NP
NP
NP
uD
uD
NP
ar
NP
NP
NP
NP
ar
NP
uD
uD
NP
NP
NP
NP
NP
ar
NP
uD
NP
NP
NP
NP
FB
"}
(58,1,1) = {"
FB
FB
FB
FB
FB
ar
NP
YD
NP
NP
ar
NP
NP
NP
NP
NP
NP
NP
NP
NP
NP
NP
NP
NP
NP
NP
NP
NP
NP
uD
uD
FB
FB
"}
(59,1,1) = {"
FB
FB
FB
FB
FB
FB
NP
NP
NP
YD
NP
NP
NP
uD
uD
NP
NP
NP
NP
NP
NP
NP
uD
uD
uD
NP
NP
NP
uD
uD
FB
FB
FB
"}
(60,1,1) = {"
FB
FB
FB
FB
FB
FB
NP
NP
NP
NP
NP
NP
NP
uD
uD
NP
NP
NP
NP
NP
NP
YD
uD
uD
uD
NP
NP
zc
uD
FB
FB
FB
FB
"}
(61,1,1) = {"
FB
FB
FB
FB
FB
FB
NP
NP
NP
NP
NP
NP
NP
YD
NP
NP
NP
YD
uD
uD
NP
NP
NP
NP
NP
NP
uD
uD
FB
FB
FB
FB
FB
"}
(62,1,1) = {"
FB
FB
FB
FB
FB
FB
FB
NP
NP
NP
Zc
NP
NP
NP
NP
NP
NP
NP
uD
uD
NP
NP
NP
NP
NP
NP
uD
FB
FB
FB
FB
FB
FB
"}
(63,1,1) = {"
FB
FB
FB
FB
FB
FB
FB
NP
NP
NP
uD
NP
NP
NP
NP
NP
NP
NP
NP
NP
NP
NP
NP
NP
NP
NP
FB
FB
FB
FB
FB
FB
FB
"}
(64,1,1) = {"
FB
FB
FB
FB
FB
FB
FB
FB
NP
NP
YD
NP
NP
ar
NP
NP
ar
NP
NP
NP
NP
ar
NP
NP
NP
ar
FB
FB
FB
FB
FB
FB
FB
"}
(65,1,1) = {"
FB
FB
FB
FB
FB
FB
FB
FB
NP
NP
NP
NP
NP
NP
NP
NP
FB
FB
NP
NP
YD
NP
NP
NP
YD
NP
FB
FB
FB
FB
FB
FB
FB
"}
(66,1,1) = {"
FB
FB
FB
FB
FB
FB
FB
FB
FB
NP
NP
NP
NP
YD
NP
FB
FB
FB
FB
NP
NP
NP
NP
NP
NP
NP
FB
FB
DA
DA
DA
DA
FB
"}
(67,1,1) = {"
FB
FB
FB
FB
FB
FB
FB
FB
FB
NP
NP
NP
NP
NP
NP
FB
FB
FB
FB
uD
uD
NP
NP
NP
NP
NP
FB
FB
DA
DA
DA
DA
FB
"}
(68,1,1) = {"
FB
FB
FB
FB
FB
FB
FB
FB
FB
NP
NP
YD
NP
NP
FB
FB
FB
FB
FB
FB
uD
NP
NP
NP
NP
NP
FB
FB
DA
DA
DA
DA
FB
"}
(69,1,1) = {"
FB
FB
FB
FB
FB
FB
FB
FB
FB
FB
NP
NP
NP
NP
FB
FB
FB
FB
FB
FB
uD
NP
NP
YD
NP
NP
FB
FB
FB
FB
FB
FB
FB
"}
(70,1,1) = {"
FB
FB
FB
FB
FB
FB
FB
FB
FB
FB
NP
NP
NP
NP
FB
FB
FB
FB
FB
FB
FB
NP
NP
NP
NP
NP
FB
FB
DA
DA
DA
DA
FB
"}
(71,1,1) = {"
DA
DA
DA
DA
FB
DA
DA
DA
DA
FB
NP
NP
NP
NP
NP
FB
FB
FB
FB
FB
FB
NP
NP
NP
NP
NP
FB
FB
DA
DA
DA
DA
FB
"}
(72,1,1) = {"
DA
DA
DA
DA
FB
DA
DA
DA
DA
FB
bS
zx
bS
bS
bS
FB
FB
FB
FB
FB
FB
ye
bS
zx
bS
bS
FB
FB
DA
DA
DA
DA
FB
"}
(73,1,1) = {"
DA
DA
DA
DA
FB
DA
DA
DA
DA
FB
HI
HI
HI
jP
HI
FB
FB
FB
FB
FB
jP
HI
HI
HI
HI
jP
FB
FB
FB
FB
FB
FB
FB
"}
(74,1,1) = {"
DA
DA
DA
DA
FB
DA
DA
DA
DA
FB
sv
HI
jD
HI
sv
FB
FB
FB
FB
FB
HI
HI
HI
FB
FB
FB
FB
qQ
Pr
Ap
BT
EG
Pr
"}
(75,1,1) = {"
FB
FB
FB
FB
FB
FB
FB
FB
FB
FB
sv
HI
Vq
HI
sv
FB
FB
FB
FB
HI
HI
HI
HI
HI
FB
FB
FB
zr
rR
KT
kq
xw
rR
"}
(76,1,1) = {"
DA
DA
DA
DA
FB
DA
DA
DA
DA
FB
sv
HI
HI
HI
sv
sv
FB
FB
HI
HI
HI
Vq
HI
HI
FB
FB
FB
zr
rR
bt
hO
Du
oz
"}
(77,1,1) = {"
DA
DA
DA
DA
FB
DA
DA
DA
DA
FB
sv
sv
HI
HI
HI
sv
FB
HI
HI
HI
HI
HI
HI
FB
FB
FB
FB
zr
rR
Al
Dh
rS
oz
"}
(78,1,1) = {"
DA
DA
DA
DA
FB
DA
DA
DA
DA
FB
FB
sv
sv
HI
HI
HI
HI
HI
HI
Vq
HI
HI
FB
FB
FB
FB
FB
zr
rR
Fa
kq
Se
oz
"}
(79,1,1) = {"
FB
FB
FB
FB
FB
FB
FB
FB
FB
FB
FB
FB
sv
jP
HI
HI
Vq
HI
HI
HI
HI
HI
FB
FB
FB
FB
FB
zr
rR
Qk
My
Qk
oz
"}
(80,1,1) = {"
DA
DA
DA
DA
FB
DA
DA
DA
DA
FB
FB
FB
FB
HI
jP
HI
HI
HI
HI
HI
HI
HI
bS
HI
FB
FB
FB
zr
FB
sG
sG
sG
sG
"}
