//MAP CONVERTED BY dmm2tgm.py THIS HEADER COMMENT PREVENTS RECONVERSION, DO NOT REMOVE
"aK" = (
/obj/effect/landmark/weed_node,
/turf/open/floor/plating/ground/dirt,
/area/lv624/ground/caves/central2)
"co" = (
/turf/open/floor,
/area/lv624/ground/caves/central1)
"dO" = (
/obj/effect/landmark/weed_node,
/obj/effect/landmark/xeno_resin_door,
/turf/open/floor/plating/ground/dirt,
/area/lv624/ground/caves/central2)
"dV" = (
/obj/effect/ai_node,
/turf/open/floor/plating/ground/dirt,
/area/lv624/ground/caves/central2)
"fb" = (
/turf/closed/mineral/smooth,
/area/lv624/ground/caves/central1)
"gv" = (
/obj/machinery/miner/damaged/platinum,
/turf/open/floor/plating/ground/dirt,
/area/lv624/ground/caves/central2)
"hn" = (
/obj/structure/rack,
/obj/effect/landmark/lv624/fog_blocker/xeno_spawn,
/turf/open/floor/tile/vault{
	dir = 8
	},
/area/lv624/ground/caves/central1)
"hY" = (
/turf/open/floor/plating/ground/dirt,
/area/lv624/ground/caves/central2)
"jw" = (
/obj/structure/rack,
/obj/item/stack/sheet/mineral/diamond{
	amount = 2
	},
/turf/open/floor/tile/vault{
	dir = 8
	},
/area/lv624/ground/caves/central1)
"km" = (
/obj/structure/rack,
/obj/item/stack/sheet/mineral/silver{
	amount = 20
	},
/turf/open/floor/tile/vault{
	dir = 8
	},
/area/lv624/ground/caves/central1)
"qE" = (
/obj/effect/landmark/excavation_site_spawner,
/turf/open/floor/plating/ground/dirt,
/area/lv624/ground/caves/central2)
"rO" = (
/obj/structure/rack,
/turf/open/floor/tile/vault{
	dir = 8
	},
/area/lv624/ground/caves/central1)
"ty" = (
/obj/structure/rack,
/obj/item/stack/sheet/mineral/gold{
	amount = 2
	},
/obj/item/stack/sheet/mineral/platinum{
	pixel_x = -6
	},
/turf/open/floor/tile/vault{
	dir = 8
	},
/area/lv624/ground/caves/central1)
"tU" = (
/obj/effect/landmark/weed_node,
/turf/open/floor/tile/dark,
/area/lv624/ground/caves/central1)
"uC" = (
/obj/effect/landmark/lv624/fog_blocker,
/obj/effect/landmark/lv624/fog_blocker/xeno_spawn,
/turf/closed/mineral/smooth,
/area/lv624/ground/caves/rock)
"vC" = (
/obj/effect/landmark/weed_node,
/obj/effect/ai_node,
/turf/open/floor/plating/ground/dirt,
/area/lv624/ground/caves/central2)
"wP" = (
/obj/structure/rack,
/obj/item/stack/sheet/mineral/iron{
	amount = 5
	},
/obj/item/stack/sheet/mineral/platinum,
/obj/machinery/light{
	dir = 8
	},
/obj/effect/landmark/lv624/fog_blocker/xeno_spawn,
/turf/open/floor/tile/vault{
	dir = 8
	},
/area/lv624/ground/caves/central1)
"yv" = (
/turf/closed/wall/r_wall,
/area/lv624/ground/caves/rock)
"yD" = (
/turf/open/floor/tile/dark,
/area/lv624/ground/caves/central1)
"yX" = (
/obj/effect/ai_node,
/turf/open/floor/tile/dark,
/area/lv624/ground/caves/central1)
"ze" = (
/obj/structure/flora/ausbushes/fullgrass,
/turf/open/floor/plating/ground/dirt,
/area/lv624/ground/caves/central2)
"zr" = (
/obj/effect/landmark/xeno_resin_door,
/obj/effect/ai_node,
/turf/open/floor/plating/ground/dirt,
/area/lv624/ground/caves/central2)
"AO" = (
/turf/closed/mineral/smooth,
/area/lv624/ground/caves/rock)
"AR" = (
/obj/structure/rack,
/obj/item/tool/pickaxe,
/turf/open/floor/tile/vault{
	dir = 8
	},
/area/lv624/ground/caves/central1)
"AV" = (
/obj/effect/landmark/xeno_resin_door,
/turf/open/floor/plating/ground/dirt,
/area/lv624/ground/caves/central2)
"Dm" = (
/obj/effect/landmark/lv624/fog_blocker/xeno_spawn,
/turf/closed/wall/r_wall,
/area/lv624/ground/caves/rock)
"Eg" = (
/obj/structure/rack,
/obj/item/stack/sheet/mineral/tritium{
	pixel_x = -4
	},
/turf/open/floor/tile/vault{
	dir = 8
	},
/area/lv624/ground/caves/central1)
"EQ" = (
/turf/open/floor/plating/ground/dirt,
/area/lv624/ground/caves/central3)
"EX" = (
/obj/structure/rack,
/obj/item/tool/shovel,
/obj/effect/landmark/lv624/fog_blocker/xeno_spawn,
/turf/open/floor/tile/vault{
	dir = 8
	},
/area/lv624/ground/caves/central1)
"EY" = (
/obj/structure/flora/ausbushes/fullgrass,
/obj/effect/landmark/weed_node,
/turf/open/floor/plating/ground/dirt,
/area/lv624/ground/caves/central2)
"GX" = (
/turf/closed/wall,
/area/lv624/ground/caves/central1)
"Ka" = (
/turf/closed/mineral/smooth/indestructible,
/area/lv624/ground/caves/rock)
"KA" = (
/obj/effect/landmark/lv624/fog_blocker,
/turf/closed/mineral/smooth,
/area/lv624/ground/caves/rock)
"MM" = (
/obj/effect/landmark/xeno_resin_wall,
/turf/open/floor/plating/ground/dirt,
/area/lv624/ground/caves/central2)
"NC" = (
/turf/closed/wall/r_wall,
/area/lv624/ground/caves/central1)
"Uf" = (
/obj/structure/rack,
/obj/item/stack/sheet/metal{
	amount = 50;
	pixel_x = 4;
	pixel_y = 4
	},
/obj/item/stack/sheet/metal{
	amount = 30
	},
/turf/open/floor/tile/vault{
	dir = 8
	},
/area/lv624/ground/caves/central1)
"Xi" = (
/obj/machinery/door/airlock/mainship/secure/locked/free_access{
	dir = 4;
	name = "\improper Mining Storage"
	},
/turf/open/floor/tile/dark,
/area/lv624/ground/caves/central1)
"XP" = (
/obj/structure/rack,
/obj/item/tool/shovel,
/turf/open/floor/tile/vault{
	dir = 8
	},
/area/lv624/ground/caves/central1)

(1,1,1) = {"
AO
AO
AO
AO
AO
AO
AO
AO
AO
AO
AV
AV
AV
AV
AV
AO
AO
AO
AO
AO
AO
AO
AO
AO
AO
AO
AO
EQ
EQ
EQ
EQ
EQ
EQ
"}
(2,1,1) = {"
AO
AO
AO
AO
AO
AO
AO
AO
AO
AO
hY
hY
hY
hY
hY
AO
AO
AO
AO
AO
AO
AO
AO
AO
AO
AO
AO
AO
AO
AO
AO
AO
EQ
"}
(3,1,1) = {"
AO
AO
AO
AO
AO
AO
AO
AO
AO
AO
hY
hY
aK
hY
hY
hY
aK
hY
hY
AO
AO
AO
AO
AO
AO
AO
Ka
Ka
Ka
Ka
Ka
AO
AO
"}
(4,1,1) = {"
AO
AO
AO
AO
AO
AO
AO
MM
MM
MM
hY
hY
hY
hY
hY
hY
hY
hY
hY
hY
hY
hY
AO
AO
AO
AO
Ka
Ka
Ka
Ka
Ka
AO
AO
"}
(5,1,1) = {"
AO
AO
AO
AO
AO
AO
AO
MM
hY
hY
hY
dV
hY
hY
hY
hY
hY
hY
dV
hY
hY
dV
hY
AO
AO
AO
Ka
Ka
Ka
Ka
Ka
AO
AO
"}
(6,1,1) = {"
AO
AO
AO
AO
AO
AO
MM
MM
hY
aK
hY
hY
aK
hY
hY
hY
hY
aK
hY
hY
hY
aK
hY
MM
AO
AO
AO
AO
AO
AO
AO
AO
AO
"}
(7,1,1) = {"
AO
AO
AO
AO
AO
AO
MM
hY
hY
hY
hY
hY
hY
hY
hY
hY
MM
MM
hY
hY
hY
hY
hY
MM
AO
AO
AO
AO
AO
AO
AO
AO
AO
"}
(8,1,1) = {"
AO
AO
AO
AO
AO
MM
MM
hY
hY
hY
hY
hY
MM
MM
aK
hY
MM
MM
hY
hY
hY
hY
hY
MM
MM
AO
Ka
Ka
Ka
Ka
Ka
AO
AO
"}
(9,1,1) = {"
AO
AO
AO
AO
AO
MM
hY
hY
hY
aK
hY
hY
MM
MM
hY
hY
hY
hY
hY
aK
hY
aK
hY
hY
MM
AO
Ka
Ka
Ka
Ka
Ka
AO
AO
"}
(10,1,1) = {"
AO
AO
AO
AO
AO
MM
aK
hY
hY
qE
hY
hY
hY
hY
hY
aK
hY
hY
hY
hY
hY
hY
hY
hY
AO
AO
Ka
Ka
Ka
Ka
Ka
AO
AO
"}
(11,1,1) = {"
AO
AO
AO
AO
AO
MM
hY
hY
hY
hY
hY
aK
hY
hY
hY
hY
hY
hY
hY
hY
hY
hY
hY
hY
AO
AO
AO
AO
AO
AO
AO
AO
AO
"}
(12,1,1) = {"
AO
AO
AO
AO
AO
MM
dV
hY
hY
hY
hY
dV
hY
ze
hY
dV
hY
hY
dV
hY
aK
dV
hY
hY
AO
AO
AO
AO
AO
AO
AO
AO
AO
"}
(13,1,1) = {"
AO
AO
AO
AO
AO
MM
hY
hY
hY
EY
hY
hY
hY
aK
hY
hY
MM
MM
MM
MM
hY
hY
hY
hY
AO
AO
Ka
Ka
Ka
Ka
Ka
AO
AO
"}
(14,1,1) = {"
AO
AO
AO
AO
MM
MM
hY
hY
hY
hY
hY
AO
AO
hY
hY
hY
MM
AO
AO
AO
AV
AV
AV
AO
AO
AO
Ka
Ka
Ka
Ka
Ka
AO
AO
"}
(15,1,1) = {"
AO
AO
AO
MM
MM
hY
hY
hY
hY
hY
AO
AO
AO
AV
AV
AV
AO
AO
AO
AO
hY
hY
hY
AO
AO
AO
Ka
Ka
Ka
Ka
Ka
AO
AO
"}
(16,1,1) = {"
AO
AO
AO
MM
hY
aK
hY
ze
hY
AO
AO
AO
hY
aK
hY
hY
AO
AO
AO
hY
hY
hY
hY
MM
AO
AO
AO
AO
AO
AO
AO
AO
AO
"}
(17,1,1) = {"
AO
AO
AO
MM
hY
hY
hY
hY
hY
AO
AO
AO
hY
hY
hY
hY
hY
AO
AO
hY
aK
hY
hY
MM
MM
AO
AO
AO
AO
AO
AO
AO
AO
"}
(18,1,1) = {"
AO
AO
AO
MM
hY
hY
aK
hY
AO
AO
AO
AO
hY
hY
hY
dV
hY
hY
hY
hY
hY
hY
hY
hY
MM
MM
MM
MM
AO
AO
Ka
Ka
Ka
"}
(19,1,1) = {"
AO
AO
AO
MM
hY
hY
hY
hY
AO
AO
AO
MM
hY
hY
MM
MM
dV
hY
hY
hY
hY
dV
hY
hY
hY
hY
hY
MM
MM
AO
Ka
Ka
Ka
"}
(20,1,1) = {"
AO
AO
MM
MM
hY
hY
dV
hY
AO
AO
AO
AO
hY
hY
MM
MM
hY
aK
hY
gv
hY
hY
dV
hY
hY
aK
hY
hY
MM
AO
Ka
Ka
Ka
"}
(21,1,1) = {"
AO
AO
MM
hY
hY
dV
hY
MM
AO
AO
AO
AO
AO
hY
hY
hY
hY
hY
hY
hY
aK
hY
hY
dV
hY
hY
dV
aK
MM
AO
AO
AO
AO
"}
(22,1,1) = {"
AO
MM
MM
EY
hY
hY
MM
MM
AO
AO
AO
AO
AO
aK
hY
hY
hY
hY
MM
MM
hY
hY
hY
hY
hY
hY
hY
hY
MM
AO
AO
AO
AO
"}
(23,1,1) = {"
AO
MM
hY
hY
hY
hY
MM
AO
AO
AO
AO
AO
AO
hY
hY
hY
dV
MM
AO
AO
MM
MM
MM
MM
aK
hY
aK
hY
hY
MM
AO
AO
AO
"}
(24,1,1) = {"
AO
MM
hY
hY
hY
hY
MM
AO
AO
AO
AO
AO
AO
AO
hY
hY
hY
MM
AO
AO
AO
MM
AO
AO
hY
hY
hY
hY
hY
MM
AO
AO
AO
"}
(25,1,1) = {"
AO
MM
hY
hY
hY
hY
MM
AO
AO
AO
AO
AO
AO
AO
hY
aK
hY
AO
AO
AO
AO
AO
AO
AO
hY
hY
hY
hY
aK
hY
MM
AO
AO
"}
(26,1,1) = {"
AO
MM
aK
hY
gv
hY
aK
AO
AO
AO
AO
AO
AO
MM
hY
hY
hY
AO
AO
AO
AO
AO
AO
hY
hY
hY
hY
hY
hY
hY
MM
AO
AO
"}
(27,1,1) = {"
AO
MM
hY
hY
hY
hY
ze
AO
AO
AO
AO
AO
MM
MM
hY
hY
hY
MM
AO
AO
AO
AO
AO
hY
hY
aK
dV
hY
hY
MM
AO
AO
AO
"}
(28,1,1) = {"
AO
MM
hY
hY
hY
hY
hY
MM
AO
AO
AO
AO
MM
hY
hY
hY
hY
MM
AO
AO
AO
AO
hY
hY
hY
hY
hY
hY
hY
MM
AO
AO
AO
"}
(29,1,1) = {"
AO
MM
hY
hY
hY
hY
hY
AO
AO
AO
AO
AO
MM
hY
hY
aK
hY
hY
MM
AO
AO
hY
hY
hY
hY
hY
hY
hY
MM
AO
AO
AO
AO
"}
(30,1,1) = {"
AO
MM
aK
ze
hY
hY
aK
hY
AO
AO
AO
MM
MM
hY
hY
hY
qE
hY
hY
hY
hY
hY
aK
hY
MM
MM
aK
hY
MM
AO
AO
AO
AO
"}
(31,1,1) = {"
AO
MM
hY
hY
hY
dV
hY
hY
AO
AO
AO
MM
hY
hY
hY
hY
hY
hY
MM
MM
hY
hY
hY
hY
MM
MM
hY
hY
MM
AO
AO
AO
AO
"}
(32,1,1) = {"
AO
MM
hY
hY
hY
hY
dV
hY
AO
AO
AO
MM
hY
aK
MM
MM
hY
aK
MM
MM
hY
hY
hY
hY
hY
hY
hY
hY
MM
AO
AO
AO
AO
"}
(33,1,1) = {"
AO
MM
hY
hY
hY
ze
hY
hY
AO
AO
hY
hY
hY
hY
MM
MM
dV
hY
hY
hY
hY
hY
aK
hY
dV
hY
dV
hY
AO
AO
AO
AO
AO
"}
(34,1,1) = {"
AO
MM
aK
hY
hY
hY
aK
hY
hY
AO
hY
hY
hY
hY
hY
hY
hY
hY
hY
AO
AO
hY
hY
hY
hY
hY
hY
hY
AO
Ka
Ka
AO
AO
"}
(35,1,1) = {"
AO
MM
hY
hY
hY
hY
hY
hY
hY
AV
hY
MM
MM
hY
hY
hY
hY
AO
AO
AO
AO
hY
hY
hY
aK
hY
hY
hY
AO
Ka
Ka
AO
AO
"}
(36,1,1) = {"
AO
MM
aK
hY
hY
hY
hY
hY
hY
AV
hY
MM
MM
dV
aK
hY
dV
AO
AO
AO
AO
AO
AO
hY
hY
hY
hY
aK
AO
Ka
Ka
AO
AO
"}
(37,1,1) = {"
AO
MM
hY
hY
hY
hY
hY
hY
hY
AV
hY
hY
hY
hY
hY
hY
AO
AO
AO
AO
AO
AO
AO
hY
hY
hY
hY
hY
AO
Ka
Ka
AO
AO
"}
(38,1,1) = {"
AO
MM
hY
hY
hY
hY
vC
hY
ze
AV
aK
hY
hY
dV
aK
hY
AO
AO
AO
AO
AO
AO
AO
AO
vC
hY
hY
hY
AO
Ka
Ka
AO
Ka
"}
(39,1,1) = {"
AO
MM
aK
hY
hY
hY
hY
hY
AO
AO
AO
AO
AO
hY
hY
hY
AO
AO
AO
AO
AO
AO
AO
AO
hY
dV
hY
hY
AO
Ka
Ka
AO
Ka
"}
(40,1,1) = {"
AO
MM
hY
hY
hY
hY
hY
AO
AO
AO
AO
AO
AO
AV
AV
AV
AO
AO
AO
AO
AO
AO
AO
AO
AV
AV
AV
AV
AO
AO
AO
AO
Ka
"}
(41,1,1) = {"
AO
AO
hY
hY
hY
hY
hY
AO
AO
AO
AO
AO
hY
hY
hY
hY
hY
AO
hY
hY
AO
AO
hY
hY
hY
aK
hY
hY
MM
AO
AO
AO
AO
"}
(42,1,1) = {"
AO
AO
hY
aK
hY
hY
vC
MM
AO
AO
AO
AO
hY
hY
hY
hY
hY
hY
hY
hY
hY
hY
hY
hY
hY
hY
hY
ze
MM
AO
AO
AO
AO
"}
(43,1,1) = {"
AO
AO
AO
hY
hY
hY
ze
MM
AO
AO
AO
AO
hY
hY
hY
aK
hY
hY
hY
hY
aK
hY
hY
hY
hY
hY
ze
hY
hY
MM
AO
MM
hY
"}
(44,1,1) = {"
AO
AO
AO
hY
hY
hY
hY
hY
MM
AO
AO
AO
hY
hY
hY
hY
hY
MM
MM
hY
hY
hY
hY
hY
hY
hY
hY
hY
hY
hY
hY
hY
hY
"}
(45,1,1) = {"
AO
AO
AO
hY
hY
hY
hY
hY
MM
AO
AO
AO
hY
hY
hY
hY
hY
MM
MM
hY
hY
hY
hY
hY
hY
aK
MM
MM
hY
aK
hY
aK
hY
"}
(46,1,1) = {"
AO
AO
AO
AO
hY
hY
aK
hY
hY
AO
AO
AO
MM
hY
hY
hY
hY
hY
hY
hY
aK
hY
MM
MM
hY
hY
MM
MM
hY
qE
hY
hY
hY
"}
(47,1,1) = {"
AO
AO
AO
AO
hY
hY
hY
hY
hY
MM
AO
AO
AO
MM
MM
hY
aK
hY
hY
hY
hY
hY
MM
MM
hY
hY
hY
hY
hY
hY
hY
hY
hY
"}
(48,1,1) = {"
AO
AO
AO
AO
hY
hY
hY
hY
hY
MM
AO
AO
AO
AO
MM
hY
hY
hY
hY
hY
hY
hY
hY
hY
hY
dV
hY
hY
hY
hY
hY
hY
hY
"}
(49,1,1) = {"
AO
AO
AO
AO
hY
hY
hY
hY
hY
MM
AO
AO
AO
AO
MM
MM
hY
hY
hY
aK
hY
hY
hY
hY
hY
aK
dV
hY
aK
hY
hY
hY
dV
"}
(50,1,1) = {"
AO
AO
AO
AO
AO
hY
aK
hY
hY
MM
AO
AO
AO
AO
AO
MM
MM
hY
hY
hY
hY
hY
hY
hY
hY
gv
hY
hY
MM
MM
hY
vC
hY
"}
(51,1,1) = {"
AO
AO
AO
AO
AO
hY
dV
hY
hY
hY
MM
AO
AO
AO
AO
AO
MM
MM
hY
hY
hY
hY
hY
hY
aK
hY
hY
hY
MM
MM
hY
hY
hY
"}
(52,1,1) = {"
AO
AO
AO
AO
AO
dV
hY
hY
hY
hY
MM
AO
AO
AO
AO
AO
AO
MM
MM
hY
hY
aK
hY
ze
hY
hY
hY
hY
hY
hY
hY
hY
AO
"}
(53,1,1) = {"
AO
AO
AO
AO
AO
hY
hY
gv
hY
hY
hY
hY
AO
AO
AO
AO
AO
AO
MM
ze
hY
hY
hY
hY
hY
hY
hY
aK
hY
hY
hY
hY
AO
"}
(54,1,1) = {"
AO
AO
AO
AO
AO
hY
aK
hY
hY
hY
hY
hY
hY
AO
AO
AO
AO
AO
AO
hY
hY
hY
hY
hY
hY
hY
hY
hY
hY
hY
aK
hY
AO
"}
(55,1,1) = {"
AO
AO
AO
AO
AO
hY
hY
hY
hY
aK
hY
hY
hY
hY
AO
AO
AO
AO
AO
hY
aK
hY
hY
aK
hY
hY
hY
hY
hY
hY
hY
hY
AO
"}
(56,1,1) = {"
AO
AO
AO
AO
AO
hY
hY
hY
hY
hY
hY
hY
aK
hY
hY
AO
AO
AO
AO
AV
AV
AO
hY
hY
hY
hY
dV
hY
hY
hY
hY
dV
AO
"}
(57,1,1) = {"
AO
AO
AO
AO
AO
hY
hY
hY
hY
hY
hY
dV
hY
hY
hY
hY
dV
hY
hY
hY
hY
AO
AO
hY
hY
dV
hY
hY
hY
hY
hY
AO
AO
"}
(58,1,1) = {"
AO
AO
AO
AO
AO
dV
hY
aK
hY
hY
dV
hY
hY
hY
hY
hY
hY
hY
hY
hY
hY
AO
AO
AO
AO
hY
hY
hY
hY
hY
AO
AO
AO
"}
(59,1,1) = {"
AO
AO
AO
AO
AO
AO
hY
hY
hY
aK
hY
hY
MM
MM
hY
hY
hY
hY
hY
hY
hY
hY
AO
AO
AO
AO
AV
AV
AV
AV
AO
AO
AO
"}
(60,1,1) = {"
AO
AO
AO
AO
AO
AO
hY
hY
hY
hY
hY
hY
MM
MM
hY
hY
hY
hY
MM
MM
hY
aK
hY
AO
AO
AO
hY
aK
hY
AO
AO
AO
AO
"}
(61,1,1) = {"
AO
AO
AO
AO
AO
AO
AO
hY
hY
hY
hY
hY
hY
aK
hY
hY
hY
aK
MM
MM
hY
hY
hY
hY
hY
hY
hY
hY
AO
AO
AO
AO
AO
"}
(62,1,1) = {"
AO
AO
AO
AO
AO
AO
AO
hY
hY
hY
qE
hY
hY
hY
hY
hY
hY
hY
hY
hY
hY
hY
hY
hY
hY
hY
hY
AO
AO
AO
AO
AO
AO
"}
(63,1,1) = {"
AO
AO
AO
AO
AO
AO
AO
hY
hY
hY
hY
hY
hY
hY
hY
hY
hY
hY
hY
hY
hY
hY
hY
hY
hY
hY
AO
AO
AO
AO
AO
AO
AO
"}
(64,1,1) = {"
AO
AO
AO
AO
AO
AO
AO
AO
hY
hY
vC
hY
hY
dV
hY
hY
dV
hY
hY
hY
hY
dV
hY
hY
hY
dV
AO
AO
AO
AO
AO
AO
AO
"}
(65,1,1) = {"
AO
AO
AO
AO
AO
AO
AO
AO
hY
hY
hY
hY
hY
hY
hY
MM
AO
AO
MM
hY
aK
hY
hY
hY
aK
hY
AO
AO
AO
AO
AO
AO
AO
"}
(66,1,1) = {"
AO
AO
AO
AO
AO
AO
AO
AO
AO
hY
MM
MM
hY
aK
MM
AO
AO
AO
AO
MM
hY
hY
MM
MM
hY
hY
AO
AO
Ka
Ka
Ka
Ka
AO
"}
(67,1,1) = {"
AO
AO
AO
AO
AO
AO
AO
AO
AO
hY
MM
MM
hY
hY
MM
AO
AO
AO
AO
MM
hY
hY
MM
MM
hY
hY
AO
AO
Ka
Ka
Ka
Ka
AO
"}
(68,1,1) = {"
AO
AO
AO
AO
AO
AO
AO
AO
AO
hY
hY
aK
hY
hY
AO
AO
AO
AO
AO
AO
MM
hY
hY
hY
hY
hY
AO
AO
Ka
Ka
Ka
Ka
AO
"}
(69,1,1) = {"
AO
AO
AO
AO
AO
AO
AO
AO
AO
AO
hY
hY
hY
hY
AO
AO
AO
AO
AO
AO
MM
hY
hY
aK
hY
hY
AO
AO
AO
AO
AO
AO
AO
"}
(70,1,1) = {"
AO
AO
AO
AO
AO
AO
AO
AO
AO
AO
hY
hY
hY
hY
AO
AO
AO
AO
AO
AO
AO
hY
hY
hY
hY
hY
AO
AO
Ka
Ka
Ka
Ka
AO
"}
(71,1,1) = {"
Ka
Ka
Ka
Ka
AO
Ka
Ka
Ka
Ka
AO
hY
hY
hY
hY
hY
AO
AO
AO
AO
AO
AO
hY
hY
hY
hY
hY
AO
AO
Ka
Ka
Ka
Ka
AO
"}
(72,1,1) = {"
Ka
Ka
Ka
Ka
AO
Ka
Ka
Ka
Ka
AO
AV
dO
AV
AV
AV
AO
AO
AO
AO
AO
AO
zr
AV
dO
AV
AV
AO
AO
Ka
Ka
Ka
Ka
AO
"}
(73,1,1) = {"
Ka
Ka
Ka
Ka
AO
Ka
Ka
Ka
Ka
AO
hY
hY
hY
dV
hY
AO
AO
AO
AO
AO
dV
hY
hY
hY
hY
dV
AO
AO
AO
AO
AO
AO
AO
"}
(74,1,1) = {"
Ka
Ka
Ka
Ka
AO
Ka
Ka
Ka
Ka
AO
hY
hY
qE
hY
hY
AO
AO
AO
AO
AO
hY
hY
hY
AO
AO
AO
AO
uC
Dm
EX
wP
hn
Dm
"}
(75,1,1) = {"
AO
AO
AO
AO
AO
AO
AO
AO
AO
AO
hY
hY
aK
hY
hY
AO
AO
AO
AO
hY
hY
hY
hY
hY
AO
AO
AO
KA
yv
ty
yD
Eg
yv
"}
(76,1,1) = {"
Ka
Ka
Ka
Ka
AO
Ka
Ka
Ka
Ka
AO
hY
hY
hY
hY
hY
hY
AO
AO
hY
hY
hY
aK
hY
hY
AO
AO
AO
KA
yv
jw
yX
km
NC
"}
(77,1,1) = {"
Ka
Ka
Ka
Ka
AO
Ka
Ka
Ka
Ka
AO
hY
hY
hY
hY
hY
hY
AO
hY
hY
hY
hY
hY
hY
AO
AO
AO
AO
KA
yv
Uf
tU
rO
NC
"}
(78,1,1) = {"
Ka
Ka
Ka
Ka
AO
Ka
Ka
Ka
Ka
AO
AO
hY
hY
hY
hY
hY
hY
hY
hY
aK
hY
hY
AO
AO
AO
AO
AO
KA
yv
XP
yD
AR
NC
"}
(79,1,1) = {"
AO
AO
AO
AO
AO
AO
AO
AO
AO
AO
AO
AO
hY
dV
hY
hY
aK
hY
hY
hY
hY
hY
AO
AO
AO
AO
AO
KA
NC
GX
Xi
GX
NC
"}
(80,1,1) = {"
Ka
Ka
Ka
Ka
AO
Ka
Ka
Ka
Ka
AO
AO
AO
AO
hY
dV
hY
hY
hY
hY
hY
hY
hY
AV
hY
AO
AO
AO
KA
fb
co
co
co
co
"}
