//MAP CONVERTED BY dmm2tgm.py THIS HEADER COMMENT PREVENTS RECONVERSION, DO NOT REMOVE
"co" = (
/turf/open/floor,
/area/lv624/ground/caves/central1)
"gv" = (
/obj/machinery/miner/damaged/platinum,
/turf/open/floor/plating/ground/dirt,
/area/lv624/ground/caves/central2)
"hY" = (
/turf/open/floor/plating/ground/dirt,
/area/lv624/ground/caves/central2)
"iT" = (
/obj/effect/landmark/xeno_resin_wall,
/turf/open/floor/plating/ground/dirt,
/area/lv624/ground/caves/central2)
"jw" = (
/obj/structure/rack,
/obj/item/stack/sheet/mineral/diamond{
	amount = 2
	},
/turf/open/floor/tile/vault{
	dir = 8
	},
/area/lv624/ground/caves/central1)
"km" = (
/obj/structure/rack,
/obj/item/stack/sheet/mineral/silver{
	amount = 20
	},
/turf/open/floor/tile/vault{
	dir = 8
	},
/area/lv624/ground/caves/central1)
"lR" = (
/obj/structure/rack,
/obj/item/tool/shovel,
/obj/effect/landmark/lv624/fog_blocker/xeno_spawn,
/turf/open/floor/tile/vault{
	dir = 8
	},
/area/lv624/ground/caves/central1)
"mn" = (
/obj/effect/landmark/weed_node,
/turf/open/floor/tile/dark,
/area/lv624/ground/caves/central1)
"oz" = (
/turf/closed/mineral/indestructible,
/area/lv624/ground/caves/rock)
"rO" = (
/obj/structure/rack,
/turf/open/floor/tile/vault{
	dir = 8
	},
/area/lv624/ground/caves/central1)
"sl" = (
/obj/effect/landmark/weed_node,
/obj/effect/ai_node,
/turf/open/floor/plating/ground/dirt,
/area/lv624/ground/caves/central2)
"ty" = (
/obj/structure/rack,
/obj/item/stack/sheet/mineral/gold{
	amount = 2
	},
/obj/item/stack/sheet/mineral/platinum{
	pixel_x = -6
	},
/turf/open/floor/tile/vault{
	dir = 8
	},
/area/lv624/ground/caves/central1)
"tV" = (
/obj/effect/landmark/weed_node,
/obj/effect/landmark/xeno_resin_door,
/turf/open/floor/plating/ground/dirt,
/area/lv624/ground/caves/central2)
"vw" = (
/obj/effect/landmark/lv624/fog_blocker/xeno_spawn,
/turf/closed/wall/r_wall,
/area/lv624/ground/caves/rock)
"vH" = (
/obj/structure/flora/ausbushes/fullgrass,
/obj/effect/landmark/weed_node,
/turf/open/floor/plating/ground/dirt,
/area/lv624/ground/caves/central2)
"xC" = (
/obj/effect/landmark/excavation_site_spawner,
/turf/open/floor/plating/ground/dirt,
/area/lv624/ground/caves/central2)
"yv" = (
/turf/closed/wall/r_wall,
/area/lv624/ground/caves/rock)
"yD" = (
/turf/open/floor/tile/dark,
/area/lv624/ground/caves/central1)
"ze" = (
/obj/structure/flora/ausbushes/fullgrass,
/turf/open/floor/plating/ground/dirt,
/area/lv624/ground/caves/central2)
"AR" = (
/obj/structure/rack,
/obj/item/tool/pickaxe,
/turf/open/floor/tile/vault{
	dir = 8
	},
/area/lv624/ground/caves/central1)
"Bu" = (
/obj/structure/rack,
/obj/effect/landmark/lv624/fog_blocker/xeno_spawn,
/turf/open/floor/tile/vault{
	dir = 8
	},
/area/lv624/ground/caves/central1)
"Co" = (
/obj/effect/landmark/xeno_resin_door,
/obj/effect/ai_node,
/turf/open/floor/plating/ground/dirt,
/area/lv624/ground/caves/central2)
"Eg" = (
/obj/structure/rack,
/obj/item/stack/sheet/mineral/tritium{
	pixel_x = -4
	},
/turf/open/floor/tile/vault{
	dir = 8
	},
/area/lv624/ground/caves/central1)
"EQ" = (
/turf/open/floor/plating/ground/dirt,
/area/lv624/ground/caves/central3)
"Gm" = (
/obj/structure/rack,
/obj/item/stack/sheet/mineral/iron{
	amount = 5
	},
/obj/item/stack/sheet/mineral/platinum,
/obj/machinery/light{
	dir = 8
	},
/obj/effect/landmark/lv624/fog_blocker/xeno_spawn,
/turf/open/floor/tile/vault{
	dir = 8
	},
/area/lv624/ground/caves/central1)
"GX" = (
/turf/closed/wall,
/area/lv624/ground/caves/central1)
"IM" = (
/obj/effect/ai_node,
/turf/open/floor/tile/dark,
/area/lv624/ground/caves/central1)
"Ji" = (
/turf/closed/mineral,
/area/lv624/ground/caves/rock)
"JG" = (
/obj/effect/landmark/weed_node,
/turf/open/floor/plating/ground/dirt,
/area/lv624/ground/caves/central2)
"LD" = (
/obj/effect/ai_node,
/turf/open/floor/plating/ground/dirt,
/area/lv624/ground/caves/central2)
"NC" = (
/turf/closed/wall/r_wall,
/area/lv624/ground/caves/central1)
"RM" = (
/turf/closed/mineral,
/area/lv624/ground/caves/central1)
"SB" = (
/obj/effect/landmark/lv624/fog_blocker,
/obj/effect/landmark/lv624/fog_blocker/xeno_spawn,
/turf/closed/mineral,
/area/lv624/ground/caves/rock)
"Uf" = (
/obj/structure/rack,
/obj/item/stack/sheet/metal{
	amount = 50;
	pixel_x = 4;
	pixel_y = 4
	},
/obj/item/stack/sheet/metal{
	amount = 30
	},
/turf/open/floor/tile/vault{
	dir = 8
	},
/area/lv624/ground/caves/central1)
"Uh" = (
/obj/effect/landmark/xeno_resin_door,
/turf/open/floor/plating/ground/dirt,
/area/lv624/ground/caves/central2)
"Wc" = (
/obj/effect/landmark/lv624/fog_blocker,
/turf/closed/mineral,
/area/lv624/ground/caves/rock)
"Xi" = (
/obj/machinery/door/airlock/mainship/secure/locked/free_access{
	dir = 4;
	name = "\improper Mining Storage"
	},
/turf/open/floor/tile/dark,
/area/lv624/ground/caves/central1)
"XP" = (
/obj/structure/rack,
/obj/item/tool/shovel,
/turf/open/floor/tile/vault{
	dir = 8
	},
/area/lv624/ground/caves/central1)

(1,1,1) = {"
Ji
Ji
Ji
Ji
Ji
Ji
Ji
Ji
Ji
Ji
Uh
Uh
Uh
Uh
Uh
Ji
Ji
Ji
Ji
Ji
Ji
Ji
Ji
Ji
Ji
Ji
Ji
EQ
EQ
EQ
EQ
EQ
EQ
"}
(2,1,1) = {"
Ji
Ji
Ji
Ji
Ji
Ji
Ji
Ji
Ji
Ji
hY
hY
hY
hY
hY
Ji
Ji
Ji
Ji
Ji
Ji
Ji
Ji
Ji
Ji
Ji
Ji
Ji
Ji
Ji
Ji
Ji
EQ
"}
(3,1,1) = {"
Ji
Ji
Ji
Ji
Ji
Ji
Ji
Ji
Ji
Ji
hY
hY
JG
hY
hY
hY
JG
hY
hY
Ji
Ji
Ji
Ji
Ji
Ji
Ji
oz
oz
oz
oz
oz
Ji
Ji
"}
(4,1,1) = {"
Ji
Ji
Ji
Ji
Ji
Ji
Ji
iT
iT
iT
hY
hY
hY
hY
hY
hY
hY
hY
hY
hY
hY
hY
Ji
Ji
Ji
Ji
oz
oz
oz
oz
oz
Ji
Ji
"}
(5,1,1) = {"
Ji
Ji
Ji
Ji
Ji
Ji
Ji
iT
hY
hY
hY
LD
hY
hY
hY
hY
hY
hY
LD
hY
hY
LD
hY
Ji
Ji
Ji
oz
oz
oz
oz
oz
Ji
Ji
"}
(6,1,1) = {"
Ji
Ji
Ji
Ji
Ji
Ji
iT
iT
hY
JG
hY
hY
JG
hY
hY
hY
hY
JG
hY
hY
hY
JG
hY
iT
Ji
Ji
Ji
Ji
Ji
Ji
Ji
Ji
Ji
"}
(7,1,1) = {"
Ji
Ji
Ji
Ji
Ji
Ji
iT
hY
hY
hY
hY
hY
hY
hY
hY
hY
iT
iT
hY
hY
hY
hY
hY
iT
Ji
Ji
Ji
Ji
Ji
Ji
Ji
Ji
Ji
"}
(8,1,1) = {"
Ji
Ji
Ji
Ji
Ji
iT
iT
hY
hY
hY
hY
hY
iT
iT
JG
hY
iT
iT
hY
hY
hY
hY
hY
iT
iT
Ji
oz
oz
oz
oz
oz
Ji
Ji
"}
(9,1,1) = {"
Ji
Ji
Ji
Ji
Ji
iT
hY
hY
hY
JG
hY
hY
iT
iT
hY
hY
hY
hY
hY
JG
hY
JG
hY
hY
iT
Ji
oz
oz
oz
oz
oz
Ji
Ji
"}
(10,1,1) = {"
Ji
Ji
Ji
Ji
Ji
iT
JG
hY
hY
xC
hY
hY
hY
hY
hY
JG
hY
hY
hY
hY
hY
hY
hY
hY
Ji
Ji
oz
oz
oz
oz
oz
Ji
Ji
"}
(11,1,1) = {"
Ji
Ji
Ji
Ji
Ji
iT
hY
hY
hY
hY
hY
JG
hY
hY
hY
hY
hY
hY
hY
hY
hY
hY
hY
hY
Ji
Ji
Ji
Ji
Ji
Ji
Ji
Ji
Ji
"}
(12,1,1) = {"
Ji
Ji
Ji
Ji
Ji
iT
LD
hY
hY
hY
hY
LD
hY
ze
hY
LD
hY
hY
LD
hY
JG
LD
hY
hY
Ji
Ji
Ji
Ji
Ji
Ji
Ji
Ji
Ji
"}
(13,1,1) = {"
Ji
Ji
Ji
Ji
Ji
iT
hY
hY
hY
vH
hY
hY
hY
JG
hY
hY
iT
iT
iT
iT
hY
hY
hY
hY
Ji
Ji
oz
oz
oz
oz
oz
Ji
Ji
"}
(14,1,1) = {"
Ji
Ji
Ji
Ji
iT
iT
hY
hY
hY
hY
hY
Ji
Ji
hY
hY
hY
iT
Ji
Ji
Ji
Uh
Uh
Uh
Ji
Ji
Ji
oz
oz
oz
oz
oz
Ji
Ji
"}
(15,1,1) = {"
Ji
Ji
Ji
iT
iT
hY
hY
hY
hY
hY
Ji
Ji
Ji
Uh
Uh
Uh
Ji
Ji
Ji
Ji
hY
hY
hY
Ji
Ji
Ji
oz
oz
oz
oz
oz
Ji
Ji
"}
(16,1,1) = {"
Ji
Ji
Ji
iT
hY
JG
hY
ze
hY
Ji
Ji
Ji
hY
JG
hY
hY
Ji
Ji
Ji
hY
hY
hY
hY
iT
Ji
Ji
Ji
Ji
Ji
Ji
Ji
Ji
Ji
"}
(17,1,1) = {"
Ji
Ji
Ji
iT
hY
hY
hY
hY
hY
Ji
Ji
Ji
hY
hY
hY
hY
hY
Ji
Ji
hY
JG
hY
hY
iT
iT
Ji
Ji
Ji
Ji
Ji
Ji
Ji
Ji
"}
(18,1,1) = {"
Ji
Ji
Ji
iT
hY
hY
JG
hY
Ji
Ji
Ji
Ji
hY
hY
hY
LD
hY
hY
hY
hY
hY
hY
hY
hY
iT
iT
iT
iT
Ji
Ji
oz
oz
oz
"}
(19,1,1) = {"
Ji
Ji
Ji
iT
hY
hY
hY
hY
Ji
Ji
Ji
iT
hY
hY
iT
iT
LD
hY
hY
hY
hY
LD
hY
hY
hY
hY
hY
iT
iT
Ji
oz
oz
oz
"}
(20,1,1) = {"
Ji
Ji
iT
iT
hY
hY
LD
hY
Ji
Ji
Ji
Ji
hY
hY
iT
iT
hY
JG
hY
gv
hY
hY
LD
hY
hY
JG
hY
hY
iT
Ji
oz
oz
oz
"}
(21,1,1) = {"
Ji
Ji
iT
hY
hY
LD
hY
iT
Ji
Ji
Ji
Ji
Ji
hY
hY
hY
hY
hY
hY
hY
JG
hY
hY
LD
hY
hY
LD
JG
iT
Ji
Ji
Ji
Ji
"}
(22,1,1) = {"
Ji
iT
iT
vH
hY
hY
iT
iT
Ji
Ji
Ji
Ji
Ji
JG
hY
hY
hY
hY
iT
iT
hY
hY
hY
hY
hY
hY
hY
hY
iT
Ji
Ji
Ji
Ji
"}
(23,1,1) = {"
Ji
iT
hY
hY
hY
hY
iT
Ji
Ji
Ji
Ji
Ji
Ji
hY
hY
hY
LD
iT
Ji
Ji
iT
iT
iT
iT
JG
hY
JG
hY
hY
iT
Ji
Ji
Ji
"}
(24,1,1) = {"
Ji
iT
hY
hY
hY
hY
iT
Ji
Ji
Ji
Ji
Ji
Ji
Ji
hY
hY
hY
iT
Ji
Ji
Ji
iT
Ji
Ji
hY
hY
hY
hY
hY
iT
Ji
Ji
Ji
"}
(25,1,1) = {"
Ji
iT
hY
hY
hY
hY
iT
Ji
Ji
Ji
Ji
Ji
Ji
Ji
hY
JG
hY
Ji
Ji
Ji
Ji
Ji
Ji
Ji
hY
hY
hY
hY
JG
hY
iT
Ji
Ji
"}
(26,1,1) = {"
Ji
iT
JG
hY
gv
hY
JG
Ji
Ji
Ji
Ji
Ji
Ji
iT
hY
hY
hY
Ji
Ji
Ji
Ji
Ji
Ji
hY
hY
hY
hY
hY
hY
hY
iT
Ji
Ji
"}
(27,1,1) = {"
Ji
iT
hY
hY
hY
hY
ze
Ji
Ji
Ji
Ji
Ji
iT
iT
hY
hY
hY
iT
Ji
Ji
Ji
Ji
Ji
hY
hY
JG
LD
hY
hY
iT
Ji
Ji
Ji
"}
(28,1,1) = {"
Ji
iT
hY
hY
hY
hY
hY
iT
Ji
Ji
Ji
Ji
iT
hY
hY
hY
hY
iT
Ji
Ji
Ji
Ji
hY
hY
hY
hY
hY
hY
hY
iT
Ji
Ji
Ji
"}
(29,1,1) = {"
Ji
iT
hY
hY
hY
hY
hY
Ji
Ji
Ji
Ji
Ji
iT
hY
hY
JG
hY
hY
iT
Ji
Ji
hY
hY
hY
hY
hY
hY
hY
iT
Ji
Ji
Ji
Ji
"}
(30,1,1) = {"
Ji
iT
JG
ze
hY
hY
JG
hY
Ji
Ji
Ji
iT
iT
hY
hY
hY
xC
hY
hY
hY
hY
hY
JG
hY
iT
iT
JG
hY
iT
Ji
Ji
Ji
Ji
"}
(31,1,1) = {"
Ji
iT
hY
hY
hY
LD
hY
hY
Ji
Ji
Ji
iT
hY
hY
hY
hY
hY
hY
iT
iT
hY
hY
hY
hY
iT
iT
hY
hY
iT
Ji
Ji
Ji
Ji
"}
(32,1,1) = {"
Ji
iT
hY
hY
hY
hY
LD
hY
Ji
Ji
Ji
iT
hY
JG
iT
iT
hY
JG
iT
iT
hY
hY
hY
hY
hY
hY
hY
hY
iT
Ji
Ji
Ji
Ji
"}
(33,1,1) = {"
Ji
iT
hY
hY
hY
ze
hY
hY
Ji
Ji
hY
hY
hY
hY
iT
iT
LD
hY
hY
hY
hY
hY
JG
hY
LD
hY
LD
hY
Ji
Ji
Ji
Ji
Ji
"}
(34,1,1) = {"
Ji
iT
JG
hY
hY
hY
JG
hY
hY
Ji
hY
hY
hY
hY
hY
hY
hY
hY
hY
Ji
Ji
hY
hY
hY
hY
hY
hY
hY
Ji
oz
oz
Ji
Ji
"}
(35,1,1) = {"
Ji
iT
hY
hY
hY
hY
hY
hY
hY
Uh
hY
iT
iT
hY
hY
hY
hY
Ji
Ji
Ji
Ji
hY
hY
hY
JG
hY
hY
hY
Ji
oz
oz
Ji
Ji
"}
(36,1,1) = {"
Ji
iT
JG
hY
hY
hY
hY
hY
hY
Uh
hY
iT
iT
LD
JG
hY
LD
Ji
Ji
Ji
Ji
Ji
Ji
hY
hY
hY
hY
JG
Ji
oz
oz
Ji
Ji
"}
(37,1,1) = {"
Ji
iT
hY
hY
hY
hY
hY
hY
hY
Uh
hY
hY
hY
hY
hY
hY
Ji
Ji
Ji
Ji
Ji
Ji
Ji
hY
hY
hY
hY
hY
Ji
oz
oz
Ji
Ji
"}
(38,1,1) = {"
Ji
iT
hY
hY
hY
hY
sl
hY
ze
Uh
JG
hY
hY
LD
JG
hY
Ji
Ji
Ji
Ji
Ji
Ji
Ji
Ji
sl
hY
hY
hY
Ji
oz
oz
Ji
oz
"}
(39,1,1) = {"
Ji
iT
JG
hY
hY
hY
hY
hY
Ji
Ji
Ji
Ji
Ji
hY
hY
hY
Ji
Ji
Ji
Ji
Ji
Ji
Ji
Ji
hY
LD
hY
hY
Ji
oz
oz
Ji
oz
"}
(40,1,1) = {"
Ji
iT
hY
hY
hY
hY
hY
Ji
Ji
Ji
Ji
Ji
Ji
Uh
Uh
Uh
Ji
Ji
Ji
Ji
Ji
Ji
Ji
Ji
Uh
Uh
Uh
Uh
Ji
Ji
Ji
Ji
oz
"}
(41,1,1) = {"
Ji
Ji
hY
hY
hY
hY
hY
Ji
Ji
Ji
Ji
Ji
hY
hY
hY
hY
hY
Ji
hY
hY
Ji
Ji
hY
hY
hY
JG
hY
hY
iT
Ji
Ji
Ji
Ji
"}
(42,1,1) = {"
Ji
Ji
hY
JG
hY
hY
sl
iT
Ji
Ji
Ji
Ji
hY
hY
hY
hY
hY
hY
hY
hY
hY
hY
hY
hY
hY
hY
hY
ze
iT
Ji
Ji
Ji
Ji
"}
(43,1,1) = {"
Ji
Ji
Ji
hY
hY
hY
ze
iT
Ji
Ji
Ji
Ji
hY
hY
hY
JG
hY
hY
hY
hY
JG
hY
hY
hY
hY
hY
ze
hY
hY
iT
Ji
iT
hY
"}
(44,1,1) = {"
Ji
Ji
Ji
hY
hY
hY
hY
hY
iT
Ji
Ji
Ji
hY
hY
hY
hY
hY
iT
iT
hY
hY
hY
hY
hY
hY
hY
hY
hY
hY
hY
hY
hY
hY
"}
(45,1,1) = {"
Ji
Ji
Ji
hY
hY
hY
hY
hY
iT
Ji
Ji
Ji
hY
hY
hY
hY
hY
iT
iT
hY
hY
hY
hY
hY
hY
JG
iT
iT
hY
JG
hY
JG
hY
"}
(46,1,1) = {"
Ji
Ji
Ji
Ji
hY
hY
JG
hY
hY
Ji
Ji
Ji
iT
hY
hY
hY
hY
hY
hY
hY
JG
hY
iT
iT
hY
hY
iT
iT
hY
xC
hY
hY
hY
"}
(47,1,1) = {"
Ji
Ji
Ji
Ji
hY
hY
hY
hY
hY
iT
Ji
Ji
Ji
iT
iT
hY
JG
hY
hY
hY
hY
hY
iT
iT
hY
hY
hY
hY
hY
hY
hY
hY
hY
"}
(48,1,1) = {"
Ji
Ji
Ji
Ji
hY
hY
hY
hY
hY
iT
Ji
Ji
Ji
Ji
iT
hY
hY
hY
hY
hY
hY
hY
hY
hY
hY
LD
hY
hY
hY
hY
hY
hY
hY
"}
(49,1,1) = {"
Ji
Ji
Ji
Ji
hY
hY
hY
hY
hY
iT
Ji
Ji
Ji
Ji
iT
iT
hY
hY
hY
JG
hY
hY
hY
hY
hY
JG
LD
hY
JG
hY
hY
hY
LD
"}
(50,1,1) = {"
Ji
Ji
Ji
Ji
Ji
hY
JG
hY
hY
iT
Ji
Ji
Ji
Ji
Ji
iT
iT
hY
hY
hY
hY
hY
hY
hY
hY
gv
hY
hY
iT
iT
hY
sl
hY
"}
(51,1,1) = {"
Ji
Ji
Ji
Ji
Ji
hY
LD
hY
hY
hY
iT
Ji
Ji
Ji
Ji
Ji
iT
iT
hY
hY
hY
hY
hY
hY
JG
hY
hY
hY
iT
iT
hY
hY
hY
"}
(52,1,1) = {"
Ji
Ji
Ji
Ji
Ji
LD
hY
hY
hY
hY
iT
Ji
Ji
Ji
Ji
Ji
Ji
iT
iT
hY
hY
JG
hY
ze
hY
hY
hY
hY
hY
hY
hY
hY
Ji
"}
(53,1,1) = {"
Ji
Ji
Ji
Ji
Ji
hY
hY
gv
hY
hY
hY
hY
Ji
Ji
Ji
Ji
Ji
Ji
iT
ze
hY
hY
hY
hY
hY
hY
hY
JG
hY
hY
hY
hY
Ji
"}
(54,1,1) = {"
Ji
Ji
Ji
Ji
Ji
hY
JG
hY
hY
hY
hY
hY
hY
Ji
Ji
Ji
Ji
Ji
Ji
hY
hY
hY
hY
hY
hY
hY
hY
hY
hY
hY
JG
hY
Ji
"}
(55,1,1) = {"
Ji
Ji
Ji
Ji
Ji
hY
hY
hY
hY
JG
hY
hY
hY
hY
Ji
Ji
Ji
Ji
Ji
hY
JG
hY
hY
JG
hY
hY
hY
hY
hY
hY
hY
hY
Ji
"}
(56,1,1) = {"
Ji
Ji
Ji
Ji
Ji
hY
hY
hY
hY
hY
hY
hY
JG
hY
hY
Ji
Ji
Ji
Ji
Uh
Uh
Ji
hY
hY
hY
hY
LD
hY
hY
hY
hY
LD
Ji
"}
(57,1,1) = {"
Ji
Ji
Ji
Ji
Ji
hY
hY
hY
hY
hY
hY
LD
hY
hY
hY
hY
LD
hY
hY
hY
hY
Ji
Ji
hY
hY
LD
hY
hY
hY
hY
hY
Ji
Ji
"}
(58,1,1) = {"
Ji
Ji
Ji
Ji
Ji
LD
hY
JG
hY
hY
LD
hY
hY
hY
hY
hY
hY
hY
hY
hY
hY
Ji
Ji
Ji
Ji
hY
hY
hY
hY
hY
Ji
Ji
Ji
"}
(59,1,1) = {"
Ji
Ji
Ji
Ji
Ji
Ji
hY
hY
hY
JG
hY
hY
iT
iT
hY
hY
hY
hY
hY
hY
hY
hY
Ji
Ji
Ji
Ji
Uh
Uh
Uh
Uh
Ji
Ji
Ji
"}
(60,1,1) = {"
Ji
Ji
Ji
Ji
Ji
Ji
hY
hY
hY
hY
hY
hY
iT
iT
hY
hY
hY
hY
iT
iT
hY
JG
hY
Ji
Ji
Ji
hY
JG
hY
Ji
Ji
Ji
Ji
"}
(61,1,1) = {"
Ji
Ji
Ji
Ji
Ji
Ji
Ji
hY
hY
hY
hY
hY
hY
JG
hY
hY
hY
JG
iT
iT
hY
hY
hY
hY
hY
hY
hY
hY
Ji
Ji
Ji
Ji
Ji
"}
(62,1,1) = {"
Ji
Ji
Ji
Ji
Ji
Ji
Ji
hY
hY
hY
xC
hY
hY
hY
hY
hY
hY
hY
hY
hY
hY
hY
hY
hY
hY
hY
hY
Ji
Ji
Ji
Ji
Ji
Ji
"}
(63,1,1) = {"
Ji
Ji
Ji
Ji
Ji
Ji
Ji
hY
hY
hY
hY
hY
hY
hY
hY
hY
hY
hY
hY
hY
hY
hY
hY
hY
hY
hY
Ji
Ji
Ji
Ji
Ji
Ji
Ji
"}
(64,1,1) = {"
Ji
Ji
Ji
Ji
Ji
Ji
Ji
Ji
hY
hY
sl
hY
hY
LD
hY
hY
LD
hY
hY
hY
hY
LD
hY
hY
hY
LD
Ji
Ji
Ji
Ji
Ji
Ji
Ji
"}
(65,1,1) = {"
Ji
Ji
Ji
Ji
Ji
Ji
Ji
Ji
hY
hY
hY
hY
hY
hY
hY
iT
Ji
Ji
iT
hY
JG
hY
hY
hY
JG
hY
Ji
Ji
Ji
Ji
Ji
Ji
Ji
"}
(66,1,1) = {"
Ji
Ji
Ji
Ji
Ji
Ji
Ji
Ji
Ji
hY
iT
iT
hY
JG
iT
Ji
Ji
Ji
Ji
iT
hY
hY
iT
iT
hY
hY
Ji
Ji
oz
oz
oz
oz
Ji
"}
(67,1,1) = {"
Ji
Ji
Ji
Ji
Ji
Ji
Ji
Ji
Ji
hY
iT
iT
hY
hY
iT
Ji
Ji
Ji
Ji
iT
hY
hY
iT
iT
hY
hY
Ji
Ji
oz
oz
oz
oz
Ji
"}
(68,1,1) = {"
Ji
Ji
Ji
Ji
Ji
Ji
Ji
Ji
Ji
hY
hY
JG
hY
hY
Ji
Ji
Ji
Ji
Ji
Ji
iT
hY
hY
hY
hY
hY
Ji
Ji
oz
oz
oz
oz
Ji
"}
(69,1,1) = {"
Ji
Ji
Ji
Ji
Ji
Ji
Ji
Ji
Ji
Ji
hY
hY
hY
hY
Ji
Ji
Ji
Ji
Ji
Ji
iT
hY
hY
JG
hY
hY
Ji
Ji
Ji
Ji
Ji
Ji
Ji
"}
(70,1,1) = {"
Ji
Ji
Ji
Ji
Ji
Ji
Ji
Ji
Ji
Ji
hY
hY
hY
hY
Ji
Ji
Ji
Ji
Ji
Ji
Ji
hY
hY
hY
hY
hY
Ji
Ji
oz
oz
oz
oz
Ji
"}
(71,1,1) = {"
oz
oz
oz
oz
Ji
oz
oz
oz
oz
Ji
hY
hY
hY
hY
hY
Ji
Ji
Ji
Ji
Ji
Ji
hY
hY
hY
hY
hY
Ji
Ji
oz
oz
oz
oz
Ji
"}
(72,1,1) = {"
oz
oz
oz
oz
Ji
oz
oz
oz
oz
Ji
Uh
tV
Uh
Uh
Uh
Ji
Ji
Ji
Ji
Ji
Ji
Co
Uh
tV
Uh
Uh
Ji
Ji
oz
oz
oz
oz
Ji
"}
(73,1,1) = {"
oz
oz
oz
oz
Ji
oz
oz
oz
oz
Ji
hY
hY
hY
LD
hY
Ji
Ji
Ji
Ji
Ji
LD
hY
hY
hY
hY
LD
Ji
Ji
Ji
Ji
Ji
Ji
Ji
"}
(74,1,1) = {"
oz
oz
oz
oz
Ji
oz
oz
oz
oz
Ji
hY
hY
xC
hY
hY
Ji
Ji
Ji
Ji
Ji
hY
hY
hY
Ji
Ji
Ji
Ji
SB
vw
lR
Gm
Bu
vw
"}
(75,1,1) = {"
Ji
Ji
Ji
Ji
Ji
Ji
Ji
Ji
Ji
Ji
hY
hY
JG
hY
hY
Ji
Ji
Ji
Ji
hY
hY
hY
hY
hY
Ji
Ji
Ji
Wc
yv
ty
yD
Eg
yv
"}
(76,1,1) = {"
oz
oz
oz
oz
Ji
oz
oz
oz
oz
Ji
hY
hY
hY
hY
hY
hY
Ji
Ji
hY
hY
hY
JG
hY
hY
Ji
Ji
Ji
Wc
yv
jw
IM
km
NC
"}
(77,1,1) = {"
oz
oz
oz
oz
Ji
oz
oz
oz
oz
Ji
hY
hY
hY
hY
hY
hY
Ji
hY
hY
hY
hY
hY
hY
Ji
Ji
Ji
Ji
Wc
yv
Uf
mn
rO
NC
"}
(78,1,1) = {"
oz
oz
oz
oz
Ji
oz
oz
oz
oz
Ji
Ji
hY
hY
hY
hY
hY
hY
hY
hY
JG
hY
hY
Ji
Ji
Ji
Ji
Ji
Wc
yv
XP
yD
AR
NC
"}
(79,1,1) = {"
Ji
Ji
Ji
Ji
Ji
Ji
Ji
Ji
Ji
Ji
Ji
Ji
hY
LD
hY
hY
JG
hY
hY
hY
hY
hY
Ji
Ji
Ji
Ji
Ji
Wc
NC
GX
Xi
GX
NC
"}
(80,1,1) = {"
oz
oz
oz
oz
Ji
oz
oz
oz
oz
Ji
Ji
Ji
Ji
hY
LD
hY
hY
hY
hY
hY
hY
hY
Uh
hY
Ji
Ji
Ji
Wc
RM
co
co
co
co
"}
