//MAP CONVERTED BY dmm2tgm.py THIS HEADER COMMENT PREVENTS RECONVERSION, DO NOT REMOVE
"aP" = (
/obj/structure/rack,
/obj/item/tool/shovel,
/turf/open/floor/tile/vault{
	dir = 8
	},
/area/lv624/ground/caves/central1)
"fo" = (
/obj/effect/landmark/xeno_resin_door,
/turf/open/floor/plating/ground/dirt,
/area/lv624/ground/caves/central1)
"ge" = (
/obj/structure/flora/ausbushes/fullgrass,
/turf/open/floor/plating/ground/dirt,
/area/lv624/ground/caves/central2)
"hm" = (
/obj/structure/rack,
/obj/item/stack/sheet/metal{
	amount = 50;
	pixel_x = 4;
	pixel_y = 4
	},
/obj/item/stack/sheet/metal{
	amount = 30
	},
/turf/open/floor/tile/vault{
	dir = 8
	},
/area/lv624/ground/caves/central1)
"hJ" = (
/turf/open/floor/tile/dark,
/area/lv624/ground/caves/central1)
"kG" = (
/obj/structure/rack,
/obj/item/tool/pickaxe,
/turf/open/floor/tile/vault{
	dir = 8
	},
/area/lv624/ground/caves/central1)
"mI" = (
/turf/open/floor/plating/ground/dirt,
/area/lv624/ground/caves/central1)
"np" = (
/obj/effect/landmark/xeno_resin_door,
/obj/effect/ai_node,
/turf/open/floor/plating/ground/dirt,
/area/lv624/ground/caves/central1)
"pd" = (
/obj/effect/landmark/excavation_site_spawner,
/turf/open/floor/plating/ground/dirt,
/area/lv624/ground/caves/central1)
"sd" = (
/turf/closed/mineral/smooth/indestructible,
/area/lv624/ground/caves/rock)
"sn" = (
/turf/closed/mineral/smooth,
/area/lv624/ground/caves/central2)
"sr" = (
/turf/open/floor/plating/ground/dirt,
/area/lv624/ground/caves/central2)
"sv" = (
/obj/structure/rack,
/obj/item/stack/sheet/mineral/gold{
	amount = 2
	},
/obj/item/stack/sheet/mineral/platinum{
	pixel_x = -6
	},
/turf/open/floor/tile/vault{
	dir = 8
	},
/area/lv624/ground/caves/central1)
"tW" = (
/obj/effect/landmark/xeno_resin_wall,
/turf/open/floor/plating/ground/dirt,
/area/lv624/ground/caves/central2)
"yL" = (
/obj/structure/rack,
/obj/item/tool/shovel,
/obj/effect/landmark/lv624/fog_blocker/xeno_spawn,
/turf/open/floor/tile/vault{
	dir = 8
	},
/area/lv624/ground/caves/central1)
"AV" = (
/obj/machinery/miner/damaged/platinum,
/turf/open/floor/plating/ground/dirt,
/area/lv624/ground/caves/central2)
"Bh" = (
/turf/closed/mineral/smooth,
/area/lv624/ground/caves/central1)
"BU" = (
/obj/structure/rack,
/obj/item/stack/sheet/mineral/silver{
	amount = 20
	},
/turf/open/floor/tile/vault{
	dir = 8
	},
/area/lv624/ground/caves/central1)
"CY" = (
/turf/closed/wall,
/area/lv624/ground/caves/central1)
"Df" = (
/obj/structure/rack,
/obj/effect/landmark/lv624/fog_blocker/xeno_spawn,
/turf/open/floor/tile/vault{
	dir = 8
	},
/area/lv624/ground/caves/central1)
"Ew" = (
/obj/structure/rack,
/obj/item/stack/sheet/mineral/iron{
	amount = 5
	},
/obj/item/stack/sheet/mineral/platinum,
/obj/machinery/light{
	dir = 8
	},
/obj/effect/landmark/lv624/fog_blocker/xeno_spawn,
/turf/open/floor/tile/vault{
	dir = 8
	},
/area/lv624/ground/caves/central1)
"GO" = (
/obj/structure/rack,
/obj/item/stack/sheet/mineral/tritium{
	pixel_x = -4
	},
/turf/open/floor/tile/vault{
	dir = 8
	},
/area/lv624/ground/caves/central1)
"GW" = (
/obj/effect/landmark/xeno_resin_door,
/turf/open/floor/plating/ground/dirt,
/area/lv624/ground/caves/central3)
"Ia" = (
/obj/effect/landmark/excavation_site_spawner,
/turf/open/floor/plating/ground/dirt,
/area/lv624/ground/caves/central2)
"Iz" = (
/obj/effect/landmark/weed_node,
/turf/open/floor/plating/ground/dirt,
/area/lv624/ground/caves/central1)
"Jt" = (
/obj/effect/landmark/lv624/fog_blocker,
/obj/effect/landmark/lv624/fog_blocker/xeno_spawn,
/turf/closed/mineral/smooth,
/area/lv624/ground/caves/rock)
"KW" = (
/turf/closed/mineral/smooth,
/area/lv624/ground/caves/rock)
"Lx" = (
/obj/structure/rack,
/turf/open/floor/tile/vault{
	dir = 8
	},
/area/lv624/ground/caves/central1)
"Mh" = (
/obj/structure/rack,
/obj/item/stack/sheet/mineral/diamond{
	amount = 2
	},
/turf/open/floor/tile/vault{
	dir = 8
	},
/area/lv624/ground/caves/central1)
"MT" = (
/obj/machinery/door/airlock/mainship/secure/locked/free_access{
	dir = 4;
	name = "\improper Mining Storage"
	},
/turf/open/floor/tile/dark,
/area/lv624/ground/caves/central1)
"Nb" = (
/obj/effect/landmark/weed_node,
/turf/open/floor/plating/ground/dirt,
/area/lv624/ground/caves/central2)
"Nd" = (
/turf/open/floor/plating/ground/dirt,
/area/lv624/ground/caves/central3)
"Qs" = (
/obj/effect/ai_node,
/turf/open/floor/plating/ground/dirt,
/area/lv624/ground/caves/central2)
"QO" = (
/obj/effect/landmark/lv624/fog_blocker/xeno_spawn,
/turf/closed/wall/r_wall,
/area/lv624/ground/caves/rock)
"TN" = (
/turf/closed/wall/r_wall,
/area/lv624/ground/caves/rock)
"UY" = (
/turf/open/floor,
/area/lv624/ground/caves/central1)
"WQ" = (
/turf/closed/wall/r_wall,
/area/lv624/ground/caves/central1)
"Yi" = (
/obj/effect/ai_node,
/turf/open/floor/plating/ground/dirt,
/area/lv624/ground/caves/central1)
"Yl" = (
/obj/effect/ai_node,
/turf/open/floor/tile/dark,
/area/lv624/ground/caves/central1)
"Za" = (
/obj/effect/landmark/lv624/fog_blocker,
/turf/closed/mineral/smooth,
/area/lv624/ground/caves/rock)

(1,1,1) = {"
KW
KW
KW
KW
KW
KW
KW
KW
KW
KW
GW
GW
GW
GW
GW
KW
KW
KW
KW
KW
KW
KW
KW
KW
KW
KW
KW
Nd
Nd
Nd
Nd
Nd
Nd
"}
(2,1,1) = {"
KW
KW
KW
KW
KW
KW
KW
KW
KW
KW
sr
sr
sr
sr
sr
KW
KW
KW
KW
KW
KW
KW
KW
KW
KW
KW
KW
KW
KW
KW
KW
KW
Nd
"}
(3,1,1) = {"
KW
KW
KW
KW
KW
KW
KW
KW
KW
KW
sr
sr
Nb
sr
sr
Nb
sr
sr
Nb
KW
KW
KW
KW
KW
KW
KW
sd
sd
sd
sd
sd
KW
KW
"}
(4,1,1) = {"
KW
KW
KW
KW
KW
KW
KW
sr
sr
Nb
sr
sr
sr
sr
sr
sr
sr
sr
sr
sr
sr
sr
KW
KW
KW
KW
sd
sd
sd
sd
sd
KW
KW
"}
(5,1,1) = {"
KW
KW
KW
KW
KW
KW
KW
sr
sr
sr
sr
Qs
sr
sr
sr
sr
Nb
sr
Qs
sr
sr
Qs
sr
KW
KW
KW
sd
sd
sd
sd
sd
KW
KW
"}
(6,1,1) = {"
KW
KW
KW
KW
KW
KW
sr
Nb
sr
sr
Nb
sr
sr
Nb
sr
sr
sr
sr
Nb
sr
Nb
sr
Nb
tW
KW
KW
KW
KW
KW
KW
KW
KW
KW
"}
(7,1,1) = {"
KW
KW
KW
KW
KW
KW
sr
tW
tW
sr
sr
Nb
sr
tW
tW
tW
sr
sr
sr
sr
sr
sr
sr
tW
KW
KW
KW
KW
KW
KW
KW
KW
KW
"}
(8,1,1) = {"
KW
KW
KW
KW
KW
sr
Nb
tW
tW
sr
tW
sr
sr
sr
sr
sr
sr
Nb
sr
tW
tW
sr
Nb
tW
tW
KW
sd
sd
sd
sd
sd
KW
KW
"}
(9,1,1) = {"
KW
KW
KW
KW
KW
sr
sr
sr
sr
sr
sr
sr
sr
sr
sr
Nb
sr
tW
sr
tW
tW
sr
sr
tW
tW
KW
sd
sd
sd
sd
sd
KW
KW
"}
(10,1,1) = {"
KW
KW
KW
KW
KW
sr
Nb
sr
sr
Ia
sr
Nb
sr
AV
sr
sr
sr
sr
sr
sr
sr
sr
Nb
tW
KW
KW
sd
sd
sd
sd
sd
KW
KW
"}
(11,1,1) = {"
KW
KW
KW
KW
KW
sr
sr
sr
sr
Nb
sr
sr
sr
sr
sr
Nb
sr
sr
sr
sr
Nb
sr
sr
tW
KW
KW
KW
KW
KW
KW
KW
KW
KW
"}
(12,1,1) = {"
KW
KW
KW
KW
KW
Qs
sr
Nb
sr
sr
sr
Qs
sr
ge
sr
sr
sr
sr
Qs
sr
sr
Qs
sr
tW
KW
KW
KW
KW
KW
KW
KW
KW
KW
"}
(13,1,1) = {"
KW
KW
KW
KW
KW
sr
sr
sr
sr
ge
sr
Nb
sr
sr
sr
Nb
sr
sr
sr
sr
sr
sr
tW
tW
KW
KW
sd
sd
sd
sd
sd
KW
KW
"}
(14,1,1) = {"
KW
KW
KW
KW
sr
sr
sr
sr
Nb
sr
sr
sr
sr
sr
sr
sr
sr
tW
tW
sr
sr
sr
tW
KW
KW
KW
sd
sd
sd
sd
sd
KW
KW
"}
(15,1,1) = {"
KW
KW
KW
sr
Nb
sr
sr
sr
sr
sr
tW
tW
tW
tW
tW
sr
sr
tW
tW
ge
sr
Nb
tW
KW
KW
KW
sd
sd
sd
sd
sd
KW
KW
"}
(16,1,1) = {"
KW
KW
KW
sr
sr
Nb
sr
ge
sr
tW
sn
sn
sn
sn
sn
tW
sr
sr
sr
sr
sr
sr
tW
tW
KW
KW
KW
KW
KW
KW
KW
KW
KW
"}
(17,1,1) = {"
KW
KW
KW
sr
sr
sr
Nb
sr
sr
tW
sn
sn
sn
sn
sn
sn
tW
sr
sr
Nb
sr
sr
sr
tW
tW
KW
KW
KW
KW
KW
KW
KW
KW
"}
(18,1,1) = {"
KW
KW
KW
sr
tW
sr
sr
sr
Nb
tW
sn
sn
sn
sn
sn
sn
tW
tW
sr
sr
sr
sr
Nb
sr
tW
tW
tW
tW
KW
KW
sd
sd
sd
"}
(19,1,1) = {"
KW
KW
KW
sr
sr
Nb
sr
sr
tW
tW
sn
sn
sn
sn
sn
sn
sn
sn
tW
sr
sr
Qs
sr
sr
sr
sr
Nb
tW
tW
KW
sd
sd
sd
"}
(20,1,1) = {"
KW
KW
tW
Nb
sr
sr
sr
tW
sn
sn
sn
sn
sn
sn
sn
sn
sn
sn
tW
sr
sr
sr
Qs
sr
sr
sr
sr
sr
tW
KW
sd
sd
sd
"}
(21,1,1) = {"
KW
tW
tW
sr
sr
Qs
sr
tW
sn
sn
sn
sn
sn
sn
sn
sn
sn
sn
sn
tW
Nb
sr
sr
Qs
Nb
sr
Qs
sr
tW
KW
KW
KW
KW
"}
(22,1,1) = {"
KW
tW
sr
ge
sr
sr
tW
tW
sn
sn
sn
sn
sn
sn
sn
sn
sn
sn
sn
tW
sr
sr
Nb
sr
sr
sr
sr
tW
tW
KW
KW
KW
KW
"}
(23,1,1) = {"
KW
tW
sr
sr
Nb
sr
tW
tW
sn
sn
sn
sn
sn
sn
sn
sn
sn
sn
sn
sn
tW
ge
sr
sr
sr
tW
sr
tW
tW
tW
KW
KW
KW
"}
(24,1,1) = {"
KW
tW
Nb
sr
sr
sr
Nb
tW
sn
sn
sn
sn
sn
sn
sn
sn
sn
sn
sn
sn
tW
tW
sr
sr
sr
sr
sr
sr
sr
tW
KW
KW
KW
"}
(25,1,1) = {"
KW
tW
sr
sr
sr
sr
sr
tW
sn
sn
sn
sn
sn
sn
sn
sn
sn
sn
sn
sn
sn
tW
tW
sr
Nb
sr
sr
Nb
sr
tW
tW
KW
KW
"}
(26,1,1) = {"
KW
tW
sr
sr
AV
sr
sr
tW
sn
sn
sn
sn
sn
sn
sn
sn
sn
sn
sn
sn
sn
sn
sn
tW
sr
sr
sr
sr
sr
tW
tW
KW
KW
"}
(27,1,1) = {"
KW
tW
sr
sr
sr
sr
ge
tW
sn
sn
sn
sn
sn
sn
sn
sn
sn
sn
sn
sn
sn
sn
tW
tW
sr
sr
Qs
sr
sr
tW
KW
KW
KW
"}
(28,1,1) = {"
KW
tW
sr
sr
Nb
sr
Nb
tW
sn
sn
sn
sn
sn
sn
sn
sn
sn
sn
sn
sn
sn
sn
tW
tW
Nb
sr
sr
Nb
tW
tW
KW
KW
KW
"}
(29,1,1) = {"
KW
tW
Nb
sr
sr
sr
sr
tW
sn
sn
sn
sn
sn
sn
sn
sn
sn
sn
sn
sn
sn
sn
sn
sr
sr
sr
sr
sr
tW
KW
KW
KW
KW
"}
(30,1,1) = {"
KW
tW
sr
ge
sr
sr
sr
Nb
tW
sn
sn
sn
sn
sn
sn
sn
sn
sn
sn
sn
sn
sn
sn
sr
sr
Nb
sr
tW
tW
KW
KW
KW
KW
"}
(31,1,1) = {"
KW
tW
sr
sr
sr
Qs
sr
sr
tW
sn
sn
sn
sn
sn
sn
sn
sn
sn
sn
sn
sn
sn
sn
tW
sr
sr
sr
sr
tW
KW
KW
KW
KW
"}
(32,1,1) = {"
KW
tW
Nb
sr
sr
Nb
Qs
sr
sr
tW
sn
sn
sn
sn
sn
sn
sn
sn
sn
sn
sn
sn
tW
sr
sr
Nb
sr
tW
tW
KW
KW
KW
KW
"}
(33,1,1) = {"
KW
tW
sr
sr
sr
ge
sr
sr
Nb
tW
sn
sn
sn
sn
sn
sn
sn
sn
sn
sn
sn
sn
sn
sr
Qs
sr
Qs
tW
KW
KW
KW
KW
KW
"}
(34,1,1) = {"
KW
tW
Nb
sr
sr
Nb
sr
sr
sr
tW
sn
sn
sn
sn
sn
sn
sn
sn
sn
sn
sn
sn
tW
sr
sr
Nb
sr
tW
KW
sd
sd
KW
KW
"}
(35,1,1) = {"
KW
tW
sr
sr
sr
sr
sr
sr
tW
tW
tW
sn
sn
sn
sn
sn
sn
sn
sn
sn
sn
sn
tW
Nb
sr
sr
sr
tW
KW
sd
sd
KW
KW
"}
(36,1,1) = {"
KW
tW
tW
tW
sr
sr
sr
sr
tW
tW
tW
sn
sn
sn
sn
sn
sn
sn
sn
sn
sn
sn
tW
sr
sr
sr
Nb
tW
KW
sd
sd
KW
KW
"}
(37,1,1) = {"
KW
tW
tW
tW
sr
sr
sr
Nb
sr
tW
sn
sn
sn
sn
sn
sn
sn
sn
sn
sn
sn
sn
tW
tW
sr
sr
sr
tW
KW
sd
sd
KW
KW
"}
(38,1,1) = {"
KW
tW
sr
Nb
sr
Nb
sr
sr
ge
tW
sn
sn
sn
sn
sn
sn
sn
sn
sn
sn
sn
tW
tW
sr
Qs
sr
Nb
tW
KW
sd
sd
KW
sd
"}
(39,1,1) = {"
KW
tW
sr
sr
sr
sr
sr
sr
sr
tW
sn
sn
sn
sn
sn
sn
sn
sn
sn
sn
sn
tW
tW
Nb
sr
Qs
sr
tW
KW
sd
sd
KW
sd
"}
(40,1,1) = {"
KW
tW
sr
sr
sr
sr
sr
sr
sr
tW
sn
sn
sn
sn
sn
sn
sn
sn
sn
sn
sn
sn
tW
tW
sr
Nb
sr
tW
KW
KW
KW
KW
sd
"}
(41,1,1) = {"
KW
tW
Nb
sr
sr
sr
sr
sr
sr
tW
sn
sn
sn
sn
sn
sn
sn
sn
sn
sn
sn
sn
tW
tW
sr
sr
sr
tW
tW
KW
KW
KW
KW
"}
(42,1,1) = {"
KW
KW
sr
sr
Nb
sr
Qs
sr
Nb
tW
sn
sn
sn
sn
sn
sn
sn
sn
sn
sn
sn
sn
tW
sr
sr
sr
sr
ge
sr
KW
KW
KW
KW
"}
(43,1,1) = {"
KW
KW
KW
tW
sr
sr
ge
sr
sr
tW
sn
sn
sn
sn
sn
sn
sn
sn
sn
sn
sn
sn
tW
sr
sr
sr
ge
sr
sr
sr
KW
sr
sr
"}
(44,1,1) = {"
KW
KW
KW
tW
sr
sr
sr
sr
sr
tW
tW
sn
sn
sn
sn
sn
sn
sn
sn
sn
sn
tW
sr
sr
tW
sr
Nb
sr
tW
sr
sr
sr
sr
"}
(45,1,1) = {"
KW
KW
KW
tW
sr
tW
tW
sr
Nb
sr
tW
sn
sn
sn
sn
sn
sn
sn
sn
sn
tW
tW
sr
tW
tW
sr
sr
sr
sr
sr
Nb
sr
sr
"}
(46,1,1) = {"
KW
KW
KW
KW
sr
tW
tW
sr
sr
sr
tW
sn
sn
sn
sn
sn
sn
sn
sn
sn
tW
sr
Nb
tW
tW
sr
sr
Nb
sr
Ia
sr
sr
Nb
"}
(47,1,1) = {"
KW
KW
KW
KW
Nb
sr
sr
sr
Nb
sr
tW
sn
sn
sn
sn
sn
sn
sn
sn
tW
tW
sr
sr
sr
sr
sr
sr
tW
tW
sr
sr
sr
sr
"}
(48,1,1) = {"
KW
KW
KW
KW
sr
sr
sr
sr
sr
sr
tW
sn
sn
sn
sn
sn
sn
sn
sn
tW
sr
sr
sr
Nb
sr
Qs
sr
tW
tW
sr
sr
sr
sr
"}
(49,1,1) = {"
KW
KW
KW
KW
sr
sr
Nb
sr
sr
tW
tW
sn
sn
sn
sn
sn
sn
sn
tW
tW
sr
Nb
tW
tW
sr
sr
Qs
sr
sr
sr
Nb
sr
Qs
"}
(50,1,1) = {"
KW
KW
KW
KW
KW
sr
sr
sr
sr
tW
tW
sn
sn
sn
sn
sn
sn
tW
tW
sr
sr
sr
tW
tW
sr
AV
sr
sr
sr
sr
sr
Qs
sr
"}
(51,1,1) = {"
KW
KW
KW
KW
KW
sr
Qs
sr
Nb
sr
tW
tW
sn
sn
sn
sn
tW
tW
sr
Nb
sr
sr
sr
sr
sr
sr
Nb
sr
sr
sr
sr
sr
sr
"}
(52,1,1) = {"
KW
KW
KW
KW
KW
Qs
sr
sr
sr
sr
sr
tW
tW
sn
sn
tW
tW
sr
sr
sr
sr
tW
sr
ge
sr
sr
sr
tW
tW
Nb
sr
sr
KW
"}
(53,1,1) = {"
KW
KW
KW
KW
KW
sr
sr
AV
sr
sr
sr
sr
tW
sn
sn
tW
sr
Nb
sr
ge
sr
sr
sr
sr
Nb
sr
sr
tW
tW
sr
sr
sr
KW
"}
(54,1,1) = {"
KW
KW
KW
KW
KW
sr
sr
Nb
sr
sr
tW
sr
Nb
sr
sr
sr
sr
sr
sr
sr
sr
Nb
sr
tW
tW
sr
sr
sr
sr
sr
Nb
sr
KW
"}
(55,1,1) = {"
KW
KW
KW
KW
KW
Nb
sr
sr
sr
sr
sr
sr
sr
tW
tW
sr
Nb
sr
tW
tW
sr
sr
sr
tW
tW
sr
Nb
sr
tW
sr
sr
sr
KW
"}
(56,1,1) = {"
KW
KW
KW
KW
KW
sr
sr
tW
tW
sr
Nb
sr
sr
tW
tW
sr
sr
sr
tW
tW
sr
sr
sr
sr
sr
sr
Qs
sr
sr
sr
sr
Qs
KW
"}
(57,1,1) = {"
KW
KW
KW
KW
KW
sr
sr
tW
tW
sr
sr
Qs
sr
Nb
sr
sr
Qs
sr
sr
Nb
sr
sr
sr
sr
sr
Qs
sr
sr
Nb
sr
tW
tW
KW
"}
(58,1,1) = {"
KW
KW
KW
KW
KW
Qs
sr
sr
sr
sr
Qs
sr
sr
sr
sr
sr
sr
sr
sr
sr
sr
tW
sr
Nb
sr
sr
sr
sr
sr
tW
tW
KW
KW
"}
(59,1,1) = {"
KW
KW
KW
KW
KW
KW
sr
sr
sr
sr
sr
tW
tW
sr
Nb
sr
sr
Nb
sr
sr
sr
sr
sr
sr
sr
sr
Nb
sr
tW
tW
KW
KW
KW
"}
(60,1,1) = {"
KW
KW
KW
KW
KW
KW
sr
sr
Nb
sr
sr
tW
tW
sr
sr
tW
tW
sr
sr
sr
Nb
tW
tW
sr
sr
sr
sr
tW
tW
KW
KW
KW
KW
"}
(61,1,1) = {"
KW
KW
KW
KW
KW
KW
Nb
sr
sr
sr
sr
sr
sr
sr
sr
tW
tW
sr
sr
sr
sr
tW
tW
sr
Nb
sr
tW
tW
KW
KW
KW
KW
KW
"}
(62,1,1) = {"
KW
KW
KW
KW
KW
KW
KW
sr
sr
sr
Ia
sr
sr
sr
sr
sr
sr
sr
sr
sr
sr
sr
sr
sr
sr
sr
tW
KW
KW
KW
KW
KW
KW
"}
(63,1,1) = {"
KW
KW
KW
KW
KW
KW
KW
sr
tW
sr
sr
Nb
sr
sr
Nb
sr
sr
sr
tW
sr
Nb
sr
sr
sr
sr
sr
KW
KW
KW
KW
KW
KW
KW
"}
(64,1,1) = {"
KW
KW
KW
KW
KW
KW
KW
KW
sr
sr
sr
sr
sr
Qs
sr
sr
Qs
sr
sr
sr
sr
Qs
sr
sr
Nb
Qs
KW
KW
KW
KW
KW
KW
KW
"}
(65,1,1) = {"
KW
KW
KW
KW
KW
KW
KW
KW
sr
sr
sr
sr
sr
sr
sr
sr
KW
KW
sr
sr
sr
sr
Nb
sr
sr
sr
KW
KW
KW
KW
KW
KW
KW
"}
(66,1,1) = {"
KW
KW
KW
KW
KW
KW
KW
KW
KW
sr
Nb
sr
sr
sr
sr
KW
KW
KW
KW
sr
Nb
sr
sr
sr
sr
sr
KW
KW
sd
sd
sd
sd
KW
"}
(67,1,1) = {"
KW
KW
KW
KW
KW
KW
KW
KW
KW
sr
sr
tW
sr
sr
Nb
KW
KW
KW
KW
sr
sr
sr
sr
sr
Nb
sr
KW
KW
sd
sd
sd
sd
KW
"}
(68,1,1) = {"
KW
KW
KW
KW
KW
KW
KW
KW
KW
Nb
sr
sr
sr
sr
KW
KW
KW
KW
KW
KW
sr
Nb
sr
sr
tW
sr
KW
KW
sd
sd
sd
sd
KW
"}
(69,1,1) = {"
KW
KW
KW
KW
KW
KW
KW
KW
KW
KW
sr
sr
sr
sr
KW
KW
KW
KW
KW
KW
sr
sr
sr
sr
sr
sr
KW
KW
KW
KW
KW
KW
KW
"}
(70,1,1) = {"
KW
KW
KW
KW
KW
KW
KW
KW
KW
KW
sr
Nb
sr
sr
KW
KW
KW
KW
KW
KW
KW
sr
sr
sr
Nb
sr
KW
KW
sd
sd
sd
sd
KW
"}
(71,1,1) = {"
sd
sd
sd
sd
KW
sd
sd
sd
sd
KW
sr
sr
sr
sr
sr
KW
KW
KW
KW
KW
KW
sr
Nb
sr
sr
sr
KW
KW
sd
sd
sd
sd
KW
"}
(72,1,1) = {"
sd
sd
sd
sd
KW
sd
sd
sd
sd
KW
fo
fo
fo
fo
fo
KW
KW
KW
KW
KW
KW
np
fo
fo
fo
fo
KW
KW
sd
sd
sd
sd
KW
"}
(73,1,1) = {"
sd
sd
sd
sd
KW
sd
sd
sd
sd
KW
mI
mI
mI
Yi
Iz
KW
KW
KW
KW
KW
Yi
Iz
mI
mI
mI
Yi
KW
KW
KW
KW
KW
KW
KW
"}
(74,1,1) = {"
sd
sd
sd
sd
KW
sd
sd
sd
sd
KW
mI
Iz
pd
mI
mI
KW
KW
KW
KW
KW
mI
mI
mI
KW
KW
KW
KW
Jt
QO
yL
Ew
Df
QO
"}
(75,1,1) = {"
KW
KW
KW
KW
KW
KW
KW
KW
KW
KW
mI
mI
mI
mI
mI
KW
KW
KW
KW
mI
mI
mI
Iz
mI
KW
KW
KW
Za
TN
sv
hJ
GO
TN
"}
(76,1,1) = {"
sd
sd
sd
sd
KW
sd
sd
sd
sd
KW
mI
Iz
mI
mI
mI
mI
KW
KW
mI
mI
mI
mI
mI
mI
KW
KW
KW
Za
TN
Mh
Yl
BU
WQ
"}
(77,1,1) = {"
sd
sd
sd
sd
KW
sd
sd
sd
sd
KW
mI
mI
mI
mI
Iz
mI
KW
mI
mI
mI
mI
mI
Iz
KW
KW
KW
KW
Za
TN
hm
hJ
Lx
WQ
"}
(78,1,1) = {"
sd
sd
sd
sd
KW
sd
sd
sd
sd
KW
KW
mI
mI
mI
mI
mI
mI
mI
mI
Iz
mI
mI
KW
KW
KW
KW
KW
Za
TN
aP
hJ
kG
WQ
"}
(79,1,1) = {"
KW
KW
KW
KW
KW
KW
KW
KW
KW
KW
KW
KW
mI
Yi
mI
mI
Iz
mI
mI
mI
mI
mI
KW
KW
KW
KW
KW
Za
TN
CY
MT
CY
WQ
"}
(80,1,1) = {"
sd
sd
sd
sd
KW
sd
sd
sd
sd
KW
KW
KW
KW
mI
Yi
mI
mI
mI
mI
mI
Iz
mI
fo
mI
KW
KW
KW
Za
Bh
UY
UY
UY
UY
"}
