//MAP CONVERTED BY dmm2tgm.py THIS HEADER COMMENT PREVENTS RECONVERSION, DO NOT REMOVE
"aa" = (
/turf/open/floor/plating/ground/dirt,
/area/lv624/ground/caves/central3)
"af" = (
/obj/structure/rack,
/obj/item/stack/sheet/mineral/tritium{
	pixel_x = -4
	},
/turf/open/floor/tile/vault{
	dir = 8
	},
/area/lv624/ground/caves/central1)
"ag" = (
/obj/effect/ai_node,
/turf/open/floor/plating/ground/dirt,
/area/lv624/ground/caves/central2)
"ah" = (
/turf/open/floor/plating/ground/dirt,
/area/lv624/ground/caves/central2)
"ai" = (
/obj/structure/rack,
/turf/open/floor/tile/vault{
	dir = 8
	},
/area/lv624/ground/caves/central1)
"aj" = (
/obj/structure/rack,
/obj/item/tool/shovel,
/turf/open/floor/tile/vault{
	dir = 8
	},
/area/lv624/ground/caves/central1)
"ak" = (
/obj/effect/landmark/lv624/fog_blocker/xeno_spawn,
/turf/closed/wall/r_wall,
/area/lv624/ground/caves/rock)
"am" = (
/obj/machinery/miner/damaged/platinum,
/turf/open/floor/plating/ground/dirt,
/area/lv624/ground/caves/central1)
"an" = (
/turf/open/floor/tile/dark,
/area/lv624/ground/caves/central1)
"ap" = (
/obj/structure/rack,
/obj/item/stack/sheet/mineral/diamond{
	amount = 2
	},
/turf/open/floor/tile/vault{
	dir = 8
	},
/area/lv624/ground/caves/central1)
"au" = (
/turf/closed/mineral/smooth/indestructible,
/area/lv624/ground/caves/rock)
"aw" = (
/turf/closed/wall/r_wall,
/area/lv624/ground/caves/rock)
"az" = (
/turf/open/floor,
/area/lv624/ground/caves/central1)
"aD" = (
/obj/structure/rack,
/obj/item/stack/sheet/mineral/gold{
	amount = 2
	},
/obj/item/stack/sheet/mineral/platinum{
	pixel_x = -6
	},
/turf/open/floor/tile/vault{
	dir = 8
	},
/area/lv624/ground/caves/central1)
"aE" = (
/obj/structure/rack,
/obj/effect/spawner/random/engineering/pickaxe,
/turf/open/floor/tile/vault{
	dir = 8
	},
/area/lv624/ground/caves/central1)
"aG" = (
/obj/effect/landmark/weed_node,
/turf/open/floor/plating/ground/dirt,
/area/lv624/ground/caves/central2)
"aH" = (
/obj/effect/ai_node,
/turf/open/floor/plating/ground/dirt,
/area/lv624/ground/caves/central1)
"aI" = (
/turf/open/floor/plating/ground/dirt,
/area/lv624/ground/caves/central1)
"aJ" = (
/obj/structure/rack,
/obj/item/stack/sheet/mineral/silver{
	amount = 20
	},
/turf/open/floor/tile/vault{
	dir = 8
	},
/area/lv624/ground/caves/central1)
"aL" = (
/turf/closed/wall/r_wall,
/area/lv624/ground/caves/central1)
"aM" = (
/turf/closed/wall,
/area/lv624/ground/caves/central1)
"aO" = (
/obj/structure/rack,
/obj/item/stack/sheet/metal{
	amount = 50;
	pixel_x = 4;
	pixel_y = 4
	},
/obj/item/stack/sheet/metal{
	amount = 30
	},
/turf/open/floor/tile/vault{
	dir = 8
	},
/area/lv624/ground/caves/central1)
"aP" = (
/obj/machinery/miner/damaged/platinum,
/turf/open/floor/plating/ground/dirt,
/area/lv624/ground/caves/central2)
"aR" = (
/obj/effect/landmark/xeno_resin_door,
/turf/open/floor/plating/ground/dirt,
/area/lv624/ground/caves/central2)
"aS" = (
/obj/machinery/door/airlock/mainship/secure/locked/free_access{
	dir = 4;
	name = "\improper Mining Storage"
	},
/turf/open/floor/tile/dark,
/area/lv624/ground/caves/central1)
"aT" = (
/turf/closed/mineral/smooth,
/area/lv624/ground/caves/rock)
"aU" = (
/obj/structure/rack,
/obj/item/stack/sheet/mineral/iron{
	amount = 5
	},
/obj/item/stack/sheet/mineral/platinum,
/obj/machinery/light{
	dir = 8
	},
/obj/effect/landmark/lv624/fog_blocker/xeno_spawn,
/turf/open/floor/tile/vault{
	dir = 8
	},
/area/lv624/ground/caves/central1)
"aV" = (
/obj/effect/landmark/xeno_resin_wall,
/turf/open/floor/plating/ground/dirt,
/area/lv624/ground/caves/central2)
"aW" = (
/obj/structure/rack,
/obj/effect/landmark/lv624/fog_blocker/xeno_spawn,
/turf/open/floor/tile/vault{
	dir = 8
	},
/area/lv624/ground/caves/central1)
"aY" = (
/obj/effect/landmark/lv624/fog_blocker,
/turf/open/floor/plating/ground/dirt,
/area/lv624/ground/caves/central2)
"aZ" = (
/obj/effect/landmark/weed_node,
/obj/effect/landmark/xeno_resin_wall,
/turf/open/floor/plating/ground/dirt,
/area/lv624/ground/caves/central2)
"bN" = (
/obj/effect/landmark/lv624/fog_blocker,
/obj/effect/ai_node,
/turf/open/floor/plating/ground/dirt,
/area/lv624/ground/caves/central2)
"eD" = (
/obj/effect/landmark/weed_node,
/obj/effect/ai_node,
/turf/open/floor/plating/ground/dirt,
/area/lv624/ground/caves/central1)
"fk" = (
/obj/effect/landmark/xeno_silo_spawn,
/turf/open/floor/plating/ground/dirt,
/area/lv624/ground/caves/central2)
"ga" = (
/obj/effect/landmark/lv624/fog_blocker,
/obj/effect/landmark/lv624/fog_blocker/xeno_spawn,
/turf/closed/mineral/smooth,
/area/lv624/ground/caves/rock)
"sb" = (
/obj/effect/landmark/weed_node,
/obj/effect/ai_node,
/turf/open/floor/plating/ground/dirt,
/area/lv624/ground/caves/central2)
"su" = (
/obj/effect/landmark/weed_node,
/obj/effect/landmark/xeno_resin_wall,
/turf/open/floor/plating/ground/dirt,
/area/lv624/ground/caves/central1)
"Ai" = (
/obj/effect/landmark/xeno_resin_wall,
/turf/open/floor/plating/ground/dirt,
/area/lv624/ground/caves/central1)
"DE" = (
/obj/effect/landmark/xeno_resin_door,
/turf/open/floor/plating/ground/dirt,
/area/lv624/ground/caves/central3)
"Ft" = (
/obj/effect/landmark/weed_node,
/turf/open/floor/plating/ground/dirt,
/area/lv624/ground/caves/central1)
"It" = (
/obj/effect/landmark/xeno_resin_door,
/turf/open/floor/plating/ground/dirt,
/area/lv624/ground/caves/central1)
"Kf" = (
/obj/effect/landmark/excavation_site_spawner,
/turf/open/floor/plating/ground/dirt,
/area/lv624/ground/caves/central2)
"Kr" = (
/obj/structure/rack,
/obj/item/tool/shovel,
/obj/effect/landmark/lv624/fog_blocker/xeno_spawn,
/turf/open/floor/tile/vault{
	dir = 8
	},
/area/lv624/ground/caves/central1)
"PA" = (
/obj/effect/landmark/lv624/fog_blocker,
/turf/closed/mineral/smooth,
/area/lv624/ground/caves/rock)

(1,1,1) = {"
aT
aT
aT
aT
aT
aT
aT
aT
aT
aT
DE
DE
DE
DE
DE
aT
aT
aT
aT
aT
aT
aT
aT
aT
aT
aT
aT
aa
aa
aa
aa
aa
aa
"}
(2,1,1) = {"
aT
aT
aT
aT
aT
aT
aT
aT
aT
aT
aG
ah
ah
ah
ah
aT
aT
aT
aT
aT
aT
aT
aT
aT
aT
aT
aT
aT
aT
aT
aT
aT
aa
"}
(3,1,1) = {"
aT
aT
aT
aT
aT
aT
aT
aT
aT
aT
ah
ah
ah
ah
aG
aT
aT
aT
aT
aT
aT
aT
aT
aT
aT
aT
au
au
au
au
au
aT
aT
"}
(4,1,1) = {"
aT
aT
aT
aT
aT
aT
aT
aT
aT
aT
ah
aG
ah
ah
ah
aT
aT
aT
aT
aT
aT
aT
aT
aT
aT
aT
au
au
au
au
au
aT
aT
"}
(5,1,1) = {"
aT
aT
aT
aT
aT
aT
aT
aT
aT
aT
ah
ag
ah
ah
ag
aT
aT
aT
aT
aT
aT
aT
aT
aT
aT
aT
au
au
au
au
au
aT
aT
"}
(6,1,1) = {"
aT
aT
aT
aT
aT
aT
aT
aT
aT
aG
ah
ah
aG
ah
ah
aT
aT
aT
aT
aT
aT
aT
aT
aT
aT
aT
aT
aT
aT
aT
aT
aT
aT
"}
(7,1,1) = {"
aT
aT
aT
aT
aT
aT
aT
aT
aT
ah
ah
ah
ah
ah
ah
aG
aT
aT
aT
aT
aT
aT
aT
aT
aT
aT
aT
aT
aT
aT
aT
aT
aT
"}
(8,1,1) = {"
aT
aT
aT
aT
aT
aT
aT
aT
aT
aT
aG
ah
aV
aV
ah
ah
aT
aT
aT
aT
aT
aT
aT
aT
aT
aT
aT
aT
au
au
au
aT
aT
"}
(9,1,1) = {"
aT
aT
aT
aT
aT
aT
aT
aT
aT
aT
ah
ah
aV
aV
aG
ah
ah
aT
aT
aT
aT
aT
aT
aT
aT
aT
aT
aT
au
au
au
aT
aT
"}
(10,1,1) = {"
aT
aT
aT
aT
aT
aT
aT
aT
aT
aT
ah
aG
ah
ah
ah
aV
ah
aT
aT
aT
aT
aT
aT
aT
aT
aT
aT
aT
au
au
au
aT
aT
"}
(11,1,1) = {"
aT
aT
aT
aT
aT
aT
aT
aT
aT
aT
aT
ag
ah
ah
ah
ah
ah
aT
aT
aT
aT
aT
aT
aT
aT
aT
aT
aT
aT
aT
aT
aT
aT
"}
(12,1,1) = {"
aT
aT
aT
aT
aT
aT
aT
aT
aT
aT
aT
ah
ag
aG
ag
ah
aG
ah
aT
aT
aT
aT
aT
aT
aT
aT
aT
aT
aT
aT
aT
aT
aT
"}
(13,1,1) = {"
aT
aT
aT
aT
aT
aT
aT
aT
aT
aT
aT
ah
ah
aV
aV
ah
ah
ah
aT
aT
aT
aT
aT
aT
aT
aT
aT
aT
au
au
au
aT
aT
"}
(14,1,1) = {"
aT
aT
aT
aT
aT
aT
aT
aT
aT
aT
ah
aG
ah
aV
aV
aG
ah
ah
ah
aT
aT
aT
aT
aT
aT
aT
aT
aT
au
au
au
aT
aT
"}
(15,1,1) = {"
aT
aT
aT
aT
aT
aT
aT
aT
aT
aT
aT
ah
ah
aG
ah
ah
ah
aZ
ah
aT
aT
aT
aT
aT
aT
aT
aT
aT
au
au
au
aT
aT
"}
(16,1,1) = {"
aT
aT
PA
PA
PA
PA
PA
PA
PA
PA
PA
PA
bN
ah
ah
ah
aG
ah
ag
aT
aT
aT
aT
aT
aT
aT
aT
aT
aT
aT
aT
aT
aT
"}
(17,1,1) = {"
aT
aT
PA
aT
aT
aT
aT
aT
aT
aT
aT
aT
PA
ah
aV
ah
ah
ah
ah
aT
aT
aT
aT
aT
aT
aT
aT
aT
aT
aT
aT
aT
aT
"}
(18,1,1) = {"
aT
aT
PA
aT
aT
aT
aT
aT
aT
aT
aT
aT
PA
aT
ah
ah
ah
ah
ah
ah
aT
aT
aT
aT
aT
aT
aT
aT
aT
aT
aT
au
au
"}
(19,1,1) = {"
aT
aT
PA
aT
aT
aT
aT
aV
aV
aV
aV
aT
PA
ah
ah
aG
aV
aV
ah
aG
aT
aT
aT
aT
aT
aT
aT
aT
aT
aT
aT
au
au
"}
(20,1,1) = {"
aT
aT
PA
aT
aT
aT
ah
ah
ah
ah
aG
aR
aY
ah
ah
ah
aV
aV
ag
ah
ag
aT
aT
aT
aT
aT
aT
aT
aT
aT
aT
au
au
"}
(21,1,1) = {"
aT
aT
PA
aT
aT
ah
ah
aG
ah
ah
ah
aR
aY
aV
aG
ah
aG
ah
aG
ah
ah
aT
aT
aT
aT
aT
aT
aT
aT
aT
aT
aT
aT
"}
(22,1,1) = {"
aT
aT
PA
aT
aT
ag
ah
fk
ah
ah
ag
aR
aY
ah
ah
ah
ag
ah
ah
aV
ah
ah
aT
aT
aT
aT
aT
aT
aT
aT
aT
aT
aT
"}
(23,1,1) = {"
aT
aT
PA
aT
ah
ah
ah
ah
ah
aG
ah
aT
PA
aT
aT
ah
ah
aG
ah
ah
aG
ah
aT
aT
aT
aT
aT
aT
aT
aT
aT
aT
aT
"}
(24,1,1) = {"
aT
aT
PA
aT
aT
ah
ah
ah
ah
ah
aT
aT
PA
aT
aT
aT
ah
ah
aV
aV
ah
ah
ah
aT
aT
aT
aT
aT
aT
aT
aT
aT
aT
"}
(25,1,1) = {"
aT
aT
PA
aT
aT
ah
ah
ah
ah
aT
aT
aT
PA
aT
aT
ah
ah
Kf
aV
aZ
ah
ah
aG
aT
aT
aT
aT
aT
aT
aT
aT
aT
aT
"}
(26,1,1) = {"
aT
aT
PA
aT
aT
aT
aG
ah
aT
aT
aT
aT
PA
aT
aT
ah
ah
ah
ah
ah
ah
ah
ah
aT
aT
aT
aT
aT
aT
aT
aT
aT
aT
"}
(27,1,1) = {"
aT
aT
PA
PA
PA
PA
PA
PA
PA
PA
PA
PA
PA
aT
ah
ah
ag
aG
ah
ah
ag
ah
sb
aT
aT
aT
aT
aT
aT
aT
aT
aT
aT
"}
(28,1,1) = {"
aT
aT
aT
aT
aT
aT
aT
aT
aT
aT
aT
aT
ah
ah
aG
ah
ah
aV
aV
aV
aZ
ah
ah
ah
aT
aT
aT
aT
aT
aT
aT
aT
aT
"}
(29,1,1) = {"
aT
aT
aT
aT
aT
aT
aT
aT
aT
aT
aV
aV
ah
ah
aP
ah
ah
aV
aT
aT
aV
ah
ah
ah
aT
aT
aT
aT
aT
aT
aT
aT
aT
"}
(30,1,1) = {"
aT
aT
aT
aT
aT
aT
aT
aT
aT
aT
aZ
ag
ah
aG
ah
ah
ag
aT
aT
aT
aT
aV
aG
ah
ah
aT
aT
aT
aT
aT
aT
aT
aT
"}
(31,1,1) = {"
aT
aT
aT
aT
aT
aT
aT
aT
aT
aV
aV
ah
ah
ah
ah
ah
aG
aV
aT
aT
aT
aT
ah
ah
ah
aT
aT
aT
aT
aT
aT
aT
aT
"}
(32,1,1) = {"
aT
aT
aT
aT
aT
aT
aT
aT
aV
aV
ah
aG
ah
ah
aT
ah
ah
aV
aT
aT
aT
aT
ah
ah
aG
aT
aT
aT
aT
aT
aT
aT
aT
"}
(33,1,1) = {"
aT
aT
aT
aT
aT
aT
aT
aT
aV
sb
ah
ag
ah
aT
aT
ah
ah
ah
ah
aT
aT
ah
aG
ah
ah
aT
aT
aT
aT
aT
aT
aT
aT
"}
(34,1,1) = {"
aT
aT
aT
aT
aT
aT
aT
aZ
aV
ah
ah
ah
aT
aT
aT
aG
ag
ah
aG
ah
ag
ah
ag
aV
aT
aT
aT
aT
aT
au
au
aT
aT
"}
(35,1,1) = {"
aT
aT
aT
aT
aT
aT
aT
aV
ah
ah
ah
ah
aT
aT
aT
aT
aV
aV
aV
ah
ah
ah
ah
aV
aT
aT
aT
aT
aT
au
au
aT
aT
"}
(36,1,1) = {"
aT
aT
aT
aT
aT
aT
aV
aV
ah
aG
ah
aT
aT
aT
aT
aT
aT
aT
aV
aV
aG
ah
ah
aV
aV
aT
aT
aT
aT
au
au
aT
aT
"}
(37,1,1) = {"
aT
aT
aT
aT
aT
aT
aV
aV
ah
ah
aT
aT
aT
aT
aT
aT
aT
aT
aT
aV
ah
ah
ah
ah
aV
aT
aT
aT
aT
au
au
aT
aT
"}
(38,1,1) = {"
aT
aT
aT
aT
aT
aT
aT
aV
Kf
ah
ah
aT
aT
aT
aT
aT
aT
aT
aT
aV
ah
ah
aG
ah
aV
aT
aT
aT
aT
aT
aT
aT
au
"}
(39,1,1) = {"
aT
aT
aT
aT
aT
aT
aT
aZ
ah
ah
ah
aT
aT
aT
aT
aT
aT
aT
aT
aZ
ah
ah
ah
ah
aV
aT
aT
aT
aT
aT
aT
aT
au
"}
(40,1,1) = {"
aT
aT
aT
aT
aT
aT
aT
aV
ah
aG
ah
aT
aT
aT
aT
aT
aT
aT
aT
aV
ah
aV
aV
ah
aG
aT
aT
aT
aT
aT
aT
aT
au
"}
(41,1,1) = {"
aT
aT
aT
aT
aT
aT
aT
aV
ah
ag
ah
aT
aT
aT
aT
aT
aT
aT
aT
aT
ah
aV
aZ
ah
ah
aT
aT
aT
aT
aT
aT
aT
aT
"}
(42,1,1) = {"
aT
aT
aT
aT
aT
aT
aT
aV
aG
ah
aT
aT
aT
aT
aT
aT
aT
aT
aT
aT
ag
ah
aG
ah
ah
ah
aT
aT
aT
aT
aT
aT
aT
"}
(43,1,1) = {"
aT
aT
aT
aT
aT
aT
aT
aV
ah
ah
aT
aT
aT
aT
aT
aT
aT
aT
aT
aV
aG
ag
ah
ah
ah
aG
ah
ag
aT
aT
aT
aT
ah
"}
(44,1,1) = {"
aT
aT
aT
aT
aT
aT
aT
aV
ah
aG
ah
aT
aT
aT
aT
aT
aT
aT
aT
aZ
ah
ah
aT
aT
ah
ah
ah
ah
ah
ah
ah
ah
ah
"}
(45,1,1) = {"
aT
aT
aT
aT
aT
aT
aT
aT
ah
ah
ah
ah
aT
aT
aT
aT
aT
aT
aT
aV
ah
ah
aT
aT
aT
aT
ah
ah
aZ
ah
aG
ah
aG
"}
(46,1,1) = {"
aT
aT
aT
aT
aT
aT
aT
aT
aT
ag
aG
ah
ag
aT
aT
aT
aT
aT
aT
aV
ah
ah
ah
aT
aT
aT
aT
ah
ah
ah
ah
ah
ah
"}
(47,1,1) = {"
aT
aT
aT
aT
aT
aT
aT
aT
aT
aT
ah
ah
ah
aT
aT
aT
aT
aT
aT
aT
ah
aG
ah
aT
aT
aT
aT
ah
ah
aV
aV
ah
ah
"}
(48,1,1) = {"
aT
aT
aT
aT
aT
aT
aT
aT
aT
aT
ah
aG
ah
aT
aT
aT
aT
aT
aT
aT
aT
ah
Kf
ah
aT
aT
ah
ah
aG
aV
aV
aG
ah
"}
(49,1,1) = {"
aT
aT
aT
aT
aT
aT
aT
aT
aT
aT
ah
ah
ag
aT
aT
aT
aT
aT
aT
aT
aT
ag
ah
ah
ah
ah
ah
ag
ah
ah
ah
ag
ah
"}
(50,1,1) = {"
aT
aT
aT
aT
aT
aT
aT
aT
aT
ah
ah
aG
ah
aZ
aT
aT
aT
aT
aT
aT
ah
ah
aZ
aV
ah
ah
aG
ah
aT
ah
ah
ah
ah
"}
(51,1,1) = {"
aT
aT
aT
aT
aT
aT
aT
aT
aT
ah
aV
aV
ah
aV
aT
aT
aT
aT
aT
aT
aT
ah
aV
aV
aG
ah
ah
aT
aT
aT
aT
aT
ah
"}
(52,1,1) = {"
aT
aT
aT
aT
aT
aT
aT
aT
aT
ah
aV
aV
ah
aV
aT
aT
aT
aT
aT
aT
ah
ah
ah
ah
ah
aV
aT
aT
aT
aT
aT
aT
aT
"}
(53,1,1) = {"
aT
aT
aT
aT
aT
aT
aT
aT
aT
ah
ah
ah
aG
ah
aV
aV
aT
aT
aT
aT
ah
ah
ah
ah
ah
aV
aT
aT
aT
aT
aT
aT
aT
"}
(54,1,1) = {"
aT
aT
aT
aT
aT
aT
aT
aT
aT
aT
ah
ah
ah
ag
aG
ah
aV
aV
aV
aT
ah
ah
aG
aV
ah
aZ
aT
aT
aT
aT
aT
aT
aT
"}
(55,1,1) = {"
aT
aT
aT
aT
aT
aT
aT
aT
aT
aT
ah
aG
ag
ah
ah
ah
ah
ag
ah
ah
ah
sb
ah
ah
ah
aV
aT
aT
aT
aT
aT
aT
aT
"}
(56,1,1) = {"
aT
aT
aT
aT
aT
aT
aT
aT
aT
aT
aT
aT
ah
ah
ah
aG
aV
ah
aG
ah
aV
aV
ag
ah
aZ
aV
aT
aT
aT
aT
aT
aT
aT
"}
(57,1,1) = {"
aT
aT
aT
aT
aT
aT
aT
aT
aT
aT
aT
aT
aT
ah
aV
ah
ah
ah
ah
ah
aV
aV
ah
aV
aV
aT
aT
aT
aT
aT
aT
aT
aT
"}
(58,1,1) = {"
aT
aT
aT
aT
aT
aT
aT
aT
aT
aT
aT
ah
ah
ag
ah
ah
ah
ag
ah
ah
ah
ah
sb
aV
aT
aT
aT
aT
aT
aT
aT
aT
aT
"}
(59,1,1) = {"
aT
aT
aT
aT
aT
aT
aT
aT
aT
aT
ah
ah
ah
aP
ah
aG
aV
aV
aT
aT
ah
ah
ah
aV
aT
aT
aT
aT
aT
aT
aT
aT
aT
"}
(60,1,1) = {"
aT
aT
aT
aT
aT
aT
aT
aT
aT
ah
aG
aV
aG
ah
ah
aV
aV
aT
aT
aT
ah
ah
ah
aV
aT
aT
aT
aT
aT
aT
aT
aT
aT
"}
(61,1,1) = {"
aT
aT
aT
aT
aT
aT
aT
aT
aT
aT
ah
ag
ah
ag
ah
aV
aT
aT
aT
aT
ah
aG
ah
aT
aT
aT
aT
aT
aT
aT
aT
aT
aT
"}
(62,1,1) = {"
aT
aT
aT
aT
aT
aT
aT
aT
aT
aT
aT
ah
ah
aV
aV
aZ
aT
aT
aT
aT
ah
Kf
ah
aT
aT
aT
aT
aT
aT
aT
aT
aT
aT
"}
(63,1,1) = {"
aT
aT
aT
aT
aT
aT
aT
aT
aT
aT
aT
ah
ah
aV
aT
aT
aT
aT
aT
sb
ah
ah
ag
aG
aT
aT
aT
aT
aT
aT
aT
aT
aT
"}
(64,1,1) = {"
aT
aT
aT
aT
aT
aT
aT
aT
aT
aT
aT
ah
ah
aZ
aT
aT
aT
aT
aT
ah
ah
aV
ah
ah
aT
aT
aT
aT
aT
aT
aT
aT
aT
"}
(65,1,1) = {"
aT
aT
aT
aT
aT
aT
aT
aT
aT
aT
aT
ah
ah
aV
aT
aT
aT
aT
aT
ah
ah
aG
ah
ah
aT
aT
aT
aT
aT
aT
aT
aT
aT
"}
(66,1,1) = {"
aT
aT
aT
aT
aT
aT
aT
aT
aT
aT
ah
ag
ah
aV
aT
aT
aT
aT
aT
aT
aT
ah
ah
ah
aT
aT
aT
aT
au
au
au
au
aT
"}
(67,1,1) = {"
aT
aT
aT
aT
aT
aT
aT
aT
aT
aT
ah
aG
ah
aT
aT
aT
aT
aT
aT
aT
aT
ah
ah
aG
aT
aT
aT
aT
au
au
au
au
aT
"}
(68,1,1) = {"
aT
aT
aT
aT
aT
aT
aT
aT
aT
ah
ah
ah
ah
aT
aT
aT
aT
aT
aT
aT
aT
ah
ag
ah
ag
aT
aT
aT
au
au
au
au
aT
"}
(69,1,1) = {"
aT
aT
aT
aT
aT
aT
aT
aT
aT
ah
aG
ah
ah
aT
aT
aT
aT
aT
aT
aT
aT
sb
aV
aV
ah
ah
aT
aT
aT
aT
aT
aT
aT
"}
(70,1,1) = {"
aT
aT
aT
aT
aT
aT
aT
aT
aT
ah
ah
ah
ah
aG
aT
aT
aT
aT
aT
aT
aT
ah
aV
aZ
ah
ah
aT
aT
au
au
au
au
aT
"}
(71,1,1) = {"
au
au
au
au
aT
au
au
aT
aT
aT
ah
aG
ah
ah
aT
aT
aT
aT
aT
aT
aT
ah
ah
ah
ah
aG
aT
aT
au
au
au
au
aT
"}
(72,1,1) = {"
au
au
au
au
aT
au
au
au
au
aT
It
It
It
It
It
aT
aT
aT
aT
aT
aT
It
It
It
It
It
aT
aT
au
au
au
au
aT
"}
(73,1,1) = {"
au
au
au
au
aT
au
au
au
au
aT
aI
aI
Ft
aI
aI
aT
aT
aT
aT
aT
aI
aH
Ft
aI
aH
aI
aT
aT
aT
aT
aT
aT
aT
"}
(74,1,1) = {"
au
au
au
au
aT
au
au
au
au
aT
Ft
aH
aI
aI
eD
aT
aT
aT
aT
aT
Ft
aI
aI
aT
aT
aT
aT
ga
ak
Kr
aU
aW
ak
"}
(75,1,1) = {"
aT
aT
aT
aT
aT
aT
aT
aT
aT
aT
aI
aI
su
Ai
aI
aT
aT
aT
aT
aI
aI
am
aI
aI
aT
aT
aT
PA
aw
aD
an
af
aw
"}
(76,1,1) = {"
au
au
au
au
aT
au
au
au
au
aT
aI
aI
Ai
Ai
aI
aI
aT
aT
aI
Ft
aI
aI
aI
Ft
aT
aT
aT
PA
aw
ap
an
aJ
aL
"}
(77,1,1) = {"
au
au
au
au
aT
au
au
au
au
aT
aI
Ft
aI
aI
Ft
aI
aT
aH
aI
aI
aI
eD
aI
aT
aT
aT
aT
PA
aw
aO
an
ai
aL
"}
(78,1,1) = {"
au
au
au
au
aT
au
au
au
au
aT
aT
aI
aI
aI
aI
aI
aI
aI
Ai
Ai
aI
aI
aT
aT
aT
aT
aT
PA
aw
aj
an
aE
aL
"}
(79,1,1) = {"
aT
aT
aT
aT
aT
aT
aT
aT
aT
aT
aT
aT
aI
aI
aI
su
aI
aI
Ai
su
aI
aI
aT
aT
aT
aT
aT
PA
aw
aM
aS
aM
aL
"}
(80,1,1) = {"
au
au
au
au
aT
au
au
au
au
aT
aT
aT
aT
aI
aH
aI
aI
eD
aI
aI
aI
aH
It
aI
aT
aT
aT
PA
aT
az
az
az
az
"}
