//MAP CONVERTED BY dmm2tgm.py THIS HEADER COMMENT PREVENTS RECONVERSION, DO NOT REMOVE
"as" = (
/obj/effect/landmark/lv624/fog_blocker/xeno_spawn,
/turf/closed/wall/r_wall,
/area/lv624/ground/caves/rock)
"au" = (
/turf/open/ground/river,
/area/lv624/ground/caves/central2)
"aG" = (
/turf/open/ground/coast{
	dir = 8;
	icon_state = "beachcorner"
	},
/area/lv624/ground/caves/central2)
"bj" = (
/turf/closed/mineral/smooth,
/area/lv624/ground/caves/rock)
"bu" = (
/obj/effect/landmark/xeno_resin_wall,
/turf/open/floor/plating/ground/dirt,
/area/lv624/ground/caves/central1)
"eb" = (
/obj/effect/landmark/excavation_site_spawner,
/turf/open/floor/plating/ground/dirt,
/area/lv624/ground/caves/central2)
"eE" = (
/obj/structure/rack,
/obj/item/tool/shovel,
/turf/open/floor/tile/vault{
	dir = 8
	},
/area/lv624/ground/caves/central1)
"gn" = (
/turf/open/ground/coast{
	dir = 1
	},
/area/lv624/ground/caves/central2)
"gA" = (
/turf/open/ground/coast{
	dir = 9
	},
/area/lv624/ground/caves/central2)
"hq" = (
/turf/closed/mineral/smooth,
/area/lv624/ground/caves/central1)
"jG" = (
/turf/open/ground/coast{
	dir = 4;
	icon_state = "beachcorner"
	},
/area/lv624/ground/caves/central2)
"kc" = (
/turf/open/floor/plating/ground/dirt,
/area/lv624/ground/caves/central2)
"kd" = (
/obj/effect/ai_node,
/turf/open/floor/plating/ground/dirt,
/area/lv624/ground/caves/central2)
"ls" = (
/turf/open/ground/coast{
	icon_state = "beachcorner"
	},
/area/lv624/ground/caves/central2)
"np" = (
/obj/structure/rack,
/obj/item/stack/sheet/metal{
	amount = 50;
	pixel_x = 4;
	pixel_y = 4
	},
/obj/item/stack/sheet/metal{
	amount = 30
	},
/turf/open/floor/tile/vault{
	dir = 8
	},
/area/lv624/ground/caves/central1)
"nZ" = (
/obj/structure/rack,
/obj/item/stack/sheet/mineral/diamond{
	amount = 2
	},
/turf/open/floor/tile/vault{
	dir = 8
	},
/area/lv624/ground/caves/central1)
"oc" = (
/turf/closed/mineral/smooth/indestructible,
/area/lv624/ground/caves/rock)
"qJ" = (
/turf/open/ground/coast{
	dir = 6
	},
/area/lv624/ground/caves/central2)
"sG" = (
/obj/effect/landmark/lv624/fog_blocker,
/obj/effect/landmark/lv624/fog_blocker/xeno_spawn,
/turf/closed/mineral/smooth,
/area/lv624/ground/caves/rock)
"tz" = (
/obj/effect/landmark/xeno_resin_door,
/turf/open/floor/plating/ground/dirt,
/area/lv624/ground/caves/central1)
"uB" = (
/obj/effect/landmark/weed_node,
/obj/effect/landmark/xeno_resin_wall,
/turf/open/floor/plating/ground/dirt,
/area/lv624/ground/caves/central1)
"vy" = (
/obj/machinery/door/airlock/mainship/secure/locked/free_access{
	dir = 4;
	name = "\improper Mining Storage"
	},
/turf/open/floor/tile/dark,
/area/lv624/ground/caves/central1)
"xw" = (
/obj/effect/landmark/weed_node,
/obj/effect/ai_node,
/turf/open/floor/plating/ground/dirt,
/area/lv624/ground/caves/central2)
"yI" = (
/obj/structure/rack,
/obj/item/stack/sheet/mineral/tritium{
	pixel_x = -4
	},
/turf/open/floor/tile/vault{
	dir = 8
	},
/area/lv624/ground/caves/central1)
"By" = (
/obj/effect/landmark/xeno_resin_door,
/turf/open/floor/plating/ground/dirt,
/area/lv624/ground/caves/central3)
"Fv" = (
/obj/machinery/miner/damaged/platinum,
/turf/open/floor/plating/ground/dirt,
/area/lv624/ground/caves/central2)
"Gb" = (
/obj/structure/rack,
/obj/item/stack/sheet/mineral/iron{
	amount = 5
	},
/obj/item/stack/sheet/mineral/platinum,
/obj/machinery/light{
	dir = 8
	},
/obj/effect/landmark/lv624/fog_blocker/xeno_spawn,
/turf/open/floor/tile/vault{
	dir = 8
	},
/area/lv624/ground/caves/central1)
"HV" = (
/obj/effect/landmark/excavation_site_spawner,
/turf/open/floor/plating/ground/dirt,
/area/lv624/ground/caves/central1)
"Ic" = (
/turf/open/ground/coast{
	dir = 1;
	icon_state = "beachcorner"
	},
/area/lv624/ground/caves/central2)
"IQ" = (
/obj/structure/rack,
/turf/open/floor/tile/vault{
	dir = 8
	},
/area/lv624/ground/caves/central1)
"Ka" = (
/obj/effect/landmark/lv624/fog_blocker,
/turf/closed/mineral/smooth,
/area/lv624/ground/caves/rock)
"Kx" = (
/turf/open/floor/plating/ground/dirt,
/area/lv624/ground/caves/central3)
"KU" = (
/turf/closed/wall/r_wall,
/area/lv624/ground/caves/central1)
"Lu" = (
/obj/structure/rack,
/obj/item/tool/shovel,
/obj/effect/landmark/lv624/fog_blocker/xeno_spawn,
/turf/open/floor/tile/vault{
	dir = 8
	},
/area/lv624/ground/caves/central1)
"LK" = (
/obj/effect/landmark/xeno_resin_wall,
/turf/open/floor/plating/ground/dirt,
/area/lv624/ground/caves/central2)
"LL" = (
/obj/effect/landmark/weed_node,
/turf/open/floor/plating/ground/dirt,
/area/lv624/ground/caves/central2)
"MU" = (
/obj/structure/jungle/plantbot1/alien,
/turf/open/ground/river,
/area/lv624/ground/caves/central2)
"ND" = (
/turf/open/ground/coast{
	dir = 8
	},
/area/lv624/ground/caves/central2)
"OT" = (
/obj/structure/rack,
/obj/item/tool/pickaxe,
/turf/open/floor/tile/vault{
	dir = 8
	},
/area/lv624/ground/caves/central1)
"OY" = (
/turf/open/floor,
/area/lv624/ground/caves/central1)
"OZ" = (
/obj/effect/landmark/weed_node,
/turf/open/floor/plating/ground/dirt,
/area/lv624/ground/caves/central1)
"Qj" = (
/obj/effect/ai_node,
/turf/open/floor/plating/ground/dirt,
/area/lv624/ground/caves/central1)
"QS" = (
/turf/closed/wall/r_wall,
/area/lv624/ground/caves/rock)
"Rz" = (
/turf/open/ground/coast{
	icon_state = "beachcorner2"
	},
/area/lv624/ground/caves/central2)
"RL" = (
/obj/structure/rack,
/obj/item/stack/sheet/mineral/silver{
	amount = 20
	},
/turf/open/floor/tile/vault{
	dir = 8
	},
/area/lv624/ground/caves/central1)
"Te" = (
/obj/structure/rack,
/obj/item/stack/sheet/mineral/gold{
	amount = 2
	},
/obj/item/stack/sheet/mineral/platinum{
	pixel_x = -6
	},
/turf/open/floor/tile/vault{
	dir = 8
	},
/area/lv624/ground/caves/central1)
"Tr" = (
/obj/effect/landmark/weed_node,
/obj/effect/landmark/xeno_resin_wall,
/turf/open/floor/plating/ground/dirt,
/area/lv624/ground/caves/central2)
"Ux" = (
/turf/open/floor/plating/ground/dirt,
/area/lv624/ground/caves/central1)
"UK" = (
/turf/open/ground/coast{
	dir = 10
	},
/area/lv624/ground/caves/central2)
"UU" = (
/turf/open/floor/tile/dark,
/area/lv624/ground/caves/central1)
"Vp" = (
/obj/structure/rack,
/obj/effect/landmark/lv624/fog_blocker/xeno_spawn,
/turf/open/floor/tile/vault{
	dir = 8
	},
/area/lv624/ground/caves/central1)
"VW" = (
/turf/open/ground/coast{
	dir = 5
	},
/area/lv624/ground/caves/central2)
"WN" = (
/turf/open/ground/coast,
/area/lv624/ground/caves/central2)
"WW" = (
/turf/closed/wall,
/area/lv624/ground/caves/central1)

(1,1,1) = {"
bj
bj
bj
bj
bj
bj
bj
bj
bj
bj
By
By
By
By
By
bj
bj
bj
bj
bj
bj
bj
bj
bj
bj
bj
bj
Kx
Kx
Kx
Kx
Kx
Kx
"}
(2,1,1) = {"
bj
bj
bj
bj
bj
bj
bj
bj
bj
bj
kc
kc
kc
kc
kc
bj
bj
bj
bj
bj
bj
bj
bj
bj
bj
bj
bj
bj
bj
bj
bj
bj
Kx
"}
(3,1,1) = {"
bj
bj
bj
bj
bj
bj
bj
bj
bj
bj
kc
kc
kc
kc
kc
kc
kc
bj
bj
bj
bj
bj
bj
bj
bj
bj
oc
oc
oc
oc
oc
bj
bj
"}
(4,1,1) = {"
bj
bj
bj
bj
bj
bj
bj
bj
kc
kc
kc
kd
LL
kc
kc
kc
kc
kc
kd
kc
bj
bj
bj
bj
bj
bj
oc
oc
oc
oc
oc
bj
bj
"}
(5,1,1) = {"
bj
bj
bj
bj
bj
bj
bj
bj
kc
kc
kc
kc
kc
kc
kc
kc
kc
kc
kc
kc
kc
LK
bj
bj
bj
bj
oc
oc
oc
oc
oc
bj
bj
"}
(6,1,1) = {"
bj
bj
bj
bj
bj
bj
bj
bj
kc
Tr
LK
kc
kc
kc
kc
LK
Tr
kc
kc
kc
kc
LK
LK
bj
bj
bj
bj
bj
bj
bj
bj
bj
bj
"}
(7,1,1) = {"
bj
bj
bj
bj
bj
bj
bj
kc
kc
LK
LK
kc
kc
LL
kc
LK
LK
kc
kc
LL
kc
kc
LK
bj
bj
bj
bj
bj
bj
bj
bj
bj
bj
"}
(8,1,1) = {"
bj
bj
bj
bj
bj
bj
bj
kc
kc
kc
kc
kd
kc
kc
kc
kc
kc
kc
kd
kc
kc
kc
kc
LK
bj
bj
oc
oc
oc
oc
oc
bj
bj
"}
(9,1,1) = {"
bj
bj
bj
bj
bj
bj
bj
kc
kc
kc
kc
LL
kc
kc
bj
bj
bj
kc
kc
kc
kc
LL
kc
LK
bj
bj
oc
oc
oc
oc
oc
bj
bj
"}
(10,1,1) = {"
bj
bj
bj
bj
bj
bj
kc
kc
kc
eb
kc
kc
kc
kc
bj
bj
bj
bj
kc
kc
LK
kc
LK
LK
bj
bj
oc
oc
oc
oc
oc
bj
bj
"}
(11,1,1) = {"
bj
bj
bj
bj
bj
bj
kc
kc
kc
kc
LK
kc
kc
bj
bj
bj
bj
bj
kc
kc
kc
kc
LK
bj
bj
bj
bj
bj
bj
bj
bj
bj
bj
"}
(12,1,1) = {"
bj
bj
bj
bj
bj
bj
kc
LL
kc
kc
kc
kc
kc
kc
kc
bj
kc
kc
kd
kc
xw
kc
LK
bj
bj
bj
bj
bj
bj
bj
bj
bj
bj
"}
(13,1,1) = {"
bj
bj
bj
bj
bj
kc
kc
kc
kc
kc
LL
kc
kc
kc
kc
kc
kc
kc
kc
kc
kc
kc
LK
bj
bj
bj
oc
oc
oc
oc
oc
bj
bj
"}
(14,1,1) = {"
bj
bj
bj
bj
kc
kc
LK
kd
kc
kc
kc
kd
kc
kc
LL
kc
LK
LK
kc
kc
kc
kc
LK
bj
bj
bj
oc
oc
oc
oc
oc
bj
bj
"}
(15,1,1) = {"
bj
bj
bj
bj
kc
kc
kc
Fv
kc
kc
LK
LK
kd
kc
kc
kc
LK
LK
LL
kc
kc
kc
LK
bj
bj
bj
oc
oc
oc
oc
oc
bj
bj
"}
(16,1,1) = {"
bj
bj
bj
bj
kc
kc
LL
kc
LL
kc
LK
LK
kc
LK
LK
kc
kc
kc
kc
LK
kc
kc
LK
LK
bj
bj
bj
bj
bj
bj
bj
bj
bj
"}
(17,1,1) = {"
bj
bj
bj
bj
kc
kc
LK
kc
kc
kc
kc
kc
kc
kc
kc
kc
kc
kc
kc
kc
kc
kc
kc
LK
LK
bj
bj
bj
bj
bj
bj
bj
bj
"}
(18,1,1) = {"
bj
bj
bj
LK
kc
kc
kc
kc
kc
kc
kc
kc
LL
kc
kc
kc
kc
kc
LL
kc
kd
LL
kc
kd
LK
LK
bj
bj
bj
bj
oc
oc
oc
"}
(19,1,1) = {"
bj
bj
bj
LK
xw
kc
kc
kd
kc
kc
kc
kc
kd
kc
kc
ls
aG
kc
kc
kd
LK
LK
kc
kc
kc
kc
kc
bj
bj
bj
oc
oc
oc
"}
(20,1,1) = {"
bj
bj
bj
LK
kc
kc
bj
bj
bj
kc
kc
kc
kc
kc
ls
qJ
VW
aG
kc
kc
LK
LK
kc
kc
kc
kc
kc
kc
bj
bj
oc
oc
oc
"}
(21,1,1) = {"
bj
bj
bj
LK
kc
kc
kc
bj
bj
kc
kc
LL
kc
ls
Rz
au
au
VW
aG
kc
kc
kc
LL
kc
kc
Fv
kc
kc
bj
bj
bj
bj
bj
"}
(22,1,1) = {"
bj
bj
bj
LK
kc
kc
kc
kc
kc
kc
kc
kc
ls
Rz
au
au
au
au
VW
aG
kc
kc
kc
kc
LL
kc
LK
LK
kc
bj
bj
bj
bj
"}
(23,1,1) = {"
bj
bj
bj
LK
kc
kc
LL
kc
kc
kc
kc
kc
WN
au
MU
au
au
au
au
VW
aG
kc
LK
kc
kc
kc
LK
LK
kc
kc
bj
bj
bj
"}
(24,1,1) = {"
bj
bj
LK
LK
kc
LK
LK
kc
kc
LK
kc
kc
WN
au
au
au
au
au
au
au
gn
kc
kc
kd
kc
kc
kd
kc
LL
kc
bj
bj
bj
"}
(25,1,1) = {"
bj
bj
LK
Tr
kc
LK
LK
kc
kc
kc
kc
kc
WN
au
au
au
au
au
au
au
gn
kc
kd
bj
bj
kc
kc
kc
kc
kc
bj
bj
bj
"}
(26,1,1) = {"
bj
bj
LK
LK
kc
kc
kc
kc
kc
kc
LL
kc
WN
au
au
au
au
au
au
au
gn
kc
kc
bj
bj
bj
kc
kc
kc
bj
bj
bj
bj
"}
(27,1,1) = {"
bj
bj
bj
LK
kc
kc
kc
LL
kc
kc
kc
kc
Ic
UK
au
au
MU
au
au
au
gn
kc
kc
bj
bj
bj
kc
kc
kc
bj
bj
bj
bj
"}
(28,1,1) = {"
bj
bj
bj
LK
kc
kc
kc
kc
LK
LK
kc
kc
kd
WN
au
au
au
au
au
au
gn
kc
kc
kc
bj
kc
kc
LL
bj
bj
bj
bj
bj
"}
(29,1,1) = {"
bj
bj
bj
LK
LL
kc
kc
kc
LK
LK
kc
kc
kc
WN
au
au
au
au
au
MU
gn
kc
kd
kc
kc
kc
kd
kc
bj
bj
bj
bj
bj
"}
(30,1,1) = {"
bj
bj
bj
LK
kd
kc
kc
kc
kc
kd
kc
kc
kc
WN
au
au
au
au
au
gA
jG
LK
LK
kd
kc
kc
kc
kc
bj
bj
bj
bj
bj
"}
(31,1,1) = {"
bj
bj
bj
bj
kc
kc
bj
kc
kc
kc
LL
kc
kc
WN
au
au
au
au
au
gn
kc
LK
LK
LL
kc
kc
kc
kc
bj
bj
bj
bj
bj
"}
(32,1,1) = {"
bj
bj
bj
bj
kc
kc
bj
bj
bj
kc
kc
kc
kc
WN
au
au
au
au
au
gn
kc
kc
kc
kc
kc
kc
kc
bj
bj
bj
bj
bj
bj
"}
(33,1,1) = {"
bj
bj
bj
bj
kc
kc
bj
bj
bj
kd
kc
kd
kc
WN
au
au
au
au
au
gn
kc
LL
kc
kc
LK
LK
kc
bj
bj
bj
bj
bj
bj
"}
(34,1,1) = {"
bj
bj
bj
bj
kc
kc
LK
bj
bj
bj
kc
LL
kd
WN
au
au
au
au
au
gn
kc
kc
kc
kc
LK
LK
kc
bj
bj
oc
oc
bj
bj
"}
(35,1,1) = {"
bj
bj
bj
bj
kd
kc
LK
LK
bj
bj
bj
kc
kc
WN
au
au
MU
au
au
gn
LK
LK
kc
kc
kc
LL
kc
bj
bj
oc
oc
bj
bj
"}
(36,1,1) = {"
bj
bj
bj
bj
bj
kd
LL
LK
bj
bj
bj
kc
kc
WN
au
au
au
au
au
gn
LK
LK
LL
kc
kc
kc
kc
bj
bj
oc
oc
bj
bj
"}
(37,1,1) = {"
bj
bj
bj
bj
bj
kc
kc
LK
bj
bj
bj
kc
kc
WN
au
au
au
au
au
gn
kc
kc
kc
kd
kc
kc
kd
bj
bj
oc
oc
bj
bj
"}
(38,1,1) = {"
bj
bj
bj
bj
bj
kd
kc
LK
bj
bj
bj
kc
kc
Ic
UK
au
au
au
au
gn
kc
kc
kc
LK
LK
kc
kc
bj
bj
oc
oc
bj
oc
"}
(39,1,1) = {"
bj
bj
bj
bj
bj
bj
kd
kc
bj
bj
bj
kc
LL
kc
WN
au
au
au
au
VW
aG
kc
kc
LK
LK
kc
kc
LK
bj
oc
oc
bj
oc
"}
(40,1,1) = {"
bj
bj
bj
bj
bj
bj
kc
kc
kc
bj
bj
kd
kc
kc
WN
au
au
au
au
au
gn
kc
kc
kc
kc
LL
kc
LK
bj
bj
bj
bj
oc
"}
(41,1,1) = {"
bj
bj
bj
bj
bj
bj
kc
kc
kc
bj
bj
kc
kd
kc
WN
au
au
MU
au
au
gn
kc
kc
LL
kc
kc
kc
LK
LK
bj
bj
bj
bj
"}
(42,1,1) = {"
bj
bj
bj
bj
bj
bj
kc
kc
kc
bj
bj
kc
kc
LL
Ic
UK
au
au
au
au
gn
kc
kc
kc
kc
kc
kd
kc
LK
bj
bj
bj
bj
"}
(43,1,1) = {"
bj
bj
bj
bj
bj
bj
kc
kc
kc
bj
bj
kc
kc
kc
kc
WN
au
au
au
gA
jG
kc
kc
kc
LK
LK
kc
LL
LK
LK
bj
kc
kc
"}
(44,1,1) = {"
bj
bj
bj
bj
bj
bj
kc
kc
LL
bj
bj
kc
kc
kc
kc
WN
au
au
au
gn
kc
kc
LL
kc
LK
LK
kc
kc
kc
kc
kc
kc
kc
"}
(45,1,1) = {"
bj
bj
bj
bj
bj
bj
kd
kc
kc
kc
bj
bj
kc
kc
kc
WN
au
au
gA
jG
kc
kd
kc
kc
kc
LL
kd
kc
LL
kc
kd
kc
kc
"}
(46,1,1) = {"
bj
bj
bj
bj
bj
bj
bj
kd
kc
kc
bj
bj
kc
kc
kc
Ic
ND
ND
jG
kc
kc
kc
kc
LK
LK
LK
LK
kc
kc
eb
kc
kc
kc
"}
(47,1,1) = {"
bj
bj
bj
bj
bj
bj
bj
kc
xw
kc
kc
kc
kd
kc
LL
kc
kc
kc
kc
kc
LL
kd
LK
LK
bj
bj
bj
LK
kc
kc
kc
LL
kc
"}
(48,1,1) = {"
bj
bj
bj
bj
bj
bj
bj
kc
kc
kc
kc
LL
kc
kc
kc
kc
kc
LK
LK
LK
LK
LK
LK
bj
bj
bj
bj
bj
LK
LL
kc
kc
kc
"}
(49,1,1) = {"
bj
bj
bj
bj
bj
bj
bj
bj
LK
kc
kc
Fv
kc
kc
kc
LK
LK
LK
bj
bj
LK
bj
bj
bj
bj
bj
bj
bj
LK
kc
kc
kc
kc
"}
(50,1,1) = {"
bj
bj
bj
bj
bj
bj
bj
bj
LK
kc
kc
kc
kc
kc
LK
LK
bj
bj
bj
bj
bj
bj
bj
bj
bj
bj
bj
bj
LK
kc
kd
kc
kc
"}
(51,1,1) = {"
bj
bj
bj
bj
bj
bj
bj
bj
LK
kc
kc
kc
kc
kc
LK
bj
bj
bj
bj
bj
bj
bj
bj
bj
bj
bj
bj
LK
LK
kc
LL
kc
kc
"}
(52,1,1) = {"
bj
bj
bj
bj
bj
bj
bj
bj
LK
LK
Tr
kc
kd
bj
bj
bj
bj
bj
bj
bj
bj
bj
bj
bj
bj
bj
LK
LK
kc
kc
kc
LL
bj
"}
(53,1,1) = {"
bj
bj
bj
bj
bj
bj
bj
bj
LK
LK
LK
kd
bj
bj
bj
bj
bj
bj
bj
bj
bj
bj
bj
bj
bj
LK
LK
kc
LL
kc
kc
kc
bj
"}
(54,1,1) = {"
bj
bj
bj
bj
bj
bj
bj
bj
LK
LL
kc
kc
bj
bj
bj
bj
bj
bj
bj
bj
bj
bj
bj
LK
LK
LK
kc
kc
kc
kc
kc
bj
bj
"}
(55,1,1) = {"
bj
bj
bj
bj
bj
bj
bj
bj
LK
kc
kc
kc
kc
bj
bj
bj
bj
bj
bj
bj
bj
bj
LK
Tr
kc
kc
kd
kc
kc
kc
kd
bj
bj
"}
(56,1,1) = {"
bj
bj
bj
bj
bj
bj
bj
bj
LK
kc
kc
kc
kc
kc
kc
bj
bj
bj
bj
bj
bj
bj
LK
kc
kc
kc
kc
kc
kc
LL
bj
bj
bj
"}
(57,1,1) = {"
bj
bj
bj
bj
bj
bj
bj
LK
LK
kc
LL
kd
kc
kc
kc
kd
kc
bj
bj
kc
kc
kc
kc
kc
kc
kc
LL
kc
LK
LK
bj
bj
bj
"}
(58,1,1) = {"
bj
bj
bj
bj
bj
bj
bj
LK
kc
kc
kd
kc
kc
LL
LK
LK
kd
kc
kc
kd
LL
kc
kc
kd
kc
kc
kd
LK
LK
bj
bj
bj
bj
"}
(59,1,1) = {"
bj
bj
bj
bj
bj
bj
bj
LK
LL
kc
kc
kc
kc
kc
LK
LK
LL
kc
kc
kc
kc
kc
kc
kc
kc
kc
LK
LK
bj
bj
bj
bj
bj
"}
(60,1,1) = {"
bj
bj
bj
bj
bj
bj
bj
LK
kc
kc
kc
LK
LK
kc
kc
kc
kc
kc
kc
kc
LK
LK
kc
kc
LL
LK
LK
bj
bj
bj
bj
bj
bj
"}
(61,1,1) = {"
bj
bj
bj
bj
bj
bj
bj
bj
kc
kc
kd
LK
LK
kc
kc
kc
kc
kc
LL
kc
LK
LK
kc
kc
LK
LK
bj
bj
bj
bj
bj
bj
bj
"}
(62,1,1) = {"
bj
bj
bj
bj
bj
bj
bj
bj
kc
kc
eb
kc
LL
kc
kc
kc
kd
kc
kc
kc
kc
LL
kc
kc
LK
bj
bj
bj
bj
bj
bj
bj
bj
"}
(63,1,1) = {"
bj
bj
bj
bj
bj
bj
bj
bj
kc
kc
kc
kc
kc
kc
kc
LK
LK
LK
kc
kc
kc
kc
kc
kc
bj
bj
bj
bj
bj
bj
bj
bj
bj
"}
(64,1,1) = {"
bj
bj
bj
bj
bj
bj
bj
bj
kc
kc
kc
kc
kc
LL
LK
bj
bj
bj
LK
kc
kc
kc
kc
kc
bj
bj
bj
bj
bj
bj
bj
bj
bj
"}
(65,1,1) = {"
bj
bj
bj
bj
bj
bj
bj
bj
kc
kc
LL
kc
kc
kc
LK
bj
bj
bj
bj
LK
kc
LL
kc
kc
bj
bj
bj
bj
bj
bj
bj
bj
bj
"}
(66,1,1) = {"
bj
bj
bj
bj
bj
bj
bj
bj
bj
kc
kc
LK
LK
kc
bj
bj
bj
bj
bj
bj
LK
kc
kc
kd
bj
bj
bj
bj
oc
oc
oc
oc
bj
"}
(67,1,1) = {"
bj
bj
bj
bj
bj
bj
bj
bj
bj
kc
kc
LK
LK
kc
bj
bj
bj
bj
bj
bj
LK
kc
kd
kc
kc
bj
bj
bj
oc
oc
oc
oc
bj
"}
(68,1,1) = {"
bj
bj
bj
bj
bj
bj
bj
bj
bj
kc
kc
kc
LL
kc
bj
bj
bj
bj
bj
bj
LK
kc
kc
LL
kc
kc
bj
bj
oc
oc
oc
oc
bj
"}
(69,1,1) = {"
bj
bj
bj
bj
bj
bj
bj
bj
bj
bj
kc
kc
kc
kc
bj
bj
bj
bj
bj
bj
bj
kc
kc
LK
LK
kc
bj
bj
bj
bj
bj
bj
bj
"}
(70,1,1) = {"
bj
bj
bj
bj
bj
bj
bj
bj
bj
bj
kc
Fv
kc
kc
bj
bj
bj
bj
bj
bj
bj
kc
kc
LK
LK
kc
bj
bj
oc
oc
oc
oc
bj
"}
(71,1,1) = {"
oc
oc
oc
oc
bj
oc
oc
oc
oc
bj
kd
kc
kc
kc
kd
bj
bj
bj
bj
bj
bj
LL
kc
kc
kc
LL
bj
bj
oc
oc
oc
oc
bj
"}
(72,1,1) = {"
oc
oc
oc
oc
bj
oc
oc
oc
oc
bj
tz
tz
tz
tz
tz
bj
bj
bj
bj
bj
bj
tz
tz
tz
tz
tz
bj
bj
oc
oc
oc
oc
bj
"}
(73,1,1) = {"
oc
oc
oc
oc
bj
oc
oc
oc
oc
bj
Ux
Ux
Ux
Ux
Ux
bj
bj
bj
bj
bj
Ux
Ux
Ux
Ux
Ux
Ux
bj
bj
bj
bj
bj
bj
bj
"}
(74,1,1) = {"
oc
oc
oc
oc
bj
oc
oc
oc
oc
bj
Ux
Ux
HV
Ux
Ux
bj
bj
bj
bj
bj
Ux
Ux
Ux
bj
bj
bj
bj
sG
as
Lu
Gb
Vp
as
"}
(75,1,1) = {"
bj
bj
bj
bj
bj
bj
bj
bj
bj
bj
Ux
OZ
Ux
OZ
Ux
bj
bj
bj
bj
Ux
Ux
OZ
Ux
Ux
bj
bj
bj
Ka
QS
Te
UU
yI
QS
"}
(76,1,1) = {"
oc
oc
oc
oc
bj
oc
oc
oc
oc
bj
Ux
Ux
bu
bu
Qj
Ux
bj
bj
Ux
Ux
Ux
Ux
Ux
OZ
bj
bj
bj
Ka
QS
nZ
UU
RL
KU
"}
(77,1,1) = {"
oc
oc
oc
oc
bj
oc
oc
oc
oc
bj
Ux
Ux
bu
uB
Ux
Qj
bj
Qj
Ux
OZ
Ux
Ux
Qj
bj
bj
bj
bj
Ka
QS
np
UU
IQ
KU
"}
(78,1,1) = {"
oc
oc
oc
oc
bj
oc
oc
oc
oc
bj
bj
Ux
Ux
Ux
Ux
Ux
Qj
Ux
Ux
Ux
Ux
Ux
bj
bj
bj
bj
bj
Ka
QS
eE
UU
OT
KU
"}
(79,1,1) = {"
bj
bj
bj
bj
bj
bj
bj
bj
bj
bj
bj
bj
Ux
Ux
Ux
Ux
Ux
Ux
OZ
Ux
Ux
Ux
bj
bj
bj
bj
bj
Ka
QS
WW
vy
WW
KU
"}
(80,1,1) = {"
oc
oc
oc
oc
bj
oc
oc
oc
oc
bj
bj
bj
bj
Ux
Ux
Ux
OZ
Ux
Ux
Ux
Ux
OZ
tz
Ux
bj
bj
bj
Ka
hq
OY
OY
OY
OY
"}
