//MAP CONVERTED BY dmm2tgm.py THIS HEADER COMMENT PREVENTS RECONVERSION, DO NOT REMOVE
"au" = (
/turf/open/floor/plating/ground/dirt,
/area/lv624/ground/caves/central1)
"ay" = (
/obj/structure/rack,
/turf/open/floor/tile/vault{
	dir = 8
	},
/area/lv624/ground/caves/central1)
"aC" = (
/atom/movable/effect/decal/cleanable/dirt,
/turf/open/floor/wood,
/area/lv624/ground/caves/central2)
"bu" = (
/atom/movable/effect/landmark/excavation_site_spawner,
/turf/open/floor/plating/ground/dirt,
/area/lv624/ground/caves/central2)
"bS" = (
/atom/movable/effect/ai_node,
/turf/open/floor/wood,
/area/lv624/ground/caves/central2)
"cb" = (
/obj/structure/bed/alien,
/atom/movable/effect/landmark/corpsespawner/colonist,
/turf/open/floor/wood,
/area/lv624/ground/caves/central2)
"cO" = (
/turf/open/ground/coast{
	dir = 4
	},
/area/lv624/ground/caves/central2)
"dp" = (
/atom/movable/effect/landmark/excavation_site_spawner,
/turf/open/floor/plating/ground/dirt,
/area/lv624/ground/caves/central1)
"dv" = (
/obj/item/storage/firstaid/regular,
/atom/movable/effect/decal/cleanable/blood/drip,
/turf/open/floor/wood,
/area/lv624/ground/caves/central2)
"eE" = (
/obj/item/ammo_casing/shell,
/turf/open/floor/wood{
	icon_state = "wood-broken3"
	},
/area/lv624/ground/caves/central2)
"eF" = (
/obj/structure/table/woodentable,
/obj/item/weapon/gun/rifle/standard_lmg,
/turf/open/floor/wood,
/area/lv624/ground/caves/central2)
"eH" = (
/obj/structure/table/woodentable,
/obj/item/tool/kitchen/knife/butcher,
/obj/item/tool/kitchen/knife/butcher{
	pixel_y = 6
	},
/turf/open/floor/wood,
/area/lv624/ground/caves/central2)
"fA" = (
/atom/movable/effect/decal/cleanable/blood/splatter,
/obj/item/weapon/twohanded/fireaxe,
/atom/movable/effect/landmark/corpsespawner/colonist,
/turf/open/floor/wood,
/area/lv624/ground/caves/central2)
"fJ" = (
/turf/open/floor/wood/broken,
/area/lv624/ground/caves/central2)
"gF" = (
/obj/structure/closet/crate,
/turf/open/floor/wood,
/area/lv624/ground/caves/central2)
"gM" = (
/obj/structure/largecrate/supply/explosives/mortar_flare,
/turf/open/floor/wood,
/area/lv624/ground/caves/central2)
"hh" = (
/atom/movable/effect/landmark/weed_node,
/turf/open/floor/plating/ground/dirt,
/area/lv624/ground/caves/central1)
"id" = (
/obj/structure/rack,
/obj/item/tool/shovel,
/atom/movable/effect/landmark/lv624/fog_blocker/xeno_spawn,
/turf/open/floor/tile/vault{
	dir = 8
	},
/area/lv624/ground/caves/central1)
"iu" = (
/turf/closed/mineral/smooth/indestructible,
/area/lv624/ground/caves/rock)
"iB" = (
/atom/movable/effect/landmark/xeno_resin_door,
/turf/open/floor/plating/ground/dirt,
/area/lv624/ground/caves/central3)
"iE" = (
/atom/movable/effect/decal/cleanable/blood/drip,
/turf/open/floor/wood{
	icon_state = "wood-broken6"
	},
/area/lv624/ground/caves/central2)
"iN" = (
/turf/open/floor/plating/ground/dirt,
/area/lv624/ground/caves/central3)
"iV" = (
/obj/structure/bed/alien,
/turf/open/floor/wood,
/area/lv624/ground/caves/central2)
"jb" = (
/obj/structure/flora/ausbushes/reedbush,
/turf/open/ground/river,
/area/lv624/ground/caves/central2)
"jl" = (
/obj/structure/closet/cabinet,
/turf/open/floor/wood,
/area/lv624/ground/caves/central2)
"jn" = (
/obj/structure/window_frame/wood,
/turf/open/floor/wood,
/area/lv624/ground/caves/central2)
"jx" = (
/atom/movable/effect/landmark/lv624/fog_blocker,
/atom/movable/effect/landmark/lv624/fog_blocker/xeno_spawn,
/turf/closed/mineral/smooth,
/area/lv624/ground/caves/rock)
"jD" = (
/atom/movable/effect/ai_node,
/turf/open/floor/tile/dark,
/area/lv624/ground/caves/central1)
"kp" = (
/turf/open/ground/coast{
	dir = 1;
	icon_state = "beachcorner"
	},
/area/lv624/ground/caves/central2)
"kE" = (
/obj/structure/rack,
/obj/item/stack/sheet/mineral/iron{
	amount = 5
	},
/obj/item/stack/sheet/mineral/platinum,
/obj/machinery/light{
	dir = 8
	},
/atom/movable/effect/landmark/lv624/fog_blocker/xeno_spawn,
/turf/open/floor/tile/vault{
	dir = 8
	},
/area/lv624/ground/caves/central1)
"kK" = (
/obj/structure/table/woodentable,
/obj/item/reagent_containers/food/snacks/meat,
/obj/item/reagent_containers/food/snacks/meat{
	pixel_y = 3
	},
/obj/item/reagent_containers/food/snacks/meat{
	pixel_y = 6
	},
/turf/open/floor/wood,
/area/lv624/ground/caves/central2)
"lb" = (
/turf/open/ground/coast{
	dir = 8
	},
/area/lv624/ground/caves/central2)
"lu" = (
/obj/structure/closet/crate,
/atom/movable/effect/spawner/random/ammo/shotgun,
/turf/open/floor/wood,
/area/lv624/ground/caves/central2)
"lF" = (
/obj/vehicle/ridden/wheelchair,
/turf/open/floor/wood,
/area/lv624/ground/caves/central2)
"mh" = (
/obj/structure/table/woodentable,
/atom/movable/effect/spawner/random/ammo/machinegun,
/atom/movable/effect/spawner/random/ammo/machinegun{
	pixel_x = -5;
	pixel_y = 6
	},
/turf/open/floor/wood,
/area/lv624/ground/caves/central2)
"ne" = (
/obj/structure/table/woodentable,
/atom/movable/effect/spawner/random/ammo/shotgun,
/turf/open/floor/carpet/side{
	dir = 10;
	
	},
/area/lv624/ground/caves/central2)
"op" = (
/atom/movable/effect/spawner/random/trash,
/turf/open/floor/plating/ground/dirt,
/area/lv624/ground/caves/central2)
"os" = (
/obj/structure/table/woodentable,
/obj/machinery/microwave,
/turf/open/floor/wood,
/area/lv624/ground/caves/central2)
"ou" = (
/obj/structure/rack,
/obj/item/stack/sheet/mineral/tritium{
	pixel_x = -4
	},
/turf/open/floor/tile/vault{
	dir = 8
	},
/area/lv624/ground/caves/central1)
"ph" = (
/turf/open/floor/wood{
	icon_state = "wood-broken2"
	},
/area/lv624/ground/caves/central2)
"pi" = (
/turf/open/ground/coast{
	dir = 8;
	icon_state = "beachcorner2"
	},
/area/lv624/ground/caves/central2)
"pD" = (
/atom/movable/effect/landmark/weed_node,
/atom/movable/effect/ai_node,
/turf/open/floor/plating/ground/dirt,
/area/lv624/ground/caves/central2)
"pE" = (
/atom/movable/effect/ai_node,
/turf/open/floor/plating/ground/dirt,
/area/lv624/ground/caves/central2)
"pJ" = (
/turf/open/floor/wood{
	icon_state = "wood-broken3"
	},
/area/lv624/ground/caves/central2)
"pP" = (
/obj/item/flashlight/lantern,
/obj/structure/table/woodentable,
/turf/open/floor/wood,
/area/lv624/ground/caves/central2)
"pR" = (
/turf/open/ground/coast{
	dir = 8;
	icon_state = "beachcorner"
	},
/area/lv624/ground/caves/central2)
"qq" = (
/turf/open/floor/tile/dark,
/area/lv624/ground/caves/central1)
"qD" = (
/obj/structure/table/woodentable,
/obj/item/tool/candle,
/obj/item/tool/match{
	pixel_x = 5;
	pixel_y = 2
	},
/turf/open/floor/carpet/side{
	
	},
/area/lv624/ground/caves/central2)
"qI" = (
/obj/structure/table/woodentable,
/obj/item/weapon/gun/shotgun/double,
/turf/open/floor/wood,
/area/lv624/ground/caves/central2)
"qW" = (
/atom/movable/effect/ai_node,
/turf/open/floor/wood{
	icon_state = "wood-broken6"
	},
/area/lv624/ground/caves/central2)
"ro" = (
/obj/item/ammo_casing/shell,
/turf/open/floor/wood{
	icon_state = "wood-broken4"
	},
/area/lv624/ground/caves/central2)
"sl" = (
/obj/structure/rack,
/obj/item/stack/sheet/mineral/gold{
	amount = 2
	},
/obj/item/stack/sheet/mineral/platinum{
	pixel_x = -6
	},
/turf/open/floor/tile/vault{
	dir = 8
	},
/area/lv624/ground/caves/central1)
"sv" = (
/obj/structure/closet/secure_closet/freezer/fridge,
/turf/open/floor/wood{
	icon_state = "wood-broken3"
	},
/area/lv624/ground/caves/central2)
"sH" = (
/obj/structure/barricade/sandbags{
	dir = 4
	},
/turf/open/floor/wood,
/area/lv624/ground/caves/central2)
"sL" = (
/obj/machinery/door/airlock/sandstone,
/turf/open/floor/wood,
/area/lv624/ground/caves/central2)
"sR" = (
/turf/closed/wall/r_wall,
/area/lv624/ground/caves/rock)
"ti" = (
/obj/structure/barricade/sandbags,
/turf/open/floor/wood,
/area/lv624/ground/caves/central2)
"us" = (
/obj/item/storage/firstaid/fire,
/turf/open/floor/wood,
/area/lv624/ground/caves/central2)
"ut" = (
/obj/structure/barricade/sandbags{
	dir = 1
	},
/turf/open/floor/wood{
	icon_state = "wood-broken1"
	},
/area/lv624/ground/caves/central2)
"uy" = (
/atom/movable/effect/decal/cleanable/blood/drip,
/turf/open/floor/wood{
	icon_state = "wood-broken4"
	},
/area/lv624/ground/caves/central2)
"uV" = (
/turf/closed/wall/wood,
/area/lv624/ground/caves/central2)
"vb" = (
/atom/movable/effect/ai_node,
/turf/open/floor/wood{
	icon_state = "wood-broken1"
	},
/area/lv624/ground/caves/central2)
"ve" = (
/turf/open/ground/coast{
	icon_state = "beachcorner"
	},
/area/lv624/ground/caves/central2)
"vi" = (
/obj/item/ammo_casing/shell,
/turf/open/floor/wood{
	icon_state = "wood-broken6"
	},
/area/lv624/ground/caves/central2)
"vk" = (
/turf/closed/mineral/smooth,
/area/lv624/ground/caves/rock)
"vt" = (
/obj/structure/rack,
/obj/item/stack/sheet/metal{
	amount = 50;
	pixel_x = 4;
	pixel_y = 4
	},
/obj/item/stack/sheet/metal{
	amount = 30
	},
/turf/open/floor/tile/vault{
	dir = 8
	},
/area/lv624/ground/caves/central1)
"vz" = (
/obj/structure/jungle/plantbot1/alien,
/turf/open/ground/river,
/area/lv624/ground/caves/central2)
"vE" = (
/turf/open/floor/wood{
	icon_state = "wood-broken4"
	},
/area/lv624/ground/caves/central2)
"vN" = (
/atom/movable/effect/spawner/random/clothing,
/turf/open/floor/wood,
/area/lv624/ground/caves/central2)
"wL" = (
/obj/structure/rack,
/obj/item/stack/sheet/mineral/silver{
	amount = 20
	},
/turf/open/floor/tile/vault{
	dir = 8
	},
/area/lv624/ground/caves/central1)
"xm" = (
/obj/structure/table/woodentable,
/atom/movable/effect/spawner/random/ammo/machinegun,
/atom/movable/effect/spawner/random/gun/machineguns{
	pixel_x = -2;
	pixel_y = 2
	},
/turf/open/floor/wood{
	icon_state = "wood-broken1"
	},
/area/lv624/ground/caves/central2)
"xD" = (
/obj/structure/bed/chair/wood/wings,
/turf/open/floor/wood,
/area/lv624/ground/caves/central2)
"xI" = (
/obj/structure/table/woodentable,
/atom/movable/effect/spawner/random/ammo/shotgun,
/turf/open/floor/carpet/side{
	dir = 1;
	
	},
/area/lv624/ground/caves/central2)
"yy" = (
/obj/structure/largecrate/supply/ammo/standard_hmg,
/turf/open/floor/wood,
/area/lv624/ground/caves/central2)
"za" = (
/atom/movable/effect/landmark/xeno_resin_door,
/atom/movable/effect/ai_node,
/turf/open/floor/plating/ground/dirt,
/area/lv624/ground/caves/central1)
"zz" = (
/atom/movable/effect/ai_node,
/turf/open/ground/coast{
	dir = 5
	},
/area/lv624/ground/caves/central2)
"zK" = (
/obj/machinery/miner/damaged/platinum,
/turf/open/floor/plating/ground/dirt,
/area/lv624/ground/caves/central2)
"BO" = (
/obj/structure/barricade/sandbags{
	dir = 4
	},
/atom/movable/effect/ai_node,
/turf/open/floor/wood,
/area/lv624/ground/caves/central2)
"BP" = (
/obj/structure/table/woodentable,
/obj/item/flashlight/lantern,
/turf/open/floor/carpet/side{
	dir = 6;
	
	},
/area/lv624/ground/caves/central2)
"Dm" = (
/atom/movable/effect/landmark/lv624/fog_blocker/xeno_spawn,
/turf/closed/wall/r_wall,
/area/lv624/ground/caves/rock)
"DD" = (
/turf/open/floor/wood{
	icon_state = "wood-broken7"
	},
/area/lv624/ground/caves/central2)
"DE" = (
/obj/structure/rack,
/obj/item/tool/pickaxe,
/turf/open/floor/tile/vault{
	dir = 8
	},
/area/lv624/ground/caves/central1)
"DG" = (
/obj/structure/barricade/sandbags{
	dir = 1
	},
/turf/open/floor/wood,
/area/lv624/ground/caves/central2)
"EQ" = (
/turf/closed/mineral/smooth,
/area/lv624/ground/caves/central2)
"Ge" = (
/obj/structure/flora/ausbushes/fernybush,
/turf/open/ground/river,
/area/lv624/ground/caves/central2)
"Gm" = (
/obj/item/ammo_casing/shell,
/turf/open/floor/wood,
/area/lv624/ground/caves/central2)
"GF" = (
/atom/movable/effect/landmark/xeno_resin_wall,
/turf/open/floor/plating/ground/dirt,
/area/lv624/ground/caves/central2)
"GS" = (
/obj/structure/table/woodentable,
/obj/item/tool/candle,
/obj/item/stack/sheet/metal{
	pixel_x = 3
	},
/turf/open/floor/carpet/side{
	dir = 9;
	
	},
/area/lv624/ground/caves/central2)
"GZ" = (
/obj/structure/bed/chair/wood/wings{
	dir = 1
	},
/turf/open/floor/wood,
/area/lv624/ground/caves/central2)
"Hb" = (
/turf/open/ground/river,
/area/lv624/ground/caves/central2)
"Hl" = (
/obj/structure/closet/crate/freezer/rations,
/turf/open/floor/wood,
/area/lv624/ground/caves/central2)
"Hu" = (
/obj/structure/rack,
/atom/movable/effect/landmark/lv624/fog_blocker/xeno_spawn,
/turf/open/floor/tile/vault{
	dir = 8
	},
/area/lv624/ground/caves/central1)
"Hy" = (
/atom/movable/effect/landmark/weed_node,
/turf/open/floor/plating/ground/dirt,
/area/lv624/ground/caves/central2)
"Hz" = (
/obj/structure/barricade/sandbags{
	dir = 4
	},
/obj/structure/closet/cabinet,
/turf/open/floor/wood,
/area/lv624/ground/caves/central2)
"HD" = (
/obj/machinery/door/airlock/mainship/secure/locked/free_access{
	dir = 4;
	name = "\improper Mining Storage"
	},
/turf/open/floor/tile/dark,
/area/lv624/ground/caves/central1)
"HO" = (
/atom/movable/effect/decal/cleanable/blood/splatter,
/atom/movable/effect/landmark/corpsespawner/colonist,
/turf/open/floor/wood,
/area/lv624/ground/caves/central2)
"Ik" = (
/obj/structure/barricade/sandbags,
/turf/open/floor/wood{
	icon_state = "wood-broken3"
	},
/area/lv624/ground/caves/central2)
"In" = (
/turf/open/floor,
/area/lv624/ground/caves/central1)
"IL" = (
/turf/closed/wall,
/area/lv624/ground/caves/central1)
"IR" = (
/atom/movable/effect/landmark/corpsespawner/colonist,
/atom/movable/effect/decal/cleanable/blood/splatter,
/turf/open/floor/wood,
/area/lv624/ground/caves/central2)
"IZ" = (
/obj/structure/largecrate/supply/ammo/shotgun,
/turf/open/floor/wood,
/area/lv624/ground/caves/central2)
"Ke" = (
/obj/structure/kitchenspike,
/atom/movable/effect/decal/cleanable/blood/splatter,
/turf/open/floor/wood,
/area/lv624/ground/caves/central2)
"Kj" = (
/atom/movable/effect/decal/cleanable/blood/drip,
/turf/open/floor/wood,
/area/lv624/ground/caves/central2)
"Ky" = (
/obj/machinery/door/airlock/sandstone,
/atom/movable/effect/ai_node,
/turf/open/floor/wood,
/area/lv624/ground/caves/central2)
"KG" = (
/turf/open/ground/coast{
	dir = 1
	},
/area/lv624/ground/caves/central2)
"Ln" = (
/turf/open/ground/coast{
	dir = 5
	},
/area/lv624/ground/caves/central2)
"Md" = (
/obj/structure/table/woodentable,
/atom/movable/effect/spawner/random/ammo/machinegun,
/atom/movable/effect/spawner/random/gun/machineguns{
	pixel_x = -2;
	pixel_y = 6
	},
/turf/open/floor/wood,
/area/lv624/ground/caves/central2)
"Mk" = (
/obj/item/flashlight/flare,
/turf/open/floor/plating/ground/dirt,
/area/lv624/ground/caves/central2)
"Mo" = (
/obj/item/stack/sheet/wood,
/turf/open/floor/plating/ground/dirt,
/area/lv624/ground/caves/central2)
"MN" = (
/turf/open/floor/wood,
/area/lv624/ground/caves/central2)
"MQ" = (
/atom/movable/effect/landmark/corpsespawner/colonist,
/atom/movable/effect/decal/cleanable/blood/splatter,
/turf/open/floor/wood{
	icon_state = "wood-broken6"
	},
/area/lv624/ground/caves/central2)
"NI" = (
/atom/movable/effect/spawner/random/gun/sidearms,
/turf/open/floor/wood,
/area/lv624/ground/caves/central2)
"NO" = (
/turf/open/floor/wood{
	icon_state = "wood-broken6"
	},
/area/lv624/ground/caves/central2)
"OX" = (
/atom/movable/effect/decal/cleanable/blood/drip,
/atom/movable/effect/spawner/random/gun/sidearms,
/turf/open/floor/wood{
	icon_state = "wood-broken1"
	},
/area/lv624/ground/caves/central2)
"Pl" = (
/obj/item/stack/sheet/wood,
/atom/movable/effect/decal/cleanable/dirt,
/turf/open/floor/wood,
/area/lv624/ground/caves/central2)
"Qk" = (
/obj/structure/closet/crate,
/obj/item/stack/sheet/metal{
	pixel_x = 3
	},
/turf/open/floor/wood,
/area/lv624/ground/caves/central2)
"QN" = (
/turf/open/ground/coast{
	dir = 4;
	icon_state = "beachcorner"
	},
/area/lv624/ground/caves/central2)
"QO" = (
/atom/movable/effect/landmark/xeno_resin_door,
/turf/open/floor/plating/ground/dirt,
/area/lv624/ground/caves/central1)
"QX" = (
/turf/open/ground/coast,
/area/lv624/ground/caves/central2)
"RA" = (
/atom/movable/effect/spawner/random/trash,
/turf/open/floor/wood,
/area/lv624/ground/caves/central2)
"RT" = (
/atom/movable/effect/spawner/random/clothing,
/turf/open/floor/wood{
	icon_state = "wood-broken6"
	},
/area/lv624/ground/caves/central2)
"Tp" = (
/atom/movable/effect/landmark/lv624/fog_blocker,
/turf/closed/mineral/smooth,
/area/lv624/ground/caves/rock)
"TR" = (
/turf/open/ground/coast{
	dir = 6
	},
/area/lv624/ground/caves/central2)
"UI" = (
/atom/movable/effect/decal/cleanable/blood/drip,
/turf/open/floor/wood{
	icon_state = "wood-broken3"
	},
/area/lv624/ground/caves/central2)
"UT" = (
/obj/structure/rack,
/obj/item/stack/sheet/mineral/diamond{
	amount = 2
	},
/turf/open/floor/tile/vault{
	dir = 8
	},
/area/lv624/ground/caves/central1)
"UU" = (
/obj/structure/flora/ausbushes/fullgrass,
/turf/open/floor/plating/ground/dirt,
/area/lv624/ground/caves/central2)
"UX" = (
/obj/structure/table/woodentable,
/atom/movable/effect/spawner/random/ammo/machinegun,
/atom/movable/effect/spawner/random/gun/machineguns{
	pixel_x = 2;
	pixel_y = 4
	},
/turf/open/floor/wood,
/area/lv624/ground/caves/central2)
"Vi" = (
/obj/structure/table/woodentable,
/obj/item/flashlight/lantern,
/turf/open/floor/wood,
/area/lv624/ground/caves/central2)
"Vo" = (
/obj/structure/table/woodentable,
/obj/item/stack/sheet/metal{
	pixel_x = 3;
	pixel_y = 1
	},
/turf/open/floor/wood,
/area/lv624/ground/caves/central2)
"Vt" = (
/obj/structure/table/woodentable,
/turf/open/floor/wood,
/area/lv624/ground/caves/central2)
"VE" = (
/obj/structure/rack,
/obj/item/tool/shovel,
/turf/open/floor/tile/vault{
	dir = 8
	},
/area/lv624/ground/caves/central1)
"We" = (
/obj/structure/barricade/sandbags,
/turf/open/floor/wood/broken,
/area/lv624/ground/caves/central2)
"Wl" = (
/obj/structure/barricade/sandbags,
/obj/structure/table/woodentable,
/obj/item/flashlight/lantern,
/obj/item/weapon/baseballbat/metal,
/turf/open/floor/wood,
/area/lv624/ground/caves/central2)
"WG" = (
/obj/item/stack/sheet/wood,
/turf/open/floor/wood,
/area/lv624/ground/caves/central2)
"WQ" = (
/obj/structure/barricade/sandbags{
	dir = 1
	},
/turf/open/floor/wood{
	icon_state = "wood-broken6"
	},
/area/lv624/ground/caves/central2)
"Xu" = (
/obj/structure/table/woodentable,
/obj/item/tool/candle,
/turf/open/floor/carpet/side{
	dir = 5;
	
	},
/area/lv624/ground/caves/central2)
"Yt" = (
/turf/closed/wall/r_wall,
/area/lv624/ground/caves/central1)
"Yv" = (
/turf/open/floor/plating/ground/dirt,
/area/lv624/ground/caves/central2)
"ZQ" = (
/atom/movable/effect/ai_node,
/turf/open/floor/plating/ground/dirt,
/area/lv624/ground/caves/central1)

(1,1,1) = {"
vk
vk
vk
vk
vk
vk
vk
vk
vk
vk
iB
iB
iB
iB
iB
vk
vk
vk
vk
vk
vk
vk
vk
vk
vk
vk
vk
iN
iN
iN
iN
iN
iN
"}
(2,1,1) = {"
vk
vk
vk
vk
vk
vk
vk
vk
vk
vk
Yv
pE
Yv
Yv
Yv
vk
vk
vk
vk
vk
vk
vk
vk
vk
vk
vk
vk
vk
vk
vk
vk
vk
iN
"}
(3,1,1) = {"
vk
vk
vk
vk
vk
vk
vk
vk
vk
vk
Yv
Yv
Hy
Yv
Yv
GF
GF
GF
GF
vk
vk
vk
vk
vk
vk
vk
iu
iu
iu
iu
iu
vk
vk
"}
(4,1,1) = {"
vk
vk
vk
vk
vk
vk
vk
GF
GF
GF
Yv
Yv
Yv
Yv
Yv
Yv
Yv
Yv
GF
GF
GF
GF
vk
vk
vk
vk
iu
iu
iu
iu
iu
vk
vk
"}
(5,1,1) = {"
vk
vk
vk
vk
vk
vk
vk
GF
GF
Yv
Yv
pE
Yv
Yv
Hy
Yv
Yv
Hy
pE
Yv
Yv
pE
GF
vk
vk
vk
iu
iu
iu
iu
iu
vk
vk
"}
(6,1,1) = {"
vk
vk
vk
vk
vk
vk
GF
GF
GF
GF
Hy
Yv
Yv
Yv
Yv
Yv
Yv
Yv
Yv
Hy
Yv
Yv
GF
GF
vk
vk
vk
vk
vk
vk
vk
vk
vk
"}
(7,1,1) = {"
vk
vk
vk
vk
vk
vk
GF
GF
GF
GF
Yv
Yv
Yv
Yv
Yv
GF
GF
Yv
Yv
Yv
Yv
Yv
Yv
GF
vk
vk
vk
vk
vk
vk
vk
vk
vk
"}
(8,1,1) = {"
vk
vk
vk
vk
vk
GF
GF
Yv
Yv
Yv
Yv
Yv
GF
GF
Yv
GF
GF
Yv
Yv
Yv
Yv
Yv
Hy
GF
GF
vk
iu
iu
iu
iu
iu
vk
vk
"}
(9,1,1) = {"
vk
vk
vk
vk
vk
GF
Yv
Yv
Yv
UU
Yv
Yv
GF
GF
Yv
Yv
Yv
Yv
Yv
GF
GF
Yv
Yv
GF
GF
vk
iu
iu
iu
iu
iu
vk
vk
"}
(10,1,1) = {"
vk
vk
vk
vk
vk
GF
Yv
Yv
Yv
bu
Hy
Yv
Yv
Yv
Yv
Yv
Yv
Yv
op
GF
GF
Yv
Yv
GF
vk
vk
iu
iu
iu
iu
iu
vk
vk
"}
(11,1,1) = {"
vk
vk
vk
vk
vk
GF
Yv
Hy
Yv
Yv
Yv
Yv
Yv
Yv
Yv
GF
GF
Yv
Yv
Yv
Yv
Hy
Yv
GF
vk
vk
vk
vk
vk
vk
vk
vk
vk
"}
(12,1,1) = {"
vk
vk
vk
vk
vk
GF
Yv
Yv
ve
cO
cO
pR
Yv
Yv
Yv
GF
GF
Yv
Yv
Yv
Yv
pE
Yv
GF
vk
vk
vk
vk
vk
vk
vk
vk
vk
"}
(13,1,1) = {"
vk
vk
vk
vk
vk
GF
pE
ve
TR
Hb
Hb
zz
pR
Hy
Yv
Yv
Yv
Yv
Hy
Yv
pE
Yv
GF
GF
vk
vk
iu
iu
iu
iu
iu
vk
vk
"}
(14,1,1) = {"
vk
vk
vk
vk
GF
GF
Yv
QX
Hb
Ge
Hb
Hb
KG
Yv
Yv
Yv
Yv
Yv
Yv
zK
Yv
Yv
GF
vk
vk
vk
iu
iu
iu
iu
iu
vk
vk
"}
(15,1,1) = {"
vk
vk
vk
GF
GF
Yv
Hy
QX
Hb
Hb
Hb
Hb
KG
Yv
Yv
GF
GF
Yv
Yv
UU
Yv
Yv
GF
vk
vk
vk
iu
iu
iu
iu
iu
vk
vk
"}
(16,1,1) = {"
vk
vk
vk
GF
Yv
Yv
Yv
QX
Hb
vz
Hb
Hb
KG
Yv
Yv
GF
GF
Yv
Yv
Hy
Yv
Yv
GF
uV
uV
uV
vk
vk
vk
vk
vk
vk
vk
"}
(17,1,1) = {"
vk
vk
vk
GF
Yv
Yv
pE
QX
Hb
Hb
Hb
vz
KG
Hy
Yv
Yv
Yv
Yv
Yv
Yv
Yv
Yv
Yv
uV
pP
uV
uV
vk
vk
vk
vk
vk
vk
"}
(18,1,1) = {"
vk
vk
vk
GF
Hy
pE
ve
TR
Hb
Hb
Hb
Hb
KG
Yv
Yv
Yv
Yv
Yv
Yv
Yv
Yv
Yv
Hy
jn
DG
ph
uV
uV
uV
uV
iu
iu
iu
"}
(19,1,1) = {"
vk
vk
vk
GF
Yv
Yv
QX
Hb
Hb
jb
Hb
Hb
KG
Yv
Yv
UU
Hy
Yv
GF
GF
Yv
pE
Yv
jn
DG
MN
bS
uy
yy
uV
iu
iu
iu
"}
(20,1,1) = {"
vk
vk
GF
GF
Yv
Yv
QX
Hb
Hb
Hb
Hb
Hb
Ln
pR
Yv
Yv
Mk
Yv
GF
GF
Yv
Yv
pE
jn
DG
OX
aC
NO
MN
uV
iu
iu
iu
"}
(21,1,1) = {"
vk
vk
GF
GF
Yv
pE
QX
Hb
Hb
Hb
Hb
Ge
Hb
KG
Yv
Yv
Yv
Yv
Yv
Yv
Yv
Yv
Yv
uV
MN
MN
MN
Gm
MN
uV
vk
vk
vk
"}
(22,1,1) = {"
vk
vk
GF
GF
Hy
Yv
QX
Hb
vz
Hb
Hb
Hb
Hb
KG
Yv
GF
GF
Yv
op
bu
Yv
Hy
Yv
uV
MN
Gm
MN
MN
uy
uV
vk
vk
vk
"}
(23,1,1) = {"
vk
vk
vk
GF
Yv
Yv
QX
Hb
Hb
Hb
Hb
Hb
vz
KG
Hy
GF
GF
Yv
Hy
Yv
Yv
Yv
Yv
uV
RA
NO
Kj
WG
MN
uV
vk
vk
vk
"}
(24,1,1) = {"
vk
vk
vk
GF
Yv
Yv
QX
Hb
Hb
Hb
Hb
pi
lb
QN
Yv
Yv
Yv
Yv
Yv
Yv
Yv
Yv
pE
MN
MN
WG
vb
MN
RA
uV
vk
vk
vk
"}
(25,1,1) = {"
vk
vk
vk
GF
GF
Hy
QX
Hb
jb
Hb
pi
QN
Yv
Yv
Yv
Yv
Yv
Yv
Yv
GF
GF
Yv
Yv
uV
MN
Kj
Gm
MN
MN
uV
vk
vk
vk
"}
(26,1,1) = {"
vk
vk
vk
vk
GF
Yv
QX
Hb
Hb
pi
QN
Yv
Hy
Yv
Yv
GF
GF
Yv
Yv
GF
GF
Yv
Yv
uV
MN
IR
MN
MN
xm
uV
vk
vk
vk
"}
(27,1,1) = {"
vk
vk
vk
vk
GF
pE
kp
lb
lb
QN
Yv
Yv
zK
Yv
pD
GF
GF
Yv
Yv
Yv
Yv
Yv
Yv
jn
ut
aC
vE
Gm
Md
uV
vk
vk
vk
"}
(28,1,1) = {"
vk
vk
vk
vk
vk
vk
Yv
Yv
Yv
Yv
Hy
Yv
Yv
Yv
Yv
pE
Hy
Yv
Hy
Yv
Yv
Yv
pD
jn
DG
NI
Pl
Kj
mh
uV
vk
vk
vk
"}
(29,1,1) = {"
vk
vk
vk
vk
vk
vk
vk
GF
GF
GF
GF
GF
GF
GF
Yv
Yv
Yv
Yv
Yv
Yv
Yv
Yv
Yv
uV
Kj
Kj
MN
MN
UX
uV
vk
vk
vk
"}
(30,1,1) = {"
vk
vk
vk
vk
vk
vk
uV
uV
uV
uV
uV
uV
uV
GF
Yv
Yv
Yv
Yv
GF
GF
Yv
Yv
Yv
jn
DG
MN
DD
MQ
MN
uV
vk
vk
vk
"}
(31,1,1) = {"
vk
vk
vk
vk
vk
vk
uV
Ke
pJ
MN
MN
Ke
uV
GF
Yv
UU
Hy
Yv
GF
GF
Yv
Yv
Yv
jn
WQ
IR
us
MN
MN
uV
vk
vk
vk
"}
(32,1,1) = {"
vk
vk
vk
vk
vk
vk
uV
eH
MN
MN
bS
kK
uV
GF
Yv
Yv
Yv
Yv
Yv
Yv
Yv
Hy
Yv
jn
DG
MN
MN
MN
uV
uV
vk
vk
vk
"}
(33,1,1) = {"
vk
vk
vk
vk
vk
vk
uV
kK
MN
vE
MN
os
uV
GF
GF
Yv
Yv
Yv
Yv
Yv
Yv
Yv
Yv
uV
bS
MN
bS
MN
uV
vk
vk
vk
vk
"}
(34,1,1) = {"
vk
vk
vk
vk
vk
vk
uV
sv
MN
eE
MN
Vo
uV
uV
uV
Yv
GF
GF
Hy
Yv
GF
GF
Yv
uV
uV
uV
uV
uV
uV
iu
iu
vk
vk
"}
(35,1,1) = {"
vk
vk
vk
vk
vk
vk
uV
gF
MN
NO
MN
MN
MN
MN
uV
Yv
GF
GF
Yv
Yv
GF
GF
Yv
GF
GF
GF
GF
GF
vk
iu
iu
vk
vk
"}
(36,1,1) = {"
vk
vk
vk
vk
vk
vk
uV
qI
vE
MN
ro
MN
eE
ti
jn
Yv
Yv
Yv
Yv
Yv
Yv
Yv
Yv
Yv
Yv
Yv
Yv
GF
vk
iu
iu
vk
vk
"}
(37,1,1) = {"
vk
vk
vk
vk
vk
uV
uV
Vt
eF
MN
MN
vE
MN
ti
jn
Yv
Yv
Hy
Yv
GF
GF
Yv
Yv
Hy
Yv
Yv
Yv
GF
vk
iu
iu
vk
vk
"}
(38,1,1) = {"
vk
vk
vk
vk
vk
uV
gM
MN
pJ
MN
HO
MN
NO
ti
jn
Yv
Yv
Yv
Yv
GF
GF
Yv
pE
Yv
pE
GF
Yv
GF
vk
iu
iu
vk
iu
"}
(39,1,1) = {"
vk
vk
vk
vk
vk
uV
IZ
MN
MN
Gm
Kj
dv
Gm
MN
uV
Mo
Yv
Yv
Yv
Yv
Yv
Yv
Yv
Yv
Yv
pE
Hy
Yv
vk
iu
iu
vk
iu
"}
(40,1,1) = {"
vk
vk
vk
vk
vk
uV
Hl
qW
MN
MN
bS
MN
fJ
MN
WG
pE
Hy
Yv
Yv
Hy
Yv
Yv
pD
Yv
Yv
Yv
Yv
Yv
vk
vk
vk
vk
iu
"}
(41,1,1) = {"
vk
vk
vk
vk
vk
uV
MN
MN
MN
pJ
lu
MN
Gm
MN
uV
Yv
Yv
GF
Yv
Yv
Yv
GF
GF
EQ
Yv
GF
GF
Yv
Yv
vk
vk
vk
vk
"}
(42,1,1) = {"
vk
vk
vk
vk
vk
uV
MN
MN
xD
GS
ne
GZ
HO
ti
jn
Yv
Yv
Yv
Yv
Yv
GF
GF
EQ
EQ
Yv
Yv
Yv
Yv
Hy
vk
vk
vk
vk
"}
(43,1,1) = {"
vk
vk
vk
vk
vk
uV
MN
fJ
xD
xI
qD
GZ
Kj
ti
jn
Yv
Hy
Yv
Yv
GF
GF
EQ
EQ
EQ
EQ
Yv
Hy
Yv
Yv
Yv
vk
Yv
Yv
"}
(44,1,1) = {"
vk
vk
vk
vk
vk
uV
pJ
MN
xD
Xu
BP
GZ
Kj
Ik
jn
Yv
Yv
Yv
GF
GF
EQ
EQ
EQ
EQ
EQ
Yv
Yv
GF
GF
Yv
Yv
Yv
Yv
"}
(45,1,1) = {"
vk
vk
vk
vk
vk
uV
MN
Gm
MN
MN
fJ
MN
MN
MN
uV
Hy
Yv
Yv
GF
EQ
EQ
EQ
EQ
EQ
EQ
EQ
Yv
GF
GF
Yv
Yv
Hy
Yv
"}
(46,1,1) = {"
vk
vk
vk
vk
vk
uV
MN
MN
Kj
fA
MN
MN
vi
MN
uV
Yv
Yv
GF
EQ
EQ
EQ
EQ
EQ
EQ
EQ
EQ
Yv
Yv
Yv
bu
Yv
Yv
Yv
"}
(47,1,1) = {"
vk
vk
vk
vk
vk
uV
MN
fJ
MN
Kj
UI
iE
MN
ti
jn
Yv
Yv
GF
EQ
EQ
EQ
EQ
EQ
EQ
EQ
EQ
Hy
Yv
Yv
Hy
GF
GF
Yv
"}
(48,1,1) = {"
vk
vk
vk
vk
vk
uV
fJ
MN
lF
fJ
Gm
MN
MN
ti
jn
Hy
Yv
Yv
Hy
EQ
EQ
EQ
EQ
EQ
EQ
pE
Yv
Yv
op
Yv
GF
GF
Yv
"}
(49,1,1) = {"
vk
vk
vk
vk
vk
uV
MN
bS
MN
MN
bS
DD
MN
We
jn
Yv
Yv
Yv
Yv
EQ
EQ
EQ
EQ
EQ
Yv
Yv
pE
Yv
Yv
Yv
Yv
Yv
pE
"}
(50,1,1) = {"
vk
vk
vk
vk
vk
uV
uV
uV
uV
Ky
uV
Ky
uV
uV
uV
Yv
GF
GF
Yv
EQ
EQ
EQ
EQ
EQ
Yv
zK
Yv
GF
GF
Yv
Hy
pE
Yv
"}
(51,1,1) = {"
vk
vk
vk
vk
vk
vk
uV
iV
MN
vE
uV
pJ
MN
iV
jn
Yv
GF
GF
Yv
EQ
EQ
EQ
EQ
Yv
Yv
Yv
Yv
GF
GF
Yv
Yv
Yv
Yv
"}
(52,1,1) = {"
vk
vk
vk
vk
vk
vk
uV
jl
MN
Qk
uV
vN
MN
Wl
jn
Hy
Yv
Yv
Hy
Yv
EQ
EQ
Yv
Hy
Yv
GF
Hy
Yv
Yv
Yv
Yv
Yv
vk
"}
(53,1,1) = {"
vk
vk
vk
vk
vk
vk
uV
cb
MN
RT
uV
MN
fJ
iV
jn
pE
Yv
Yv
Yv
Yv
Yv
Hy
Yv
Yv
Yv
pE
Yv
Yv
Yv
Yv
Yv
GF
vk
"}
(54,1,1) = {"
vk
vk
vk
vk
vk
vk
uV
Vi
sH
BO
sL
BO
sH
Hz
jn
Yv
GF
Yv
GF
GF
Yv
Yv
GF
GF
Yv
Hy
Yv
GF
GF
Hy
Yv
GF
vk
"}
(55,1,1) = {"
vk
vk
vk
vk
vk
vk
uV
uV
jn
jn
uV
jn
jn
uV
uV
Hy
Yv
Yv
GF
GF
Yv
Yv
GF
GF
Yv
Yv
Yv
GF
GF
Yv
Yv
GF
vk
"}
(56,1,1) = {"
vk
vk
vk
vk
vk
vk
vk
GF
GF
GF
GF
GF
GF
GF
GF
pE
Yv
Yv
Yv
Yv
Yv
Yv
Yv
Yv
Yv
Yv
pE
Yv
Yv
Yv
Yv
GF
vk
"}
(57,1,1) = {"
vk
vk
vk
vk
vk
vk
vk
GF
Yv
Yv
Yv
pE
Yv
Yv
Hy
Yv
pE
Yv
Yv
Yv
Yv
Yv
Hy
Yv
Yv
pE
Hy
Yv
Yv
Hy
GF
GF
vk
"}
(58,1,1) = {"
vk
vk
vk
vk
vk
vk
GF
GF
Yv
Yv
pE
Yv
Yv
Yv
Yv
Yv
Yv
Yv
Hy
Yv
GF
GF
Yv
Yv
GF
GF
Yv
Yv
Yv
GF
GF
vk
vk
"}
(59,1,1) = {"
vk
vk
vk
vk
vk
vk
GF
GF
GF
GF
Yv
Hy
Yv
Yv
Yv
Yv
Yv
Yv
Yv
Yv
GF
GF
Yv
Yv
GF
GF
Yv
Yv
GF
GF
vk
vk
vk
"}
(60,1,1) = {"
vk
vk
vk
vk
vk
vk
GF
GF
GF
GF
Yv
Yv
Yv
Yv
Hy
Yv
GF
GF
Yv
Yv
Yv
Yv
Yv
Yv
Yv
Yv
Yv
GF
GF
vk
vk
vk
vk
"}
(61,1,1) = {"
vk
vk
vk
vk
vk
vk
vk
GF
Yv
Yv
Yv
UU
Yv
Yv
Yv
Yv
GF
GF
Yv
Yv
Yv
Hy
Yv
Yv
Yv
Yv
GF
GF
vk
vk
vk
vk
vk
"}
(62,1,1) = {"
vk
vk
vk
vk
vk
vk
vk
GF
Yv
Yv
bu
Yv
zK
Yv
Yv
Yv
Yv
Yv
Hy
Yv
Yv
Yv
GF
GF
Yv
Hy
GF
vk
vk
vk
vk
vk
vk
"}
(63,1,1) = {"
vk
vk
vk
vk
vk
vk
vk
GF
GF
Yv
Yv
Yv
Yv
Yv
Hy
Yv
Yv
Yv
op
Yv
Hy
Yv
GF
GF
Yv
Yv
vk
vk
vk
vk
vk
vk
vk
"}
(64,1,1) = {"
vk
vk
vk
vk
vk
vk
vk
vk
GF
Yv
Yv
Hy
Yv
pE
Yv
Yv
GF
GF
Yv
Yv
Yv
pE
Yv
Yv
Yv
pE
vk
vk
vk
vk
vk
vk
vk
"}
(65,1,1) = {"
vk
vk
vk
vk
vk
vk
vk
vk
GF
GF
Yv
Yv
Yv
Yv
Yv
GF
vk
vk
GF
Yv
Hy
Yv
Yv
Yv
UU
Yv
vk
vk
vk
vk
vk
vk
vk
"}
(66,1,1) = {"
vk
vk
vk
vk
vk
vk
vk
vk
vk
GF
Yv
Yv
Yv
Yv
GF
vk
vk
vk
vk
GF
Yv
Yv
Hy
Yv
Yv
Hy
vk
vk
iu
iu
iu
iu
vk
"}
(67,1,1) = {"
vk
vk
vk
vk
vk
vk
vk
vk
vk
GF
Yv
Hy
Yv
Yv
GF
vk
vk
vk
vk
GF
Yv
Yv
Yv
Yv
Yv
Yv
vk
vk
iu
iu
iu
iu
vk
"}
(68,1,1) = {"
vk
vk
vk
vk
vk
vk
vk
vk
vk
GF
Yv
Yv
Yv
Yv
vk
vk
vk
vk
vk
vk
GF
Yv
Yv
Yv
Yv
Yv
vk
vk
iu
iu
iu
iu
vk
"}
(69,1,1) = {"
vk
vk
vk
vk
vk
vk
vk
vk
vk
vk
Yv
Yv
Yv
Yv
vk
vk
vk
vk
vk
vk
GF
Yv
Yv
Hy
Yv
Hy
vk
vk
vk
vk
vk
vk
vk
"}
(70,1,1) = {"
vk
vk
vk
vk
vk
vk
vk
vk
vk
vk
Hy
Yv
Yv
Hy
vk
vk
vk
vk
vk
vk
vk
Yv
Yv
Yv
Yv
Yv
vk
vk
iu
iu
iu
iu
vk
"}
(71,1,1) = {"
iu
iu
iu
iu
vk
iu
iu
iu
iu
vk
Yv
Yv
Yv
Yv
Yv
vk
vk
vk
vk
vk
vk
Yv
Yv
Yv
Yv
Yv
vk
vk
iu
iu
iu
iu
vk
"}
(72,1,1) = {"
iu
iu
iu
iu
vk
iu
iu
iu
iu
vk
QO
QO
QO
QO
QO
vk
vk
vk
vk
vk
vk
za
QO
QO
QO
QO
vk
vk
iu
iu
iu
iu
vk
"}
(73,1,1) = {"
iu
iu
iu
iu
vk
iu
iu
iu
iu
vk
au
au
au
ZQ
au
vk
vk
vk
vk
vk
ZQ
au
au
au
au
ZQ
vk
vk
vk
vk
vk
vk
vk
"}
(74,1,1) = {"
iu
iu
iu
iu
vk
iu
iu
iu
iu
vk
au
au
dp
au
hh
vk
vk
vk
vk
vk
au
au
au
vk
vk
vk
vk
jx
Dm
id
kE
Hu
Dm
"}
(75,1,1) = {"
vk
vk
vk
vk
vk
vk
vk
vk
vk
vk
au
au
au
au
au
vk
vk
vk
vk
au
au
hh
au
au
vk
vk
vk
Tp
sR
sl
qq
ou
sR
"}
(76,1,1) = {"
iu
iu
iu
iu
vk
iu
iu
iu
iu
vk
hh
au
hh
au
au
au
vk
vk
au
au
au
au
au
au
vk
vk
vk
Tp
sR
UT
jD
wL
Yt
"}
(77,1,1) = {"
iu
iu
iu
iu
vk
iu
iu
iu
iu
vk
au
au
au
au
au
au
vk
au
hh
au
au
hh
au
vk
vk
vk
vk
Tp
sR
vt
qq
ay
Yt
"}
(78,1,1) = {"
iu
iu
iu
iu
vk
iu
iu
iu
iu
vk
vk
au
au
au
hh
au
au
au
au
au
au
au
vk
vk
vk
vk
vk
Tp
sR
VE
qq
DE
Yt
"}
(79,1,1) = {"
vk
vk
vk
vk
vk
vk
vk
vk
vk
vk
vk
vk
au
ZQ
au
au
au
au
hh
au
au
au
vk
vk
vk
vk
vk
Tp
sR
IL
HD
IL
Yt
"}
(80,1,1) = {"
iu
iu
iu
iu
vk
iu
iu
iu
iu
vk
vk
vk
vk
au
ZQ
au
au
au
au
au
ZQ
au
QO
au
vk
vk
vk
Tp
vk
In
In
In
In
"}
