//MAP CONVERTED BY dmm2tgm.py THIS HEADER COMMENT PREVENTS RECONVERSION, DO NOT REMOVE
"a" = (
/turf/open/floor/plating/ground/dirt,
/area/lv624/ground/caves/central3)
"b" = (
/obj/effect/landmark/lv624/fog_blocker,
/obj/effect/landmark/lv624/fog_blocker/xeno_spawn,
/turf/closed/mineral,
/area/lv624/ground/caves/rock)
"c" = (
/turf/closed/mineral,
/area/lv624/ground/caves/rock)
"d" = (
/obj/effect/landmark/xeno_resin_wall,
/turf/open/floor/plating/ground/dirt,
/area/lv624/ground/caves/central1)
"e" = (
/obj/effect/landmark/xeno_silo_spawn,
/turf/open/floor/plating/ground/dirt,
/area/lv624/ground/caves/central2)
"f" = (
/obj/structure/rack,
/obj/item/stack/sheet/mineral/tritium{
	pixel_x = -4
	},
/turf/open/floor/tile/vault{
	dir = 8
	},
/area/lv624/ground/caves/central1)
"g" = (
/obj/effect/ai_node,
/turf/open/floor/plating/ground/dirt,
/area/lv624/ground/caves/central2)
"h" = (
/turf/open/floor/plating/ground/dirt,
/area/lv624/ground/caves/central2)
"i" = (
/obj/structure/rack,
/turf/open/floor/tile/vault{
	dir = 8
	},
/area/lv624/ground/caves/central1)
"j" = (
/obj/structure/rack,
/obj/item/tool/shovel,
/turf/open/floor/tile/vault{
	dir = 8
	},
/area/lv624/ground/caves/central1)
"l" = (
/obj/structure/rack,
/obj/item/tool/shovel,
/obj/effect/landmark/lv624/fog_blocker/xeno_spawn,
/turf/open/floor/tile/vault{
	dir = 8
	},
/area/lv624/ground/caves/central1)
"m" = (
/obj/machinery/miner/damaged/platinum,
/turf/open/floor/plating/ground/dirt,
/area/lv624/ground/caves/central1)
"n" = (
/turf/open/floor/tile/dark,
/area/lv624/ground/caves/central1)
"o" = (
/obj/effect/landmark/weed_node,
/obj/effect/landmark/xeno_resin_wall,
/turf/open/floor/plating/ground/dirt,
/area/lv624/ground/caves/central1)
"p" = (
/obj/structure/rack,
/obj/item/stack/sheet/mineral/diamond{
	amount = 2
	},
/turf/open/floor/tile/vault{
	dir = 8
	},
/area/lv624/ground/caves/central1)
"q" = (
/obj/effect/landmark/weed_node,
/turf/open/floor/plating/ground/dirt,
/area/lv624/ground/caves/central1)
"r" = (
/obj/effect/landmark/lv624/fog_blocker,
/obj/effect/ai_node,
/turf/open/floor/plating/ground/dirt,
/area/lv624/ground/caves/central2)
"s" = (
/obj/effect/landmark/xeno_resin_door,
/turf/open/floor/plating/ground/dirt,
/area/lv624/ground/caves/central1)
"v" = (
/obj/effect/landmark/lv624/fog_blocker,
/turf/closed/mineral,
/area/lv624/ground/caves/rock)
"w" = (
/turf/closed/wall/r_wall,
/area/lv624/ground/caves/rock)
"x" = (
/obj/effect/landmark/lv624/fog_blocker/xeno_spawn,
/turf/closed/wall/r_wall,
/area/lv624/ground/caves/rock)
"y" = (
/obj/effect/landmark/xeno_resin_wall,
/turf/open/floor/plating/ground/dirt,
/area/lv624/ground/caves/central2)
"z" = (
/turf/open/floor,
/area/lv624/ground/caves/central1)
"A" = (
/obj/effect/landmark/xeno_resin_door,
/turf/open/floor/plating/ground/dirt,
/area/lv624/ground/caves/central3)
"B" = (
/obj/effect/landmark/weed_node,
/obj/effect/ai_node,
/turf/open/floor/plating/ground/dirt,
/area/lv624/ground/caves/central2)
"C" = (
/obj/effect/landmark/excavation_site_spawner,
/turf/open/floor/plating/ground/dirt,
/area/lv624/ground/caves/central2)
"D" = (
/obj/structure/rack,
/obj/item/stack/sheet/mineral/gold{
	amount = 2
	},
/obj/item/stack/sheet/mineral/platinum{
	pixel_x = -6
	},
/turf/open/floor/tile/vault{
	dir = 8
	},
/area/lv624/ground/caves/central1)
"E" = (
/obj/structure/rack,
/obj/item/tool/pickaxe,
/turf/open/floor/tile/vault{
	dir = 8
	},
/area/lv624/ground/caves/central1)
"F" = (
/obj/effect/landmark/weed_node,
/obj/effect/ai_node,
/turf/open/floor/plating/ground/dirt,
/area/lv624/ground/caves/central1)
"H" = (
/obj/effect/ai_node,
/turf/open/floor/plating/ground/dirt,
/area/lv624/ground/caves/central1)
"I" = (
/turf/open/floor/plating/ground/dirt,
/area/lv624/ground/caves/central1)
"J" = (
/obj/structure/rack,
/obj/item/stack/sheet/mineral/silver{
	amount = 20
	},
/turf/open/floor/tile/vault{
	dir = 8
	},
/area/lv624/ground/caves/central1)
"K" = (
/obj/effect/landmark/weed_node,
/turf/open/floor/plating/ground/dirt,
/area/lv624/ground/caves/central2)
"L" = (
/turf/closed/wall/r_wall,
/area/lv624/ground/caves/central1)
"M" = (
/turf/closed/wall,
/area/lv624/ground/caves/central1)
"O" = (
/obj/structure/rack,
/obj/item/stack/sheet/metal{
	amount = 50;
	pixel_x = 4;
	pixel_y = 4
	},
/obj/item/stack/sheet/metal{
	amount = 30
	},
/turf/open/floor/tile/vault{
	dir = 8
	},
/area/lv624/ground/caves/central1)
"P" = (
/obj/machinery/miner/damaged/platinum,
/turf/open/floor/plating/ground/dirt,
/area/lv624/ground/caves/central2)
"R" = (
/obj/effect/landmark/xeno_resin_door,
/turf/open/floor/plating/ground/dirt,
/area/lv624/ground/caves/central2)
"S" = (
/obj/machinery/door/airlock/mainship/secure/locked/free_access{
	dir = 4;
	name = "\improper Mining Storage"
	},
/turf/open/floor/tile/dark,
/area/lv624/ground/caves/central1)
"U" = (
/obj/structure/rack,
/obj/item/stack/sheet/mineral/iron{
	amount = 5
	},
/obj/item/stack/sheet/mineral/platinum,
/obj/machinery/light{
	dir = 8
	},
/obj/effect/landmark/lv624/fog_blocker/xeno_spawn,
/turf/open/floor/tile/vault{
	dir = 8
	},
/area/lv624/ground/caves/central1)
"W" = (
/obj/structure/rack,
/obj/effect/landmark/lv624/fog_blocker/xeno_spawn,
/turf/open/floor/tile/vault{
	dir = 8
	},
/area/lv624/ground/caves/central1)
"X" = (
/turf/closed/mineral/indestructible,
/area/lv624/ground/caves/rock)
"Y" = (
/obj/effect/landmark/lv624/fog_blocker,
/turf/open/floor/plating/ground/dirt,
/area/lv624/ground/caves/central2)
"Z" = (
/obj/effect/landmark/weed_node,
/obj/effect/landmark/xeno_resin_wall,
/turf/open/floor/plating/ground/dirt,
/area/lv624/ground/caves/central2)

(1,1,1) = {"
c
c
c
c
c
c
c
c
c
c
A
A
A
A
A
c
c
c
c
c
c
c
c
c
c
c
c
a
a
a
a
a
a
"}
(2,1,1) = {"
c
c
c
c
c
c
c
c
c
c
K
h
h
h
h
c
c
c
c
c
c
c
c
c
c
c
c
c
c
c
c
c
a
"}
(3,1,1) = {"
c
c
c
c
c
c
c
c
c
c
h
h
h
h
K
c
c
c
c
c
c
c
c
c
c
c
X
X
X
X
X
c
c
"}
(4,1,1) = {"
c
c
c
c
c
c
c
c
c
c
h
K
h
h
h
c
c
c
c
c
c
c
c
c
c
c
X
X
X
X
X
c
c
"}
(5,1,1) = {"
c
c
c
c
c
c
c
c
c
c
h
g
h
h
g
c
c
c
c
c
c
c
c
c
c
c
X
X
X
X
X
c
c
"}
(6,1,1) = {"
c
c
c
c
c
c
c
c
c
K
h
h
K
h
h
c
c
c
c
c
c
c
c
c
c
c
c
c
c
c
c
c
c
"}
(7,1,1) = {"
c
c
c
c
c
c
c
c
c
h
h
h
h
h
h
K
c
c
c
c
c
c
c
c
c
c
c
c
c
c
c
c
c
"}
(8,1,1) = {"
c
c
c
c
c
c
c
c
c
c
K
h
y
y
h
h
c
c
c
c
c
c
c
c
c
c
c
c
X
X
X
c
c
"}
(9,1,1) = {"
c
c
c
c
c
c
c
c
c
c
h
h
y
y
K
h
h
c
c
c
c
c
c
c
c
c
c
c
X
X
X
c
c
"}
(10,1,1) = {"
c
c
c
c
c
c
c
c
c
c
h
K
h
h
h
y
h
c
c
c
c
c
c
c
c
c
c
c
X
X
X
c
c
"}
(11,1,1) = {"
c
c
c
c
c
c
c
c
c
c
c
g
h
h
h
h
h
c
c
c
c
c
c
c
c
c
c
c
c
c
c
c
c
"}
(12,1,1) = {"
c
c
c
c
c
c
c
c
c
c
c
h
g
K
g
h
K
h
c
c
c
c
c
c
c
c
c
c
c
c
c
c
c
"}
(13,1,1) = {"
c
c
c
c
c
c
c
c
c
c
c
h
h
y
y
h
h
h
c
c
c
c
c
c
c
c
c
c
X
X
X
c
c
"}
(14,1,1) = {"
c
c
c
c
c
c
c
c
c
c
h
K
h
y
y
K
h
h
h
c
c
c
c
c
c
c
c
c
X
X
X
c
c
"}
(15,1,1) = {"
c
c
c
c
c
c
c
c
c
c
c
h
h
K
h
h
h
Z
h
c
c
c
c
c
c
c
c
c
X
X
X
c
c
"}
(16,1,1) = {"
c
c
v
v
v
v
v
v
v
v
v
v
r
h
h
h
K
h
g
c
c
c
c
c
c
c
c
c
c
c
c
c
c
"}
(17,1,1) = {"
c
c
v
c
c
c
c
c
c
c
c
c
v
h
y
h
h
h
h
c
c
c
c
c
c
c
c
c
c
c
c
c
c
"}
(18,1,1) = {"
c
c
v
c
c
c
c
c
c
c
c
c
v
c
h
h
h
h
h
h
c
c
c
c
c
c
c
c
c
c
c
X
X
"}
(19,1,1) = {"
c
c
v
c
c
c
c
y
y
y
y
c
v
h
h
K
y
y
h
K
c
c
c
c
c
c
c
c
c
c
c
X
X
"}
(20,1,1) = {"
c
c
v
c
c
c
h
h
h
h
K
R
Y
h
h
h
y
y
g
h
g
c
c
c
c
c
c
c
c
c
c
X
X
"}
(21,1,1) = {"
c
c
v
c
c
h
h
K
h
h
h
R
Y
y
K
h
K
h
K
h
h
c
c
c
c
c
c
c
c
c
c
c
c
"}
(22,1,1) = {"
c
c
v
c
c
g
h
e
h
h
g
R
Y
h
h
h
g
h
h
y
h
h
c
c
c
c
c
c
c
c
c
c
c
"}
(23,1,1) = {"
c
c
v
c
h
h
h
h
h
K
h
c
v
c
c
h
h
K
h
h
K
h
c
c
c
c
c
c
c
c
c
c
c
"}
(24,1,1) = {"
c
c
v
c
c
h
h
h
h
h
c
c
v
c
c
c
h
h
y
y
h
h
h
c
c
c
c
c
c
c
c
c
c
"}
(25,1,1) = {"
c
c
v
c
c
h
h
h
h
c
c
c
v
c
c
h
h
C
y
Z
h
h
K
c
c
c
c
c
c
c
c
c
c
"}
(26,1,1) = {"
c
c
v
c
c
c
K
h
c
c
c
c
v
c
c
h
h
h
h
h
h
h
h
c
c
c
c
c
c
c
c
c
c
"}
(27,1,1) = {"
c
c
v
v
v
v
v
v
v
v
v
v
v
c
h
h
g
K
h
h
g
h
B
c
c
c
c
c
c
c
c
c
c
"}
(28,1,1) = {"
c
c
c
c
c
c
c
c
c
c
c
c
h
h
K
h
h
y
y
y
Z
h
h
h
c
c
c
c
c
c
c
c
c
"}
(29,1,1) = {"
c
c
c
c
c
c
c
c
c
c
y
y
h
h
P
h
h
y
c
c
y
h
h
h
c
c
c
c
c
c
c
c
c
"}
(30,1,1) = {"
c
c
c
c
c
c
c
c
c
c
Z
g
h
K
h
h
g
c
c
c
c
y
K
h
h
c
c
c
c
c
c
c
c
"}
(31,1,1) = {"
c
c
c
c
c
c
c
c
c
y
y
h
h
h
h
h
K
y
c
c
c
c
h
h
h
c
c
c
c
c
c
c
c
"}
(32,1,1) = {"
c
c
c
c
c
c
c
c
y
y
h
K
h
h
c
h
h
y
c
c
c
c
h
h
K
c
c
c
c
c
c
c
c
"}
(33,1,1) = {"
c
c
c
c
c
c
c
c
y
B
h
g
h
c
c
h
h
h
h
c
c
h
K
h
h
c
c
c
c
c
c
c
c
"}
(34,1,1) = {"
c
c
c
c
c
c
c
Z
y
h
h
h
c
c
c
K
g
h
K
h
g
h
g
y
c
c
c
c
c
X
X
c
c
"}
(35,1,1) = {"
c
c
c
c
c
c
c
y
h
h
h
h
c
c
c
c
y
y
y
h
h
h
h
y
c
c
c
c
c
X
X
c
c
"}
(36,1,1) = {"
c
c
c
c
c
c
y
y
h
K
h
c
c
c
c
c
c
c
y
y
K
h
h
y
y
c
c
c
c
X
X
c
c
"}
(37,1,1) = {"
c
c
c
c
c
c
y
y
h
h
c
c
c
c
c
c
c
c
c
y
h
h
h
h
y
c
c
c
c
X
X
c
c
"}
(38,1,1) = {"
c
c
c
c
c
c
c
y
C
h
h
c
c
c
c
c
c
c
c
y
h
h
K
h
y
c
c
c
c
c
c
c
X
"}
(39,1,1) = {"
c
c
c
c
c
c
c
Z
h
h
h
c
c
c
c
c
c
c
c
Z
h
h
h
h
y
c
c
c
c
c
c
c
X
"}
(40,1,1) = {"
c
c
c
c
c
c
c
y
h
K
h
c
c
c
c
c
c
c
c
y
h
y
y
h
K
c
c
c
c
c
c
c
X
"}
(41,1,1) = {"
c
c
c
c
c
c
c
y
h
g
h
c
c
c
c
c
c
c
c
c
h
y
Z
h
h
c
c
c
c
c
c
c
c
"}
(42,1,1) = {"
c
c
c
c
c
c
c
y
K
h
c
c
c
c
c
c
c
c
c
c
g
h
K
h
h
h
c
c
c
c
c
c
c
"}
(43,1,1) = {"
c
c
c
c
c
c
c
y
h
h
c
c
c
c
c
c
c
c
c
y
K
g
h
h
h
K
h
g
c
c
c
c
h
"}
(44,1,1) = {"
c
c
c
c
c
c
c
y
h
K
h
c
c
c
c
c
c
c
c
Z
h
h
c
c
h
h
h
h
h
h
h
h
h
"}
(45,1,1) = {"
c
c
c
c
c
c
c
c
h
h
h
h
c
c
c
c
c
c
c
y
h
h
c
c
c
c
h
h
Z
h
K
P
K
"}
(46,1,1) = {"
c
c
c
c
c
c
c
c
c
g
K
h
g
c
c
c
c
c
c
y
h
h
h
c
c
c
c
h
h
h
h
h
h
"}
(47,1,1) = {"
c
c
c
c
c
c
c
c
c
c
h
h
h
c
c
c
c
c
c
c
h
K
h
c
c
c
c
h
h
y
y
h
h
"}
(48,1,1) = {"
c
c
c
c
c
c
c
c
c
c
h
K
h
c
c
c
c
c
c
c
c
h
C
h
c
c
h
h
K
y
y
K
h
"}
(49,1,1) = {"
c
c
c
c
c
c
c
c
c
c
h
h
g
c
c
c
c
c
c
c
c
g
h
h
h
h
h
g
h
h
h
g
h
"}
(50,1,1) = {"
c
c
c
c
c
c
c
c
c
h
h
K
h
Z
c
c
c
c
c
c
h
h
Z
y
h
h
K
h
c
h
h
h
h
"}
(51,1,1) = {"
c
c
c
c
c
c
c
c
c
h
y
y
h
y
c
c
c
c
c
c
c
h
y
y
K
h
h
c
c
c
c
c
h
"}
(52,1,1) = {"
c
c
c
c
c
c
c
c
c
h
y
y
h
y
c
c
c
c
c
c
h
h
h
h
h
y
c
c
c
c
c
c
c
"}
(53,1,1) = {"
c
c
c
c
c
c
c
c
c
h
h
h
K
h
y
y
c
c
c
c
h
h
h
h
h
y
c
c
c
c
c
c
c
"}
(54,1,1) = {"
c
c
c
c
c
c
c
c
c
c
h
h
h
g
K
h
y
y
y
c
h
h
K
y
h
Z
c
c
c
c
c
c
c
"}
(55,1,1) = {"
c
c
c
c
c
c
c
c
c
c
h
K
g
h
h
h
h
g
h
h
h
B
h
h
h
y
c
c
c
c
c
c
c
"}
(56,1,1) = {"
c
c
c
c
c
c
c
c
c
c
c
c
h
h
h
K
y
h
K
h
y
y
g
h
Z
y
c
c
c
c
c
c
c
"}
(57,1,1) = {"
c
c
c
c
c
c
c
c
c
c
c
c
c
h
y
h
h
h
h
h
y
y
h
y
y
c
c
c
c
c
c
c
c
"}
(58,1,1) = {"
c
c
c
c
c
c
c
c
c
c
c
h
h
g
h
h
h
g
h
h
h
h
B
y
c
c
c
c
c
c
c
c
c
"}
(59,1,1) = {"
c
c
c
c
c
c
c
c
c
c
h
h
h
P
h
K
y
y
c
c
h
h
h
y
c
c
c
c
c
c
c
c
c
"}
(60,1,1) = {"
c
c
c
c
c
c
c
c
c
h
K
y
K
h
h
y
y
c
c
c
h
h
h
y
c
c
c
c
c
c
c
c
c
"}
(61,1,1) = {"
c
c
c
c
c
c
c
c
c
c
h
g
h
g
h
y
c
c
c
c
h
K
h
c
c
c
c
c
c
c
c
c
c
"}
(62,1,1) = {"
c
c
c
c
c
c
c
c
c
c
c
h
h
y
y
Z
c
c
c
c
h
C
h
c
c
c
c
c
c
c
c
c
c
"}
(63,1,1) = {"
c
c
c
c
c
c
c
c
c
c
c
h
h
y
c
c
c
c
c
B
h
h
g
K
c
c
c
c
c
c
c
c
c
"}
(64,1,1) = {"
c
c
c
c
c
c
c
c
c
c
c
h
h
Z
c
c
c
c
c
h
h
y
h
h
c
c
c
c
c
c
c
c
c
"}
(65,1,1) = {"
c
c
c
c
c
c
c
c
c
c
c
h
h
y
c
c
c
c
c
h
h
K
h
h
c
c
c
c
c
c
c
c
c
"}
(66,1,1) = {"
c
c
c
c
c
c
c
c
c
c
h
g
h
y
c
c
c
c
c
c
c
h
h
h
c
c
c
c
X
X
X
X
c
"}
(67,1,1) = {"
c
c
c
c
c
c
c
c
c
c
h
K
h
c
c
c
c
c
c
c
c
h
h
K
c
c
c
c
X
X
X
X
c
"}
(68,1,1) = {"
c
c
c
c
c
c
c
c
c
h
h
h
h
c
c
c
c
c
c
c
c
h
g
h
g
c
c
c
X
X
X
X
c
"}
(69,1,1) = {"
c
c
c
c
c
c
c
c
c
h
K
h
h
c
c
c
c
c
c
c
c
B
y
y
h
h
c
c
c
c
c
c
c
"}
(70,1,1) = {"
c
c
c
c
c
c
c
c
c
h
h
h
h
K
c
c
c
c
c
c
c
h
y
Z
h
h
c
c
X
X
X
X
c
"}
(71,1,1) = {"
X
X
X
X
c
X
X
c
c
c
h
K
h
h
c
c
c
c
c
c
c
h
h
h
h
K
c
c
X
X
X
X
c
"}
(72,1,1) = {"
X
X
X
X
c
X
X
X
X
c
s
s
s
s
s
c
c
c
c
c
c
s
s
s
s
s
c
c
X
X
X
X
c
"}
(73,1,1) = {"
X
X
X
X
c
X
X
X
X
c
I
I
q
I
I
c
c
c
c
c
I
H
q
I
H
I
c
c
c
c
c
c
c
"}
(74,1,1) = {"
X
X
X
X
c
X
X
X
X
c
q
H
I
I
F
c
c
c
c
c
q
I
I
c
c
c
c
b
x
l
U
W
x
"}
(75,1,1) = {"
c
c
c
c
c
c
c
c
c
c
I
I
o
d
I
c
c
c
c
I
I
m
I
I
c
c
c
v
w
D
n
f
w
"}
(76,1,1) = {"
X
X
X
X
c
X
X
X
X
c
I
I
d
d
I
I
c
c
I
q
I
I
I
q
c
c
c
v
w
p
n
J
L
"}
(77,1,1) = {"
X
X
X
X
c
X
X
X
X
c
I
q
I
I
q
I
c
H
I
I
I
F
I
c
c
c
c
v
w
O
n
i
L
"}
(78,1,1) = {"
X
X
X
X
c
X
X
X
X
c
c
I
I
I
I
I
I
I
d
d
I
I
c
c
c
c
c
v
w
j
n
E
L
"}
(79,1,1) = {"
c
c
c
c
c
c
c
c
c
c
c
c
I
I
I
o
I
I
d
o
I
I
c
c
c
c
c
v
w
M
S
M
L
"}
(80,1,1) = {"
X
X
X
X
c
X
X
X
X
c
c
c
c
I
H
I
I
F
I
I
I
H
s
I
c
c
c
v
c
z
z
z
z
"}
