//MAP CONVERTED BY dmm2tgm.py THIS HEADER COMMENT PREVENTS RECONVERSION, DO NOT REMOVE
"at" = (
/obj/effect/landmark/weed_node,
/turf/open/liquid/water/river/autosmooth,
/area/lv624/ground/caves/central2)
"aC" = (
/turf/open/floor/plating/ground/dirt,
/area/lv624/ground/caves/central3)
"cp" = (
/obj/structure/flora/ausbushes/reedbush,
/turf/open/liquid/water/river/autosmooth,
/area/lv624/ground/caves/central2)
"dD" = (
/obj/effect/ai_node,
/obj/effect/landmark/weed_node,
/turf/open/floor/plating/ground/dirt,
/area/lv624/ground/caves/central2)
"ev" = (
/obj/machinery/door/airlock/mainship/secure/locked/free_access{
	dir = 4;
	name = "\improper Mining Storage"
	},
/turf/open/floor/tile/dark,
/area/lv624/ground/caves/central1)
"eA" = (
/obj/effect/landmark/xeno_resin_door,
/turf/open/floor/plating/ground/dirt,
/area/lv624/ground/caves/central2)
"fD" = (
/obj/effect/ai_node,
/turf/open/floor/plating/ground/dirt,
/area/lv624/ground/caves/central1)
"gQ" = (
/turf/closed/wall,
/area/lv624/ground/caves/central1)
"hh" = (
/obj/effect/landmark/weed_node,
/obj/effect/landmark/xeno_resin_door,
/turf/open/floor/plating/ground/dirt,
/area/lv624/ground/caves/central2)
"hy" = (
/obj/machinery/miner/damaged/platinum,
/turf/open/floor/plating/ground/dirt,
/area/lv624/ground/caves/central2)
"hG" = (
/obj/effect/landmark/xeno_resin_door,
/turf/open/floor/plating/ground/dirt,
/area/lv624/ground/caves/central3)
"it" = (
/obj/effect/landmark/xeno_resin_door,
/turf/open/floor/plating/ground/dirt,
/area/lv624/ground/caves/central1)
"jU" = (
/obj/structure/rack,
/obj/item/stack/sheet/metal{
	amount = 50;
	pixel_x = 4;
	pixel_y = 4
	},
/obj/item/stack/sheet/metal{
	amount = 30
	},
/turf/open/floor/tile/vault{
	dir = 8
	},
/area/lv624/ground/caves/central1)
"kG" = (
/obj/structure/rack,
/obj/item/tool/shovel,
/obj/effect/landmark/lv624/fog_blocker/xeno_spawn,
/turf/open/floor/tile/vault{
	dir = 8
	},
/area/lv624/ground/caves/central1)
"nH" = (
/obj/structure/rack,
/obj/effect/spawner/random/engineering/pickaxe,
/turf/open/floor/tile/vault{
	dir = 8
	},
/area/lv624/ground/caves/central1)
"oW" = (
/obj/structure/rack,
/turf/open/floor/tile/vault{
	dir = 8
	},
/area/lv624/ground/caves/central1)
"qd" = (
/obj/effect/landmark/lv624/fog_blocker,
/obj/effect/landmark/lv624/fog_blocker/xeno_spawn,
/turf/closed/mineral/smooth,
/area/lv624/ground/caves/rock)
"qN" = (
/obj/structure/flora/ausbushes/fullgrass,
/turf/open/floor/plating/ground/dirt,
/area/lv624/ground/caves/central2)
"vn" = (
/turf/closed/wall/r_wall,
/area/lv624/ground/caves/rock)
"yC" = (
/obj/structure/rack,
/obj/item/tool/shovel,
/turf/open/floor/tile/vault{
	dir = 8
	},
/area/lv624/ground/caves/central1)
"zK" = (
/obj/effect/landmark/lv624/fog_blocker,
/turf/closed/mineral/smooth,
/area/lv624/ground/caves/rock)
"zZ" = (
/obj/effect/landmark/xeno_resin_wall,
/obj/effect/landmark/xeno_resin_wall,
/turf/open/floor/plating/ground/dirt,
/area/lv624/ground/caves/central2)
"AS" = (
/obj/effect/ai_node,
/turf/open/liquid/water/river/autosmooth,
/area/lv624/ground/caves/central2)
"Bx" = (
/obj/effect/landmark/excavation_site_spawner,
/turf/open/floor/plating/ground/dirt,
/area/lv624/ground/caves/central1)
"BH" = (
/turf/open/floor/plating/ground/dirt,
/area/lv624/ground/caves/central1)
"CN" = (
/obj/effect/landmark/xeno_resin_door,
/obj/effect/ai_node,
/turf/open/floor/plating/ground/dirt,
/area/lv624/ground/caves/central1)
"Dp" = (
/turf/open/floor,
/area/lv624/ground/caves/central1/garbledradio)
"DG" = (
/obj/effect/landmark/weed_node,
/turf/open/floor/plating/ground/dirt,
/area/lv624/ground/caves/central1)
"DY" = (
/turf/closed/wall/r_wall,
/area/lv624/ground/caves/central1/garbledradio)
"EE" = (
/obj/effect/landmark/lv624/fog_blocker/xeno_spawn,
/turf/closed/wall/r_wall,
/area/lv624/ground/caves/rock)
"EO" = (
/obj/structure/rack,
/obj/item/stack/sheet/mineral/iron{
	amount = 5
	},
/obj/item/stack/sheet/mineral/platinum,
/obj/machinery/light{
	dir = 8
	},
/obj/effect/landmark/lv624/fog_blocker/xeno_spawn,
/turf/open/floor/tile/vault{
	dir = 8
	},
/area/lv624/ground/caves/central1)
"Fz" = (
/obj/effect/ai_node,
/turf/open/floor/tile/dark,
/area/lv624/ground/caves/central1)
"FI" = (
/obj/effect/landmark/weed_node,
/turf/open/floor/plating/ground/dirt,
/area/lv624/ground/caves/central2)
"Gr" = (
/obj/structure/rack,
/obj/item/stack/sheet/mineral/diamond{
	amount = 2
	},
/turf/open/floor/tile/vault{
	dir = 8
	},
/area/lv624/ground/caves/central1)
"Gw" = (
/turf/open/floor/plating/ground/dirt,
/area/lv624/ground/caves/central2)
"GI" = (
/obj/effect/landmark/excavation_site_spawner,
/turf/open/floor/plating/ground/dirt,
/area/lv624/ground/caves/central2)
"GV" = (
/turf/closed/mineral/smooth,
/area/lv624/ground/caves/rock)
"IU" = (
/turf/closed/mineral/smooth/indestructible,
/area/lv624/ground/caves/rock)
"MS" = (
/obj/structure/rack,
/obj/item/stack/sheet/mineral/silver{
	amount = 20
	},
/turf/open/floor/tile/vault{
	dir = 8
	},
/area/lv624/ground/caves/central1)
"OV" = (
/obj/structure/rack,
/obj/effect/landmark/lv624/fog_blocker/xeno_spawn,
/turf/open/floor/tile/vault{
	dir = 8
	},
/area/lv624/ground/caves/central1)
"PS" = (
/obj/structure/rack,
/obj/item/stack/sheet/mineral/gold{
	amount = 2
	},
/obj/item/stack/sheet/mineral/platinum{
	pixel_x = -6
	},
/turf/open/floor/tile/vault{
	dir = 8
	},
/area/lv624/ground/caves/central1)
"QB" = (
/obj/structure/flora/jungle/plantbot1/alien,
/turf/open/liquid/water/river/autosmooth,
/area/lv624/ground/caves/central2)
"Rk" = (
/obj/structure/flora/ausbushes/fernybush,
/turf/open/liquid/water/river/autosmooth,
/area/lv624/ground/caves/central2)
"Sl" = (
/turf/open/liquid/water/river/autosmooth,
/area/lv624/ground/caves/central2)
"SW" = (
/obj/effect/landmark/xeno_resin_wall,
/turf/open/floor/plating/ground/dirt,
/area/lv624/ground/caves/central2)
"Tu" = (
/obj/structure/rack,
/obj/item/stack/sheet/mineral/tritium{
	pixel_x = -4
	},
/turf/open/floor/tile/vault{
	dir = 8
	},
/area/lv624/ground/caves/central1)
"Zf" = (
/turf/open/floor/tile/dark,
/area/lv624/ground/caves/central1)
"ZW" = (
/obj/effect/ai_node,
/turf/open/floor/plating/ground/dirt,
/area/lv624/ground/caves/central2)

(1,1,1) = {"
GV
GV
GV
GV
GV
GV
GV
GV
GV
GV
hG
hG
hG
hG
hG
GV
GV
GV
GV
GV
GV
GV
GV
GV
GV
GV
GV
aC
aC
aC
aC
aC
aC
"}
(2,1,1) = {"
GV
GV
GV
GV
GV
GV
GV
GV
GV
GV
Gw
Gw
Gw
Gw
Gw
GV
GV
GV
GV
GV
GV
GV
GV
GV
GV
GV
GV
GV
GV
GV
GV
GV
aC
"}
(3,1,1) = {"
GV
GV
GV
GV
GV
GV
GV
GV
GV
GV
Gw
FI
Gw
Gw
Gw
Gw
Gw
Gw
Gw
GV
GV
GV
GV
GV
GV
GV
IU
IU
IU
IU
IU
GV
GV
"}
(4,1,1) = {"
GV
GV
GV
GV
GV
GV
GV
SW
Gw
Gw
Gw
Gw
Gw
FI
Gw
Gw
Gw
Gw
Gw
Gw
Gw
Gw
GV
GV
GV
GV
IU
IU
IU
IU
IU
GV
GV
"}
(5,1,1) = {"
GV
GV
GV
GV
GV
GV
GV
SW
Gw
Gw
FI
ZW
Gw
Gw
Gw
Gw
FI
Gw
ZW
Gw
FI
ZW
Gw
GV
GV
GV
IU
IU
IU
IU
IU
GV
GV
"}
(6,1,1) = {"
GV
GV
GV
GV
GV
GV
SW
SW
Gw
Gw
Gw
Gw
Gw
Gw
Gw
Gw
Gw
Gw
Gw
FI
Gw
Gw
FI
Gw
GV
GV
GV
GV
GV
GV
GV
GV
GV
"}
(7,1,1) = {"
GV
GV
GV
GV
GV
GV
SW
Gw
FI
Gw
Gw
Gw
SW
GV
GV
SW
SW
Gw
Gw
Gw
Gw
Gw
Sl
Sl
GV
GV
GV
GV
GV
GV
GV
GV
GV
"}
(8,1,1) = {"
GV
GV
GV
GV
GV
SW
SW
Gw
Gw
Gw
Gw
Gw
SW
GV
GV
GV
GV
GV
Gw
Gw
FI
Sl
Sl
Rk
Sl
GV
IU
IU
IU
IU
IU
GV
GV
"}
(9,1,1) = {"
GV
GV
GV
GV
GV
SW
Gw
Gw
Gw
Gw
FI
Gw
SW
SW
GV
GV
GV
GV
Gw
Sl
Sl
Sl
Sl
QB
Sl
GV
IU
IU
IU
IU
IU
GV
GV
"}
(10,1,1) = {"
GV
GV
GV
GV
GV
SW
Gw
Gw
Gw
GI
Gw
Gw
Gw
SW
SW
GV
GV
Gw
Sl
Sl
Sl
Sl
Sl
Sl
GV
GV
IU
IU
IU
IU
IU
GV
GV
"}
(11,1,1) = {"
GV
GV
GV
GV
GV
Gw
Gw
FI
Gw
Gw
Gw
Gw
Gw
Gw
SW
SW
SW
Gw
Sl
Sl
QB
Sl
Sl
Gw
GV
GV
GV
GV
GV
GV
GV
GV
GV
"}
(12,1,1) = {"
GV
GV
GV
GV
GV
ZW
Gw
Gw
Gw
Gw
Gw
ZW
Gw
qN
Gw
Gw
Gw
Sl
AS
Sl
Rk
AS
Gw
Gw
GV
GV
GV
GV
GV
GV
GV
GV
GV
"}
(13,1,1) = {"
GV
GV
GV
GV
GV
Gw
Gw
Gw
Gw
qN
FI
Gw
Gw
FI
Gw
Gw
Sl
Sl
Sl
Sl
Sl
Sl
Gw
FI
GV
GV
IU
IU
IU
IU
IU
GV
GV
"}
(14,1,1) = {"
GV
GV
GV
GV
SW
Gw
Gw
FI
Gw
Gw
hy
Gw
Gw
Gw
Gw
Sl
Sl
Sl
Sl
Sl
cp
Sl
Gw
GV
GV
GV
IU
IU
IU
IU
IU
GV
GV
"}
(15,1,1) = {"
GV
GV
GV
SW
SW
FI
Gw
Gw
Gw
Gw
Gw
Gw
Gw
Gw
Sl
Sl
Sl
Sl
Sl
Sl
Sl
Sl
FI
GV
GV
GV
IU
IU
IU
IU
IU
GV
GV
"}
(16,1,1) = {"
GV
GV
GV
SW
Gw
Gw
Gw
qN
Gw
FI
Gw
FI
Gw
Gw
Sl
Sl
QB
Sl
Sl
qN
Gw
Gw
Gw
GV
GV
GV
GV
GV
GV
GV
GV
GV
GV
"}
(17,1,1) = {"
GV
GV
GV
SW
Gw
Gw
Gw
Gw
Gw
Gw
Gw
Gw
GV
GV
Sl
Sl
Sl
GV
GV
Gw
FI
Gw
GV
GV
GV
GV
GV
GV
GV
GV
GV
GV
GV
"}
(18,1,1) = {"
GV
GV
GV
SW
Gw
FI
Gw
FI
Gw
Gw
GV
GV
GV
GV
Sl
Sl
Sl
GV
GV
GV
Gw
Gw
Gw
GV
GV
GV
SW
SW
GV
GV
IU
IU
IU
"}
(19,1,1) = {"
GV
GV
GV
SW
Gw
Gw
Gw
Gw
Gw
GV
GV
GV
GV
GV
Sl
Sl
cp
Sl
GV
GV
Gw
ZW
Gw
Gw
GV
GV
Gw
SW
SW
GV
IU
IU
IU
"}
(20,1,1) = {"
GV
GV
SW
SW
Gw
Gw
Gw
Gw
GV
GV
GV
GV
GV
Sl
Sl
Sl
Sl
Sl
Gw
Gw
Gw
Gw
ZW
Gw
eA
Gw
Gw
Gw
SW
GV
IU
IU
IU
"}
(21,1,1) = {"
GV
SW
SW
Gw
Gw
ZW
Gw
ZW
GV
GV
GV
GV
Sl
Sl
QB
Sl
Sl
Sl
Gw
Gw
Gw
FI
Gw
ZW
eA
Gw
ZW
Gw
SW
GV
GV
GV
GV
"}
(22,1,1) = {"
GV
SW
Gw
qN
Gw
Gw
FI
Gw
ZW
Gw
Gw
Sl
Sl
Sl
Sl
Sl
Sl
Gw
FI
ZW
Gw
ZW
Gw
FI
eA
FI
Gw
Gw
SW
GV
GV
GV
GV
"}
(23,1,1) = {"
GV
SW
Gw
Gw
GV
GV
Gw
Gw
Gw
Gw
Sl
Sl
Sl
Rk
Sl
Sl
Sl
Gw
Gw
FI
Gw
qN
Gw
Gw
eA
Gw
Gw
FI
Gw
SW
GV
GV
GV
"}
(24,1,1) = {"
GV
SW
Gw
Gw
GV
GV
GV
Gw
Gw
at
Sl
Sl
Sl
Sl
Sl
GV
GV
SW
Gw
Gw
Gw
Gw
GV
GV
SW
Gw
Gw
Gw
Gw
SW
GV
GV
GV
"}
(25,1,1) = {"
GV
SW
FI
Gw
Gw
GV
GV
Gw
Gw
Sl
Sl
Sl
Sl
Sl
GV
GV
GV
GV
SW
Gw
Gw
SW
GV
GV
GV
SW
Gw
Gw
Gw
SW
SW
GV
GV
"}
(26,1,1) = {"
GV
SW
Gw
Gw
hy
Gw
Gw
Gw
Gw
Sl
Sl
Sl
Sl
GV
GV
GV
GV
GV
Gw
Gw
Gw
SW
GV
GV
GV
SW
Gw
FI
Gw
SW
SW
GV
GV
"}
(27,1,1) = {"
GV
SW
Gw
Gw
Gw
Gw
qN
FI
Gw
Sl
QB
Sl
GV
GV
GV
GV
GV
GV
Gw
FI
Gw
SW
GV
GV
SW
SW
ZW
Gw
Gw
SW
GV
GV
GV
"}
(28,1,1) = {"
GV
SW
Gw
Gw
FI
Gw
Gw
ZW
Gw
Sl
Sl
Sl
GV
GV
GV
GV
GV
GV
Gw
Gw
Gw
GV
GV
GV
zZ
Gw
Gw
Gw
SW
SW
GV
GV
GV
"}
(29,1,1) = {"
GV
SW
Gw
FI
Gw
Gw
ZW
GV
GV
Sl
Sl
Sl
Sl
GV
GV
GV
GV
GV
Gw
Gw
Gw
GV
GV
GV
SW
Gw
FI
Gw
SW
GV
GV
GV
GV
"}
(30,1,1) = {"
GV
SW
Gw
qN
Gw
Gw
Gw
GV
GV
Sl
Sl
cp
Sl
Gw
GV
GV
GV
Gw
Gw
FI
Gw
GV
GV
SW
SW
Gw
Gw
Gw
SW
GV
GV
GV
GV
"}
(31,1,1) = {"
GV
SW
Gw
Gw
Gw
Gw
Gw
GV
GV
Gw
Sl
Sl
Sl
Sl
eA
Gw
Gw
Gw
Gw
ZW
GV
GV
GV
SW
Gw
Gw
Gw
Gw
SW
GV
GV
GV
GV
"}
(32,1,1) = {"
GV
SW
Gw
Gw
Gw
Gw
ZW
GV
GV
GV
Sl
Sl
AS
Sl
eA
Gw
FI
Gw
ZW
Gw
GV
GV
SW
SW
Gw
Gw
Gw
SW
SW
GV
GV
GV
GV
"}
(33,1,1) = {"
GV
SW
SW
Gw
FI
qN
Gw
SW
GV
GV
Sl
Sl
Sl
Sl
eA
Gw
Gw
hy
Gw
Gw
GV
GV
SW
Gw
ZW
FI
ZW
SW
GV
GV
GV
GV
GV
"}
(34,1,1) = {"
GV
GV
SW
Gw
Gw
Gw
Gw
SW
GV
GV
GV
Sl
Sl
GV
GV
SW
Gw
Gw
Gw
Gw
GV
GV
GV
Gw
Gw
Gw
Gw
SW
GV
IU
IU
GV
GV
"}
(35,1,1) = {"
GV
GV
SW
SW
Gw
Gw
Gw
Gw
Gw
GV
GV
Sl
Sl
GV
GV
GV
SW
Gw
qN
GV
GV
GV
GV
Gw
Gw
Gw
Gw
GV
GV
IU
IU
GV
GV
"}
(36,1,1) = {"
GV
GV
GV
SW
Gw
Gw
Gw
FI
Gw
eA
Gw
Sl
Sl
Sl
GV
GV
GV
Gw
Gw
GV
GV
GV
Gw
Gw
Gw
qN
Gw
GV
GV
IU
IU
GV
GV
"}
(37,1,1) = {"
GV
GV
SW
SW
Gw
Gw
ZW
Gw
Gw
eA
Gw
Sl
AS
Sl
GV
GV
GV
Gw
FI
GV
GV
GV
Gw
FI
Gw
Gw
Gw
GV
GV
IU
IU
GV
GV
"}
(38,1,1) = {"
GV
GV
GV
SW
Gw
FI
Gw
Gw
qN
eA
Gw
Sl
Sl
Sl
GV
GV
GV
Gw
Gw
GV
GV
GV
Gw
Gw
ZW
FI
Gw
SW
GV
IU
IU
GV
IU
"}
(39,1,1) = {"
GV
GV
GV
SW
Gw
Gw
Gw
Gw
SW
GV
GV
Gw
Sl
QB
Sl
GV
GV
GV
Gw
SW
GV
GV
GV
Gw
Gw
ZW
Gw
SW
GV
IU
IU
GV
IU
"}
(40,1,1) = {"
GV
GV
GV
SW
Gw
Gw
Gw
SW
SW
GV
GV
GV
AS
Sl
Sl
AS
GV
GV
Gw
Gw
SW
GV
GV
Gw
Gw
Gw
Gw
Gw
GV
GV
GV
GV
IU
"}
(41,1,1) = {"
GV
GV
GV
SW
Gw
Gw
Gw
SW
SW
SW
GV
GV
GV
Sl
Sl
Sl
Sl
Sl
Sl
FI
Gw
Gw
eA
Gw
Gw
Gw
Gw
Gw
SW
GV
GV
GV
GV
"}
(42,1,1) = {"
GV
GV
GV
SW
Gw
FI
ZW
Gw
Gw
SW
SW
GV
GV
Sl
Sl
AS
Sl
Sl
AS
Gw
Gw
FI
eA
Gw
Gw
ZW
FI
qN
SW
GV
GV
GV
GV
"}
(43,1,1) = {"
GV
GV
GV
SW
Gw
Gw
qN
Gw
Gw
FI
SW
GV
GV
Gw
Sl
Sl
Sl
Sl
Sl
Sl
qN
Gw
eA
FI
Gw
Gw
qN
Gw
Gw
SW
GV
Gw
Gw
"}
(44,1,1) = {"
GV
GV
GV
SW
Gw
Gw
Gw
Gw
Gw
Gw
SW
GV
GV
GV
Gw
Sl
cp
Sl
QB
Sl
Gw
GV
GV
Gw
Gw
Gw
Gw
Gw
FI
Gw
Gw
Gw
Gw
"}
(45,1,1) = {"
GV
GV
GV
SW
SW
Gw
Gw
FI
Gw
Gw
SW
GV
GV
GV
GV
Sl
Sl
Sl
Sl
Sl
GV
GV
GV
GV
Gw
Gw
Gw
Gw
Gw
Gw
Gw
Gw
Gw
"}
(46,1,1) = {"
GV
GV
GV
GV
SW
Gw
Gw
Gw
Gw
GV
GV
GV
GV
GV
GV
Gw
Sl
Sl
Sl
Sl
GV
GV
GV
GV
Gw
FI
Gw
Gw
Gw
GI
Gw
Gw
FI
"}
(47,1,1) = {"
GV
GV
GV
GV
SW
Gw
Gw
Gw
Gw
GV
GV
GV
GV
GV
Gw
FI
Gw
Sl
Sl
Sl
Sl
Sl
GV
GV
Gw
Gw
Gw
Gw
Gw
Gw
Gw
Gw
Gw
"}
(48,1,1) = {"
GV
GV
GV
GV
SW
Gw
Gw
Gw
Gw
GV
GV
GV
Gw
eA
Gw
Gw
GV
GV
Sl
Sl
Rk
Sl
GV
GV
GV
ZW
Gw
Gw
Gw
Gw
Gw
FI
Gw
"}
(49,1,1) = {"
GV
GV
GV
GV
SW
Gw
FI
Gw
Gw
GV
GV
Gw
Gw
eA
Gw
Gw
GV
GV
GV
Sl
Sl
Sl
GV
GV
GV
FI
ZW
Gw
FI
Gw
Gw
Gw
ZW
"}
(50,1,1) = {"
GV
GV
GV
GV
GV
Gw
Gw
Gw
Gw
Gw
Gw
Gw
Gw
hh
qN
ZW
SW
GV
GV
GV
Sl
Sl
Sl
GV
GV
Gw
Gw
Gw
Gw
Gw
Gw
ZW
Gw
"}
(51,1,1) = {"
GV
GV
GV
GV
GV
Gw
ZW
Gw
Gw
Gw
Gw
Gw
Gw
eA
Gw
Gw
ZW
SW
GV
GV
Sl
Sl
Sl
Gw
eA
Gw
Gw
GV
GV
GV
Gw
Gw
Gw
"}
(52,1,1) = {"
GV
GV
GV
GV
GV
ZW
Gw
Gw
qN
Gw
FI
Gw
Gw
GV
GV
Gw
Gw
ZW
Sl
Sl
Sl
QB
Sl
qN
eA
FI
ZW
GV
GV
GV
Gw
Gw
GV
"}
(53,1,1) = {"
GV
GV
GV
GV
GV
FI
Gw
hy
FI
Gw
Gw
Gw
Gw
GV
GV
GV
Gw
Sl
Sl
Sl
cp
Sl
Sl
Gw
eA
Gw
Gw
SW
GV
GV
Gw
Gw
GV
"}
(54,1,1) = {"
GV
GV
GV
GV
GV
Gw
Gw
Gw
Gw
Gw
Gw
Gw
Gw
SW
GV
GV
GV
Sl
Sl
Sl
Sl
Sl
Sl
GV
GV
Gw
Gw
Gw
GV
SW
FI
Gw
GV
"}
(55,1,1) = {"
GV
GV
GV
GV
GV
Gw
FI
Gw
Gw
Gw
Gw
Gw
qN
Gw
SW
GV
GV
Sl
cp
Sl
GV
GV
GV
GV
GV
Gw
Gw
Gw
Gw
Gw
Gw
Gw
GV
"}
(56,1,1) = {"
GV
GV
GV
GV
GV
Gw
Gw
Gw
Gw
Gw
FI
Gw
Gw
Gw
eA
Gw
Sl
Sl
Sl
Sl
GV
GV
GV
GV
SW
Gw
dD
Gw
Gw
Gw
Gw
ZW
GV
"}
(57,1,1) = {"
GV
GV
GV
GV
GV
Gw
Gw
qN
Gw
Gw
Gw
ZW
Gw
Gw
eA
Gw
Sl
AS
Sl
GV
GV
GV
GV
GV
SW
ZW
Gw
Gw
Gw
Gw
Gw
Gw
GV
"}
(58,1,1) = {"
GV
GV
GV
GV
GV
ZW
Gw
Gw
FI
Gw
ZW
Gw
Gw
Gw
GV
Gw
Sl
Sl
Sl
Sl
GV
GV
GV
SW
SW
Gw
Gw
Gw
Gw
FI
Gw
GV
GV
"}
(59,1,1) = {"
GV
GV
GV
GV
GV
GV
SW
Gw
Gw
Gw
Gw
Gw
Gw
GV
GV
GV
Gw
Sl
Sl
Rk
Sl
Sl
Gw
eA
Gw
Gw
Gw
Gw
Gw
Gw
GV
GV
GV
"}
(60,1,1) = {"
GV
GV
GV
GV
GV
GV
SW
Gw
Gw
Gw
FI
Gw
GV
GV
GV
GV
Gw
Sl
Sl
Sl
Sl
Sl
FI
eA
Gw
Gw
FI
Gw
Gw
GV
GV
GV
GV
"}
(61,1,1) = {"
GV
GV
GV
GV
GV
GV
SW
SW
SW
Gw
Gw
Gw
GV
GV
GV
Gw
Gw
FI
Sl
cp
Sl
Sl
Gw
GV
GV
Gw
Gw
Gw
GV
GV
GV
GV
GV
"}
(62,1,1) = {"
GV
GV
GV
GV
GV
GV
GV
GV
SW
SW
GI
Gw
Gw
GV
GV
Gw
qN
Gw
Sl
QB
Sl
GV
GV
GV
GV
Gw
Gw
GV
GV
GV
GV
GV
GV
"}
(63,1,1) = {"
GV
GV
GV
GV
GV
GV
GV
GV
GV
SW
Gw
Gw
FI
Gw
eA
Gw
FI
Gw
Sl
Sl
Sl
GV
GV
Sl
Sl
Sl
GV
GV
GV
GV
GV
GV
GV
"}
(64,1,1) = {"
GV
GV
GV
GV
GV
GV
GV
GV
GV
SW
Gw
Gw
Gw
ZW
eA
Gw
Gw
ZW
Sl
Sl
Sl
AS
Sl
Sl
Sl
AS
GV
GV
GV
GV
GV
GV
GV
"}
(65,1,1) = {"
GV
GV
GV
GV
GV
GV
GV
GV
GV
SW
Gw
Gw
Gw
Gw
eA
Gw
GV
GV
Gw
Sl
Sl
Sl
Sl
Sl
QB
Sl
GV
GV
GV
GV
GV
GV
GV
"}
(66,1,1) = {"
GV
GV
GV
GV
GV
GV
GV
GV
GV
SW
Gw
Gw
FI
Gw
SW
GV
GV
GV
GV
Sl
Sl
cp
Sl
Sl
Sl
Sl
GV
GV
IU
IU
IU
IU
GV
"}
(67,1,1) = {"
GV
GV
GV
GV
GV
GV
GV
GV
GV
SW
Gw
Gw
Gw
Gw
SW
GV
GV
GV
GV
Sl
Sl
Sl
GV
GV
GV
Sl
GV
GV
IU
IU
IU
IU
GV
"}
(68,1,1) = {"
GV
GV
GV
GV
GV
GV
GV
GV
GV
SW
Gw
Gw
Gw
Gw
GV
GV
GV
GV
GV
GV
Gw
FI
GV
GV
GV
Gw
GV
GV
IU
IU
IU
IU
GV
"}
(69,1,1) = {"
GV
GV
GV
GV
GV
GV
GV
GV
GV
GV
FI
Gw
FI
Gw
GV
GV
GV
GV
GV
GV
Gw
Gw
Gw
GV
GV
FI
GV
GV
GV
GV
GV
GV
GV
"}
(70,1,1) = {"
GV
GV
GV
GV
GV
GV
GV
GV
GV
GV
Gw
Gw
Gw
Gw
GV
GV
GV
GV
GV
GV
GV
Gw
Gw
Gw
Gw
Gw
GV
GV
IU
IU
IU
IU
GV
"}
(71,1,1) = {"
IU
IU
IU
IU
GV
IU
IU
IU
IU
GV
Gw
Gw
Gw
Gw
Gw
GV
GV
GV
GV
GV
GV
Gw
FI
Gw
Gw
FI
GV
GV
IU
IU
IU
IU
GV
"}
(72,1,1) = {"
IU
IU
IU
IU
GV
IU
IU
IU
IU
GV
it
it
it
it
it
GV
GV
GV
GV
GV
GV
CN
it
it
it
it
GV
GV
IU
IU
IU
IU
GV
"}
(73,1,1) = {"
IU
IU
IU
IU
GV
IU
IU
IU
IU
GV
BH
BH
BH
fD
BH
GV
GV
GV
GV
GV
fD
BH
BH
BH
BH
fD
GV
GV
GV
GV
GV
GV
GV
"}
(74,1,1) = {"
IU
IU
IU
IU
GV
IU
IU
IU
IU
GV
BH
BH
Bx
BH
DG
GV
GV
GV
GV
GV
BH
DG
BH
GV
GV
GV
GV
qd
EE
kG
EO
OV
EE
"}
(75,1,1) = {"
GV
GV
GV
GV
GV
GV
GV
GV
GV
GV
BH
DG
BH
BH
BH
GV
GV
GV
GV
BH
BH
BH
BH
BH
GV
GV
GV
zK
vn
PS
Zf
Tu
vn
"}
(76,1,1) = {"
IU
IU
IU
IU
GV
IU
IU
IU
IU
GV
BH
BH
BH
BH
BH
BH
GV
GV
BH
BH
BH
DG
BH
BH
GV
GV
GV
zK
vn
Gr
Fz
MS
DY
"}
(77,1,1) = {"
IU
IU
IU
IU
GV
IU
IU
IU
IU
GV
BH
BH
BH
DG
BH
BH
GV
BH
BH
BH
BH
BH
BH
GV
GV
GV
GV
zK
vn
jU
Zf
oW
DY
"}
(78,1,1) = {"
IU
IU
IU
IU
GV
IU
IU
IU
IU
GV
GV
BH
BH
BH
BH
BH
BH
BH
BH
BH
BH
BH
GV
GV
GV
GV
GV
zK
vn
yC
Zf
nH
DY
"}
(79,1,1) = {"
GV
GV
GV
GV
GV
GV
GV
GV
GV
GV
GV
GV
BH
fD
BH
DG
BH
BH
DG
BH
BH
DG
GV
GV
GV
GV
GV
zK
vn
gQ
ev
gQ
DY
"}
(80,1,1) = {"
IU
IU
IU
IU
GV
IU
IU
IU
IU
GV
GV
GV
GV
BH
fD
BH
BH
BH
BH
BH
BH
BH
it
BH
GV
GV
GV
zK
GV
Dp
Dp
Dp
Dp
"}
