//MAP CONVERTED BY dmm2tgm.py THIS HEADER COMMENT PREVENTS RECONVERSION, DO NOT REMOVE
"bk" = (
/turf/closed/wall/r_wall,
/area/lv624/ground/caves/central1)
"bF" = (
/obj/effect/landmark/weed_node,
/turf/open/floor/tile/dark,
/area/lv624/ground/caves/central1)
"co" = (
/turf/open/floor,
/area/lv624/ground/caves/central1)
"cr" = (
/obj/effect/decal/lvsanddecal,
/obj/effect/decal/lvsanddecal{
	dir = 8
	},
/turf/open/floor/tile/darkgreen,
/area/lv624/ground/caves/central2)
"cu" = (
/obj/item/mecha_parts/part/durand_head,
/obj/mecha_wreckage/durand,
/turf/open/floor/plating/ground/dirt,
/area/lv624/ground/caves/central2)
"cQ" = (
/obj/effect/decal/cleanable/dirt,
/obj/effect/decal/lvsanddecal{
	dir = 4
	},
/obj/effect/decal/lvsanddecal{
	dir = 8
	},
/turf/open/floor/tile/darkgreen,
/area/lv624/ground/caves/central2)
"dg" = (
/obj/effect/decal/cleanable/dirt,
/turf/open/floor/plating/ground/dirt,
/area/lv624/ground/caves/central2)
"dX" = (
/obj/structure/rack,
/obj/item/tool/shovel,
/obj/effect/landmark/lv624/fog_blocker/xeno_spawn,
/turf/open/floor/tile/vault{
	dir = 8
	},
/area/lv624/ground/caves/central1)
"eJ" = (
/obj/effect/ai_node,
/turf/open/floor/plating/ground/dirt,
/area/lv624/ground/caves/central2)
"fB" = (
/turf/open/floor/tile/cafe,
/area/lv624/ground/caves/central2)
"gj" = (
/obj/item/mecha_parts/part/durand_right_leg,
/obj/effect/ai_node,
/turf/open/floor/plating/ground/dirt,
/area/lv624/ground/caves/central2)
"gq" = (
/obj/machinery/constructable_frame/state_2,
/turf/open/floor/plating/ground/dirt,
/area/lv624/ground/caves/central2)
"gv" = (
/obj/machinery/miner/damaged/platinum,
/turf/open/floor/plating/ground/dirt,
/area/lv624/ground/caves/central2)
"gx" = (
/obj/effect/spawner/random/tool,
/turf/open/floor/plating/ground/dirt,
/area/lv624/ground/caves/central2)
"gG" = (
/obj/effect/ai_node,
/obj/structure/flora/ausbushes/fullgrass,
/turf/open/floor/plating/ground/dirt,
/area/lv624/ground/caves/central2)
"gI" = (
/obj/effect/ai_node,
/turf/open/floor/plating/ground/dirt,
/area/lv624/ground/caves/central1)
"gM" = (
/obj/effect/landmark/excavation_site_spawner,
/turf/open/floor/plating/ground/dirt,
/area/lv624/ground/caves/central1)
"gX" = (
/obj/effect/landmark/xeno_resin_door,
/turf/open/floor/plating/ground/dirt,
/area/lv624/ground/caves/central3)
"gZ" = (
/obj/structure/rack/nometal,
/obj/effect/spawner/random/toolbox,
/obj/effect/spawner/random/cable,
/turf/open/floor/plating/ground/dirt,
/area/lv624/ground/caves/central2)
"hL" = (
/obj/machinery/mech_bay_recharge_port,
/turf/open/floor/tile/darkgreen,
/area/lv624/ground/caves/central2)
"jw" = (
/obj/structure/rack,
/obj/item/stack/sheet/mineral/diamond{
	amount = 2
	},
/turf/open/floor/tile/vault{
	dir = 8
	},
/area/lv624/ground/caves/central1)
"jJ" = (
/turf/closed/wall,
/area/lv624/ground/caves/central2)
"km" = (
/obj/structure/rack,
/obj/item/stack/sheet/mineral/silver{
	amount = 20
	},
/turf/open/floor/tile/vault{
	dir = 8
	},
/area/lv624/ground/caves/central1)
"lP" = (
/obj/structure/device/broken_piano,
/obj/effect/decal/cleanable/dirt,
/turf/open/floor/tile/cafe,
/area/lv624/ground/caves/central2)
"mj" = (
/obj/effect/landmark/lv624/fog_blocker/xeno_spawn,
/turf/closed/wall/r_wall,
/area/lv624/ground/caves/rock)
"nQ" = (
/obj/item/mecha_parts/part/durand_head,
/obj/item/mecha_parts/part/durand_right_leg,
/turf/open/floor/plating/ground/dirt,
/area/lv624/ground/caves/central2)
"nT" = (
/obj/effect/landmark/xeno_resin_door,
/obj/effect/ai_node,
/turf/open/floor/plating/ground/dirt,
/area/lv624/ground/caves/central1)
"qe" = (
/obj/effect/landmark/weed_node,
/turf/open/floor/plating/ground/dirt,
/area/lv624/ground/caves/central1)
"qA" = (
/obj/effect/decal/lvsanddecal,
/obj/effect/decal/cleanable/dirt,
/turf/open/floor/tile/cafe,
/area/lv624/ground/caves/central2)
"qK" = (
/obj/effect/landmark/weed_node,
/obj/effect/ai_node,
/turf/open/floor/plating/ground/dirt,
/area/lv624/ground/caves/central2)
"qW" = (
/obj/effect/landmark/xeno_resin_wall,
/turf/open/floor/plating/ground/dirt,
/area/lv624/ground/caves/central1)
"rO" = (
/obj/structure/rack,
/turf/open/floor/tile/vault{
	dir = 8
	},
/area/lv624/ground/caves/central1)
"sB" = (
/obj/item/shard,
/obj/effect/decal/lvsanddecal{
	dir = 8
	},
/turf/open/floor/tile/cafe,
/area/lv624/ground/caves/central2)
"tk" = (
/obj/effect/spawner/random/trash,
/turf/open/floor/plating/ground/dirt,
/area/lv624/ground/caves/central2)
"ty" = (
/obj/structure/rack,
/obj/item/stack/sheet/mineral/gold{
	amount = 2
	},
/obj/item/stack/sheet/mineral/platinum{
	pixel_x = -6
	},
/turf/open/floor/tile/vault{
	dir = 8
	},
/area/lv624/ground/caves/central1)
"tJ" = (
/turf/open/floor/plating/ground/dirt,
/area/lv624/ground/caves/central3)
"tK" = (
/obj/effect/decal/lvsanddecal,
/turf/open/floor/tile/darkgreen,
/area/lv624/ground/caves/central2)
"uN" = (
/turf/closed/mineral/smooth,
/area/lv624/ground/caves/central1)
"vo" = (
/turf/open/floor/plating/ground/dirt,
/area/lv624/ground/caves/central1)
"xX" = (
/obj/effect/landmark/weed_node,
/turf/open/floor/plating/ground/dirt,
/area/lv624/ground/caves/central2)
"yu" = (
/obj/effect/landmark/xeno_resin_wall,
/turf/open/floor/plating/ground/dirt,
/area/lv624/ground/caves/central2)
"yv" = (
/turf/closed/wall/r_wall,
/area/lv624/ground/caves/rock)
"yD" = (
/turf/open/floor/tile/dark,
/area/lv624/ground/caves/central1)
"yQ" = (
/obj/effect/landmark/lv624/fog_blocker,
/turf/closed/mineral/smooth,
/area/lv624/ground/caves/rock)
"ze" = (
/obj/structure/flora/ausbushes/fullgrass,
/turf/open/floor/plating/ground/dirt,
/area/lv624/ground/caves/central2)
"zj" = (
/obj/machinery/light,
/turf/open/floor/plating/ground/dirt,
/area/lv624/ground/caves/central2)
"AO" = (
/obj/effect/ai_node,
/turf/open/floor/tile/dark,
/area/lv624/ground/caves/central1)
"AR" = (
/obj/structure/rack,
/obj/item/tool/pickaxe,
/turf/open/floor/tile/vault{
	dir = 8
	},
/area/lv624/ground/caves/central1)
"Bh" = (
/obj/effect/decal/cleanable/dirt,
/turf/open/floor/tile/cafe,
/area/lv624/ground/caves/central2)
"Bt" = (
/turf/closed/mineral/smooth/indestructible,
/area/lv624/ground/caves/rock)
"Cf" = (
/obj/structure/rack,
/obj/effect/landmark/lv624/fog_blocker/xeno_spawn,
/turf/open/floor/tile/vault{
	dir = 8
	},
/area/lv624/ground/caves/central1)
"CL" = (
/obj/effect/landmark/excavation_site_spawner,
/turf/open/floor/plating/ground/dirt,
/area/lv624/ground/caves/central2)
"CO" = (
/obj/effect/decal/lvsanddecal{
	dir = 4
	},
/turf/open/floor/tile/cafe,
/area/lv624/ground/caves/central2)
"DQ" = (
/obj/machinery/constructable_frame/machine_frame,
/turf/open/floor/plating/ground/dirt,
/area/lv624/ground/caves/central2)
"Eb" = (
/obj/effect/decal/cleanable/dirt,
/obj/effect/decal/lvsanddecal,
/obj/effect/decal/lvsanddecal{
	dir = 4
	},
/turf/open/floor/tile/darkgreen,
/area/lv624/ground/caves/central2)
"Eg" = (
/obj/structure/rack,
/obj/item/stack/sheet/mineral/tritium{
	pixel_x = -4
	},
/turf/open/floor/tile/vault{
	dir = 8
	},
/area/lv624/ground/caves/central1)
"FO" = (
/obj/structure/girder/reinforced,
/turf/open/floor/plating/ground/dirt,
/area/lv624/ground/caves/central2)
"FU" = (
/obj/structure/girder,
/turf/open/floor/plating/ground/dirt,
/area/lv624/ground/caves/central2)
"Gs" = (
/obj/effect/decal/lvsanddecal{
	dir = 8
	},
/obj/effect/decal/cleanable/dirt,
/turf/open/floor/tile/cafe,
/area/lv624/ground/caves/central2)
"GX" = (
/turf/closed/wall,
/area/lv624/ground/caves/central1)
"Ii" = (
/obj/structure/girder/displaced,
/turf/open/floor/plating/ground/dirt,
/area/lv624/ground/caves/central2)
"ID" = (
/obj/effect/decal/lvsanddecal,
/obj/effect/decal/lvsanddecal{
	dir = 8
	},
/turf/open/floor/tile/cafe,
/area/lv624/ground/caves/central2)
"JT" = (
/obj/effect/landmark/xeno_resin_door,
/turf/open/floor/plating/ground/dirt,
/area/lv624/ground/caves/central1)
"JW" = (
/obj/effect/landmark/lv624/fog_blocker,
/obj/effect/landmark/lv624/fog_blocker/xeno_spawn,
/turf/closed/mineral/smooth,
/area/lv624/ground/caves/rock)
"Kf" = (
/obj/effect/landmark/weed_node,
/obj/effect/landmark/xeno_resin_wall,
/turf/open/floor/plating/ground/dirt,
/area/lv624/ground/caves/central2)
"Kp" = (
/obj/effect/decal/lvsanddecal{
	dir = 8
	},
/turf/open/floor/tile/cafe,
/area/lv624/ground/caves/central2)
"Lv" = (
/obj/structure/flora/ausbushes/fullgrass,
/obj/effect/landmark/weed_node,
/turf/open/floor/plating/ground/dirt,
/area/lv624/ground/caves/central2)
"LS" = (
/obj/item/mecha_parts/part/durand_right_leg,
/obj/effect/decal/lvsanddecal,
/obj/effect/decal/lvsanddecal{
	dir = 4
	},
/turf/open/floor/tile/darkgreen,
/area/lv624/ground/caves/central2)
"LU" = (
/obj/effect/decal/lvsanddecal{
	dir = 4
	},
/obj/effect/decal/cleanable/dirt,
/turf/open/floor/tile/cafe,
/area/lv624/ground/caves/central2)
"Mo" = (
/obj/effect/decal/cleanable/blood/splatter/animated,
/obj/effect/landmark/xeno_resin_wall,
/turf/open/floor/plating/ground/dirt,
/area/lv624/ground/caves/central2)
"MZ" = (
/obj/effect/decal/lvsanddecal,
/turf/open/floor/tile/cafe,
/area/lv624/ground/caves/central2)
"NA" = (
/obj/structure/bed/stool,
/turf/open/floor/plating/ground/dirt,
/area/lv624/ground/caves/central2)
"NZ" = (
/turf/open/floor/tile/darkgreen,
/area/lv624/ground/caves/central2)
"Oq" = (
/obj/effect/spawner/random/kitchen,
/turf/open/floor/plating/ground/dirt,
/area/lv624/ground/caves/central2)
"OE" = (
/obj/structure/window_frame/colony,
/obj/item/shard,
/turf/open/floor/plating/ground/dirt,
/area/lv624/ground/caves/central2)
"OR" = (
/obj/effect/decal/lvsanddecal,
/obj/effect/decal/lvsanddecal{
	dir = 8
	},
/obj/effect/spawner/random/trash,
/turf/open/floor/tile/darkgreen,
/area/lv624/ground/caves/central2)
"Py" = (
/obj/machinery/mech_bay_recharge_port,
/turf/open/floor/plating/ground/dirt,
/area/lv624/ground/caves/central2)
"PF" = (
/obj/item/shard,
/obj/effect/spawner/random/kitchen,
/turf/open/floor/plating/ground/dirt,
/area/lv624/ground/caves/central2)
"PL" = (
/obj/effect/decal/cleanable/blood/splatter/animated,
/turf/open/floor/plating/ground/dirt,
/area/lv624/ground/caves/central2)
"Rj" = (
/obj/item/shard,
/turf/open/floor/tile/cafe,
/area/lv624/ground/caves/central2)
"Rk" = (
/obj/effect/decal/lvsanddecal{
	dir = 8
	},
/turf/open/floor/mech_bay_recharge_floor/asteroid,
/area/lv624/ground/caves/central2)
"SN" = (
/obj/item/stack/sheet/metal/small_stack,
/turf/open/floor/plating/ground/dirt,
/area/lv624/ground/caves/central2)
"Uf" = (
/obj/structure/rack,
/obj/item/stack/sheet/metal{
	amount = 50;
	pixel_x = 4;
	pixel_y = 4
	},
/obj/item/stack/sheet/metal{
	amount = 30
	},
/turf/open/floor/tile/vault{
	dir = 8
	},
/area/lv624/ground/caves/central1)
"Ux" = (
/turf/open/floor/plating/ground/dirt,
/area/lv624/ground/caves/central2)
"US" = (
/obj/structure/rack,
/obj/item/stack/sheet/mineral/iron{
	amount = 5
	},
/obj/item/stack/sheet/mineral/platinum,
/obj/machinery/light{
	dir = 8
	},
/obj/effect/landmark/lv624/fog_blocker/xeno_spawn,
/turf/open/floor/tile/vault{
	dir = 8
	},
/area/lv624/ground/caves/central1)
"UV" = (
/obj/effect/landmark/weed_node,
/obj/effect/landmark/xeno_resin_door,
/turf/open/floor/plating/ground/dirt,
/area/lv624/ground/caves/central1)
"Vc" = (
/obj/effect/spawner/random/cable,
/turf/open/floor/plating/ground/dirt,
/area/lv624/ground/caves/central2)
"WV" = (
/obj/effect/decal/cleanable/dirt,
/obj/effect/decal/lvsanddecal,
/turf/open/floor/tile/darkgreen,
/area/lv624/ground/caves/central2)
"Xi" = (
/obj/machinery/door/airlock/mainship/secure/locked/free_access{
	dir = 4;
	name = "\improper Mining Storage"
	},
/turf/open/floor/tile/dark,
/area/lv624/ground/caves/central1)
"Xp" = (
/obj/effect/decal/lvsanddecal{
	dir = 4
	},
/obj/effect/decal/lvsanddecal,
/turf/open/floor/tile/cafe,
/area/lv624/ground/caves/central2)
"XC" = (
/turf/closed/mineral/smooth,
/area/lv624/ground/caves/rock)
"XM" = (
/obj/item/shard,
/turf/open/floor/plating/ground/dirt,
/area/lv624/ground/caves/central2)
"XP" = (
/obj/structure/rack,
/obj/item/tool/shovel,
/turf/open/floor/tile/vault{
	dir = 8
	},
/area/lv624/ground/caves/central1)
"Yu" = (
/obj/structure/window_frame/colony,
/turf/open/floor/plating/ground/dirt,
/area/lv624/ground/caves/central2)

(1,1,1) = {"
XC
XC
XC
XC
XC
XC
XC
XC
XC
XC
gX
gX
gX
gX
gX
XC
XC
XC
XC
XC
XC
XC
XC
XC
XC
XC
XC
tJ
tJ
tJ
tJ
tJ
tJ
"}
(2,1,1) = {"
XC
XC
XC
XC
XC
XC
XC
XC
XC
XC
Ux
Ux
Ux
Ux
Ux
XC
XC
XC
XC
XC
XC
XC
XC
XC
XC
XC
XC
XC
XC
XC
XC
XC
tJ
"}
(3,1,1) = {"
XC
XC
XC
XC
XC
XC
XC
XC
XC
XC
Ux
Ux
xX
Ux
Ux
Ux
xX
Ux
Ux
XC
XC
XC
XC
XC
XC
XC
Bt
Bt
Bt
Bt
Bt
XC
XC
"}
(4,1,1) = {"
XC
XC
XC
XC
XC
XC
XC
yu
yu
yu
Ux
Ux
Ux
Ux
Ux
Ux
Ux
Ux
Ux
Ux
Ux
Ux
XC
XC
XC
XC
Bt
Bt
Bt
Bt
Bt
XC
XC
"}
(5,1,1) = {"
XC
XC
XC
XC
XC
XC
XC
yu
yu
Ux
Ux
eJ
Ux
Ux
Ux
Ux
Ux
Ux
eJ
Ux
Ux
eJ
Ux
XC
XC
XC
Bt
Bt
Bt
Bt
Bt
XC
XC
"}
(6,1,1) = {"
XC
XC
XC
XC
XC
XC
Ux
xX
Ux
Ux
Ux
Ux
xX
Ux
Ux
Ux
Ux
xX
Ux
Ux
Ux
xX
Ux
yu
XC
XC
XC
XC
XC
XC
XC
XC
XC
"}
(7,1,1) = {"
XC
XC
XC
XC
XC
XC
Ux
Ux
Ux
Vc
Ux
Ux
Ux
Ux
Ux
yu
yu
Ux
Ux
Ux
yu
Ux
Ux
yu
XC
XC
XC
XC
XC
XC
XC
XC
XC
"}
(8,1,1) = {"
XC
XC
XC
XC
XC
Ux
Ux
Ux
Ux
Ux
Ux
Ux
yu
Ux
xX
yu
yu
Ux
Ux
Ux
Ux
Ux
Ux
yu
yu
XC
Bt
Bt
Bt
Bt
Bt
XC
XC
"}
(9,1,1) = {"
XC
XC
XC
XC
XC
Ux
SN
Ux
Ux
xX
Ux
Ux
Ux
Ux
Ux
Ux
Ux
Ux
Ux
xX
Ux
xX
Ux
yu
yu
XC
Bt
Bt
Bt
Bt
Bt
XC
XC
"}
(10,1,1) = {"
XC
XC
XC
XC
XC
Ux
Ux
Ux
Ux
CL
Ux
Ux
Ux
Ux
Ux
xX
Ux
Ux
Ux
SN
Ux
Ux
Ux
yu
XC
XC
Bt
Bt
Bt
Bt
Bt
XC
XC
"}
(11,1,1) = {"
XC
XC
XC
XC
XC
Ux
Ux
Ux
Ux
Ux
Ux
xX
gv
Ux
Ux
Ux
Ux
Ux
Ux
Ux
Ux
Ux
Ux
yu
XC
XC
XC
XC
XC
XC
XC
XC
XC
"}
(12,1,1) = {"
XC
XC
XC
XC
XC
eJ
Ux
Ux
Ux
Ux
Ux
eJ
Ux
ze
Ux
Ux
jJ
Ux
eJ
Ux
Ux
eJ
Ux
yu
XC
XC
XC
XC
XC
XC
XC
XC
XC
"}
(13,1,1) = {"
XC
XC
XC
XC
XC
Ux
Ux
yu
yu
Lv
Ux
Ux
eJ
xX
Ux
jJ
jJ
xX
Ux
yu
xX
Ux
yu
yu
XC
XC
Bt
Bt
Bt
Bt
Bt
XC
XC
"}
(14,1,1) = {"
XC
XC
XC
XC
yu
Ux
yu
yu
yu
Ux
Ux
Ux
xX
Ux
Ux
Ux
Ux
Ux
Ux
Ux
Ux
Ux
yu
XC
XC
XC
Bt
Bt
Bt
Bt
Bt
XC
XC
"}
(15,1,1) = {"
XC
XC
XC
yu
yu
Ux
yu
yu
Ux
Ux
Ux
Ux
Ux
Ux
Ux
Ux
Ux
yu
Ux
ze
Ux
Ux
yu
XC
XC
XC
Bt
Bt
Bt
Bt
Bt
XC
XC
"}
(16,1,1) = {"
XC
XC
XC
yu
Ux
xX
Ux
ze
Ux
Ux
Ux
Ux
Ux
SN
Ux
yu
yu
yu
Ux
Ux
Ux
Ux
yu
yu
XC
XC
XC
XC
XC
XC
XC
XC
XC
"}
(17,1,1) = {"
XC
XC
XC
yu
Ux
Ux
Ux
Ux
Ux
xX
Ux
Ux
Ux
Ux
Ux
Ux
SN
Ux
Ux
Ux
xX
Ux
Ux
yu
yu
XC
XC
XC
XC
XC
XC
XC
XC
"}
(18,1,1) = {"
XC
XC
XC
yu
Ux
Ux
yu
yu
yu
yu
jJ
PL
Ux
jJ
jJ
Ux
Ux
XM
Ux
Ux
Ux
Ux
Ux
Ux
yu
yu
yu
yu
XC
XC
Bt
Bt
Bt
"}
(19,1,1) = {"
XC
XC
XC
Ux
Ux
Ux
jJ
Yu
Yu
Yu
jJ
Ux
Ux
XM
jJ
Yu
Yu
Yu
jJ
Ux
yu
eJ
Ux
Ux
Ux
Ux
Ux
yu
yu
XC
Bt
Bt
Bt
"}
(20,1,1) = {"
XC
XC
yu
Ux
yu
eJ
Ux
Ux
Ux
Ux
SN
Ux
Ux
Ux
Ux
qA
Ux
NA
Yu
Ux
Ux
Ux
eJ
Ux
yu
Ux
Ux
Ux
yu
XC
Bt
Bt
Bt
"}
(21,1,1) = {"
XC
yu
Ux
Ux
Ux
Ux
Ux
Rj
Ux
Bh
jJ
XM
xX
Ux
jJ
MZ
fB
Ux
Yu
Ux
xX
Ux
Ux
eJ
Ux
Ux
eJ
xX
yu
XC
XC
XC
XC
"}
(22,1,1) = {"
XC
yu
Ux
Lv
Ux
eJ
FO
Bh
Bh
lP
jJ
Ux
Ux
ze
FU
Ux
sB
Gs
jJ
Ux
Ux
Ux
yu
Ux
Ux
Ux
Ux
Ux
yu
XC
XC
XC
XC
"}
(23,1,1) = {"
XC
yu
Ux
Ux
eJ
jJ
jJ
Ux
jJ
jJ
jJ
FU
Ux
Ux
jJ
jJ
jJ
Ux
jJ
jJ
Ux
ze
Ux
Ux
xX
Ux
Ux
Ux
yu
yu
XC
XC
XC
"}
(24,1,1) = {"
XC
yu
Ux
Ux
Ux
Yu
Ux
Ux
Ux
Ux
Ux
Ux
Ux
XM
Ux
Ux
Ux
Ux
xX
Ux
Ux
Ux
Ux
Ux
Ux
Ux
Ux
Ux
Ux
yu
XC
XC
XC
"}
(25,1,1) = {"
XC
yu
eJ
Ux
eJ
Ux
Ux
xX
Ux
Ux
XM
Ux
eJ
Ux
Ux
Ux
XM
Ux
Ux
SN
eJ
Ux
Ux
Ux
Ux
Ux
eJ
Ux
Ux
yu
yu
XC
XC
"}
(26,1,1) = {"
XC
yu
xX
Ux
gv
Yu
XM
Ux
ze
Ux
Ux
Ux
Ux
xX
Ux
Ux
Ux
Ux
yu
yu
yu
Ux
xX
Ux
Ux
Ux
Ux
Ux
Ux
yu
yu
XC
XC
"}
(27,1,1) = {"
XC
yu
Ux
Ux
Ux
jJ
jJ
Ux
jJ
jJ
jJ
Ux
ze
Ux
jJ
jJ
jJ
Ux
jJ
jJ
yu
ze
Ux
Ux
Ux
xX
eJ
Ux
Ux
yu
XC
XC
XC
"}
(28,1,1) = {"
XC
yu
Ux
yu
Ux
Ux
jJ
Xp
LU
CO
jJ
Ux
Ux
SN
jJ
Ux
ze
Ux
jJ
FU
yu
Ux
Ux
Ux
Ux
Ux
Ux
Ux
yu
yu
XC
XC
XC
"}
(29,1,1) = {"
XC
yu
Ux
Ux
Ux
Ux
Yu
MZ
xX
Ux
jJ
XM
xX
Ux
jJ
Ux
LU
CO
Ux
Ux
xX
Ux
Ux
Ux
yu
yu
Ux
Ux
yu
XC
XC
XC
XC
"}
(30,1,1) = {"
XC
yu
xX
ze
yu
Ux
Yu
Ux
Gs
Ux
dg
Ux
Ux
Ux
Ux
ID
Kp
Gs
Ux
Ux
Ux
Ux
Ux
yu
yu
Ux
xX
Ux
yu
XC
XC
XC
XC
"}
(31,1,1) = {"
XC
yu
Ux
Ux
yu
Ux
jJ
Yu
Yu
Ux
jJ
XM
Ux
XM
jJ
Yu
Ux
Yu
jJ
Ii
Ux
Ux
Ux
Ux
Ux
Ux
Ux
Ux
yu
XC
XC
XC
XC
"}
(32,1,1) = {"
XC
yu
Ux
Ux
Ux
Ux
Ux
Ux
Ux
Ux
jJ
Ux
Ux
Yu
jJ
yu
Ux
Ux
Ii
Ux
Ux
Ux
Ux
Ux
Ux
Ux
Ux
yu
yu
XC
XC
XC
XC
"}
(33,1,1) = {"
XC
yu
Ux
Ux
Ux
ze
Ux
Ux
Ux
Ux
yu
Ux
xX
yu
yu
yu
Ux
Ux
Ux
Ux
Ux
Ux
Yu
Ux
Ux
Ux
eJ
yu
XC
XC
XC
XC
XC
"}
(34,1,1) = {"
XC
yu
xX
Ux
yu
Ux
qK
Ux
SN
Ux
Ux
eJ
SN
Ux
Ux
Ux
Ux
xX
Ux
Ux
Ux
Ux
jJ
Ux
Ux
Vc
Ux
yu
XC
Bt
Bt
XC
XC
"}
(35,1,1) = {"
XC
yu
Ux
Ux
Ux
Ux
Ux
Ux
Ux
Ux
Ux
xX
eJ
Ux
Ux
Ux
Ux
ze
Ux
Ux
Ux
Ux
Ux
Ux
xX
Ux
Ux
yu
XC
Bt
Bt
XC
XC
"}
(36,1,1) = {"
XC
yu
xX
Ux
Ux
Ux
Ux
yu
Ux
Ux
Ux
Ux
Ux
yu
jJ
Ux
Ux
Ux
Ux
jJ
jJ
jJ
jJ
Ux
Ux
Ux
Ux
yu
XC
Bt
Bt
XC
XC
"}
(37,1,1) = {"
XC
yu
Ux
Ux
Ux
Ux
Ux
Ux
Ux
Ux
Ux
Ux
Ux
yu
jJ
Ux
Ux
Ux
Ux
Ux
Ux
Ux
Ux
Ux
Ux
Ux
Ux
yu
XC
Bt
Bt
XC
XC
"}
(38,1,1) = {"
XC
yu
Ux
yu
yu
Ux
xX
Yu
jJ
jJ
jJ
Ux
Ux
Ux
Ux
Ux
Ux
Ux
Ux
Ux
Ux
Ux
yu
yu
xX
Ux
Ux
yu
XC
Bt
Bt
XC
Bt
"}
(39,1,1) = {"
XC
yu
xX
yu
yu
Ux
eJ
Ux
Ux
Ux
jJ
eJ
xX
Ux
Ux
Ux
xX
Ux
gG
Ux
Ux
Ux
Ux
Ux
Ux
Ux
eJ
yu
XC
Bt
Bt
XC
Bt
"}
(40,1,1) = {"
XC
yu
eJ
Ux
Ux
eJ
Ux
Ux
Ux
Ux
jJ
Ux
Ux
Ux
Ux
Ux
Ux
Ux
Ux
Ux
Ii
Ux
Ux
Ux
Ux
Ux
Ux
yu
XC
XC
XC
XC
Bt
"}
(41,1,1) = {"
XC
yu
yu
Ux
Ux
Ux
Ux
Ux
yu
Ux
Ux
Ux
Ux
Ux
Ux
Ux
jJ
Mo
Ux
Ux
jJ
Ux
Ux
Ux
Ux
Ux
Ux
yu
yu
XC
XC
XC
XC
"}
(42,1,1) = {"
XC
XC
yu
yu
Ux
Ux
qK
Ux
Ux
Ux
xX
Ux
jJ
Yu
Yu
Yu
jJ
yu
Ux
Ux
jJ
Yu
Yu
yu
jJ
Ux
Ux
ze
yu
XC
XC
XC
XC
"}
(43,1,1) = {"
XC
XC
XC
yu
Ux
Ux
ze
Ux
Ux
SN
Ux
Ux
Yu
yu
yu
yu
yu
yu
Ux
OR
Ux
Ux
Ux
Ux
Yu
yu
ze
Ux
yu
yu
XC
yu
yu
"}
(44,1,1) = {"
XC
XC
XC
yu
Ux
Ux
Ux
Ux
Ux
Ux
Ux
Ux
Yu
yu
Ux
Ux
Ux
Ux
Ux
Ux
Ux
DQ
Ux
Py
Yu
yu
Ux
Ux
Ux
yu
yu
yu
Ux
"}
(45,1,1) = {"
XC
XC
XC
yu
yu
Ux
Ux
Ux
Ux
Ux
Ux
Ux
jJ
yu
Ux
PF
XM
Ux
Ux
dg
gx
Ux
Ux
nQ
jJ
yu
Ux
Ux
Ux
xX
Ux
Ux
Ux
"}
(46,1,1) = {"
XC
XC
XC
XC
yu
Ii
xX
Ux
Ux
xX
Ux
jJ
jJ
yu
dg
dg
Ux
XM
Eb
Ux
ze
Ux
XM
Ux
jJ
jJ
Ux
XM
Ux
CL
Ux
Ux
Ux
"}
(47,1,1) = {"
XC
XC
XC
XC
yu
Ii
Ux
Ux
SN
Ux
Ux
jJ
Ux
dg
Ux
xX
dg
Eb
dg
dg
gq
Ux
Ux
dg
Ux
Yu
Ux
SN
Ux
Ux
Ux
Ux
Ux
"}
(48,1,1) = {"
XC
XC
XC
XC
yu
Ux
eJ
Ux
Ux
Ux
Ux
SN
Ux
NZ
gx
ze
dg
WV
gj
Ux
Ux
dg
cQ
cQ
cQ
eJ
Ux
Ux
Ux
Ux
Ux
Ux
Ux
"}
(49,1,1) = {"
XC
XC
XC
XC
yu
yu
Ux
jJ
jJ
Ux
Ux
jJ
Ux
Ux
Ux
tk
Ux
Ux
Ux
tK
Ux
dg
dg
xX
Ux
Yu
eJ
Ux
xX
Ux
Ux
Ux
eJ
"}
(50,1,1) = {"
XC
XC
XC
XC
XC
yu
xX
Ux
Ux
Ux
Ux
jJ
jJ
Ux
LS
jJ
jJ
gZ
SN
Ux
SN
Ux
Ux
Oq
jJ
jJ
Ux
Ux
yu
yu
Ux
qK
Ux
"}
(51,1,1) = {"
XC
XC
XC
XC
XC
yu
eJ
Ux
Ux
Ux
Ux
Ux
jJ
Ux
cr
hL
jJ
XM
Ux
SN
Ux
Ux
gx
zj
jJ
yu
Ux
Ux
yu
yu
Ux
Ux
Ux
"}
(52,1,1) = {"
XC
XC
XC
XC
XC
yu
Ux
Ux
Ux
Ux
Ux
Ux
OE
Ux
cu
Rk
jJ
SN
ze
Ux
XM
dg
dg
Ux
Yu
Ux
Ux
Ux
Ux
Ux
Ux
Ux
XC
"}
(53,1,1) = {"
XC
XC
XC
XC
XC
yu
Ux
gv
Ux
Ux
Ux
Ux
Yu
Ux
Ux
Ux
Ux
Ux
Ux
tK
Ux
Ux
Ux
Ux
ze
Ux
Ux
xX
Ux
Ux
Ux
Ux
XC
"}
(54,1,1) = {"
XC
XC
XC
XC
XC
yu
xX
Ux
Ux
Ux
Ux
Ux
jJ
Yu
Yu
Yu
jJ
Ux
Ux
Ux
jJ
Yu
Yu
Yu
jJ
Ux
Ux
SN
Ux
Ux
xX
Ux
XC
"}
(55,1,1) = {"
XC
XC
XC
XC
XC
yu
Ux
Ux
Ux
xX
Ux
SN
Ux
Ux
Ux
Ux
jJ
Yu
Ux
Yu
jJ
Ux
Ux
Ux
Ux
Ux
Ux
Ux
Ux
Ux
Ux
Ux
XC
"}
(56,1,1) = {"
XC
XC
XC
XC
XC
yu
Ux
Ux
yu
yu
Ux
Ux
xX
Ux
Ux
Ux
Ux
Ux
Ux
Ux
Ux
Ux
Ux
Ux
Ux
Ux
eJ
Ux
Ux
Ux
Ux
eJ
XC
"}
(57,1,1) = {"
XC
XC
XC
XC
XC
yu
Ux
Ux
yu
yu
Ux
eJ
Ux
Ux
Ux
Ux
eJ
Ux
eJ
Ux
Ux
Ux
SN
Ux
Ux
eJ
Ux
yu
Ux
Ux
Ux
Ux
XC
"}
(58,1,1) = {"
XC
XC
XC
XC
XC
yu
eJ
xX
Ux
Ux
eJ
Ux
Ux
Ux
Ux
Ux
Ux
Ux
xX
Ux
Ux
yu
yu
yu
Ux
Ux
Ux
Ux
Ux
yu
yu
XC
XC
"}
(59,1,1) = {"
XC
XC
XC
XC
XC
XC
Ux
Ux
Ux
xX
Ux
Ux
Ux
yu
yu
Ux
Ux
Ux
Ux
SN
Ux
Ux
Ux
yu
Ux
Ux
Ux
Ux
yu
yu
XC
XC
XC
"}
(60,1,1) = {"
XC
XC
XC
XC
XC
XC
Ux
Ux
Ux
Ux
Ux
Ux
Ux
yu
yu
Ux
Ux
Ux
Ux
Ux
Ux
xX
Ux
Ux
Ux
Ux
Ux
Kf
yu
XC
XC
XC
XC
"}
(61,1,1) = {"
XC
XC
XC
XC
XC
XC
Ux
Ux
Ux
Ux
Ux
Ux
Ux
xX
Ux
Ux
Ux
xX
yu
yu
Ux
Ux
Ux
Ux
Ux
Ux
yu
yu
XC
XC
XC
XC
XC
"}
(62,1,1) = {"
XC
XC
XC
XC
XC
XC
XC
Ux
Ux
Ux
CL
Ux
Ux
Ux
Ux
Ux
Ux
Ux
yu
yu
Ux
Ux
Ux
Vc
Ux
Ux
yu
XC
XC
XC
XC
XC
XC
"}
(63,1,1) = {"
XC
XC
XC
XC
XC
XC
XC
Ux
Ux
Ux
yu
Ux
Ux
Ux
gv
Ux
Ux
Ux
Ux
Ux
Ux
Ux
Ux
Ux
Ux
Ux
XC
XC
XC
XC
XC
XC
XC
"}
(64,1,1) = {"
XC
XC
XC
XC
XC
XC
XC
XC
Ux
Ux
xX
Ux
Ux
eJ
Ux
Ux
eJ
Ux
Ux
Ux
Ux
eJ
Ux
jJ
Ux
eJ
XC
XC
XC
XC
XC
XC
XC
"}
(65,1,1) = {"
XC
XC
XC
XC
XC
XC
XC
XC
Ux
Ux
Ux
Ux
Ux
Ux
Ux
Ux
XC
XC
Ux
Ux
xX
Ux
Ux
jJ
xX
Ux
XC
XC
XC
XC
XC
XC
XC
"}
(66,1,1) = {"
XC
XC
XC
XC
XC
XC
XC
XC
XC
Ux
Ux
Ux
Ux
xX
Ux
XC
XC
XC
XC
Ux
Ux
Ux
Ux
Ux
Ux
Ux
XC
XC
Bt
Bt
Bt
Bt
XC
"}
(67,1,1) = {"
XC
XC
XC
XC
XC
XC
XC
XC
XC
Ux
Ux
Ux
Ux
Ux
Ux
XC
XC
XC
XC
yu
yu
Ux
Ux
Ux
Ux
Ux
XC
XC
Bt
Bt
Bt
Bt
XC
"}
(68,1,1) = {"
XC
XC
XC
XC
XC
XC
XC
XC
XC
Ux
Ux
xX
Ux
Ux
XC
XC
XC
XC
XC
XC
yu
Ux
Ux
Ux
Ux
Ux
XC
XC
Bt
Bt
Bt
Bt
XC
"}
(69,1,1) = {"
XC
XC
XC
XC
XC
XC
XC
XC
XC
XC
Ux
Ux
Ux
Ux
XC
XC
XC
XC
XC
XC
yu
Ux
Ux
xX
Ux
Ux
XC
XC
XC
XC
XC
XC
XC
"}
(70,1,1) = {"
XC
XC
XC
XC
XC
XC
XC
XC
XC
XC
Ux
Ux
Ux
Ux
XC
XC
XC
XC
XC
XC
XC
Ux
Ux
Ux
Ux
Ux
XC
XC
Bt
Bt
Bt
Bt
XC
"}
(71,1,1) = {"
Bt
Bt
Bt
Bt
XC
Bt
Bt
Bt
Bt
XC
Ux
Ux
Ux
Ux
Ux
XC
XC
XC
XC
XC
XC
Ux
Ux
Ux
Ux
Ux
XC
XC
Bt
Bt
Bt
Bt
XC
"}
(72,1,1) = {"
Bt
Bt
Bt
Bt
XC
Bt
Bt
Bt
Bt
XC
JT
UV
JT
JT
JT
XC
XC
XC
XC
XC
XC
nT
JT
UV
JT
JT
XC
XC
Bt
Bt
Bt
Bt
XC
"}
(73,1,1) = {"
Bt
Bt
Bt
Bt
XC
Bt
Bt
Bt
Bt
XC
vo
vo
vo
gI
vo
XC
XC
XC
XC
XC
gI
vo
vo
vo
vo
gI
XC
XC
XC
XC
XC
XC
XC
"}
(74,1,1) = {"
Bt
Bt
Bt
Bt
XC
Bt
Bt
Bt
Bt
XC
qW
vo
gM
vo
qW
XC
XC
XC
XC
XC
vo
vo
vo
XC
XC
XC
XC
JW
mj
dX
US
Cf
mj
"}
(75,1,1) = {"
XC
XC
XC
XC
XC
XC
XC
XC
XC
XC
qW
vo
qe
vo
qW
XC
XC
XC
XC
vo
vo
vo
vo
vo
XC
XC
XC
yQ
yv
ty
yD
Eg
yv
"}
(76,1,1) = {"
Bt
Bt
Bt
Bt
XC
Bt
Bt
Bt
Bt
XC
qW
vo
vo
vo
qW
qW
XC
XC
vo
vo
vo
qe
vo
vo
XC
XC
XC
yQ
yv
jw
AO
km
bk
"}
(77,1,1) = {"
Bt
Bt
Bt
Bt
XC
Bt
Bt
Bt
Bt
XC
qW
qW
vo
vo
vo
qW
XC
vo
vo
vo
vo
vo
vo
XC
XC
XC
XC
yQ
yv
Uf
bF
rO
bk
"}
(78,1,1) = {"
Bt
Bt
Bt
Bt
XC
Bt
Bt
Bt
Bt
XC
XC
qW
qW
vo
vo
vo
vo
vo
vo
qe
vo
vo
XC
XC
XC
XC
XC
yQ
yv
XP
yD
AR
bk
"}
(79,1,1) = {"
XC
XC
XC
XC
XC
XC
XC
XC
XC
XC
XC
XC
qW
gI
vo
vo
qe
vo
vo
vo
vo
vo
XC
XC
XC
XC
XC
yQ
yv
GX
Xi
GX
bk
"}
(80,1,1) = {"
Bt
Bt
Bt
Bt
XC
Bt
Bt
Bt
Bt
XC
XC
XC
XC
vo
gI
vo
vo
vo
vo
vo
vo
vo
JT
vo
XC
XC
XC
yQ
uN
co
co
co
co
"}
