//MAP CONVERTED BY dmm2tgm.py THIS HEADER COMMENT PREVENTS RECONVERSION, DO NOT REMOVE
"aa" = (
/turf/open/floor/plating/ground/dirt,
/area/lv624/ground/caves/central3)
"ab" = (
/obj/structure/rack,
/obj/item/stack/sheet/mineral/diamond{
	amount = 2
	},
/turf/open/floor/tile/vault{
	dir = 8
	},
/area/lv624/ground/caves/central1)
"ac" = (
/obj/effect/landmark/xeno_resin_wall,
/turf/open/floor/plating/ground/dirt,
/area/lv624/ground/caves/central2)
"ad" = (
/obj/effect/landmark/weed_node,
/turf/open/floor/plating/ground/dirt,
/area/lv624/ground/caves/central2)
"ae" = (
/obj/effect/landmark/lv624/fog_blocker/xeno_spawn,
/turf/open/floor/plating/ground/dirt,
/area/lv624/ground/caves/central2)
"af" = (
/turf/open/floor/plating/ground/dirt,
/area/lv624/ground/caves/central2)
"ag" = (
/obj/structure/rack,
/turf/open/floor/tile/vault{
	dir = 8
	},
/area/lv624/ground/caves/central1)
"ah" = (
/obj/effect/landmark/lv624/fog_blocker,
/obj/effect/landmark/lv624/fog_blocker/xeno_spawn,
/turf/closed/mineral,
/area/lv624/ground/caves/rock)
"ai" = (
/turf/closed/mineral,
/area/lv624/ground/caves/rock)
"aj" = (
/obj/machinery/door/airlock/mainship/secure/locked/free_access{
	dir = 4;
	name = "\improper Mining Storage"
	},
/turf/open/floor/tile/dark,
/area/lv624/ground/caves/central1)
"ak" = (
/obj/structure/rack,
/obj/item/stack/sheet/metal{
	amount = 50;
	pixel_x = 4;
	pixel_y = 4
	},
/obj/item/stack/sheet/metal{
	amount = 30
	},
/turf/open/floor/tile/vault{
	dir = 8
	},
/area/lv624/ground/caves/central1)
"al" = (
/obj/structure/rack,
/obj/effect/landmark/lv624/fog_blocker/xeno_spawn,
/turf/open/floor/tile/vault{
	dir = 8
	},
/area/lv624/ground/caves/central1)
"am" = (
/obj/effect/landmark/xeno_resin_door,
/turf/open/floor/plating/ground/dirt,
/area/lv624/ground/caves/central3)
"an" = (
/turf/closed/wall,
/area/lv624/ground/caves/central1)
"ao" = (
/obj/structure/rack,
/obj/item/stack/sheet/mineral/iron{
	amount = 5
	},
/obj/item/stack/sheet/mineral/platinum,
/obj/machinery/light{
	dir = 8
	},
/obj/effect/landmark/lv624/fog_blocker/xeno_spawn,
/turf/open/floor/tile/vault{
	dir = 8
	},
/area/lv624/ground/caves/central1)
"ap" = (
/obj/effect/landmark/xeno_resin_door,
/turf/open/floor/plating/ground/dirt,
/area/lv624/ground/caves/central1)
"aq" = (
/turf/closed/wall/r_wall,
/area/lv624/ground/caves/rock)
"ar" = (
/turf/open/floor/plating/ground/dirt,
/area/lv624/ground/caves/central1)
"as" = (
/turf/closed/wall/r_wall,
/area/lv624/ground/caves/central1)
"at" = (
/obj/effect/ai_node,
/turf/open/floor/plating/ground/dirt,
/area/lv624/ground/caves/central2)
"au" = (
/obj/effect/landmark/lv624/fog_blocker/xeno_spawn,
/turf/open/floor/plating/ground/dirt,
/area/lv624/ground/caves/central2)
"av" = (
/obj/structure/rack,
/obj/item/tool/pickaxe,
/turf/open/floor/tile/vault{
	dir = 8
	},
/area/lv624/ground/caves/central1)
"aw" = (
/obj/effect/landmark/weed_node,
/obj/effect/ai_node,
/turf/open/floor/plating/ground/dirt,
/area/lv624/ground/caves/central2)
"ax" = (
/obj/structure/rack,
/obj/item/stack/sheet/mineral/gold{
	amount = 2
	},
/obj/item/stack/sheet/mineral/platinum{
	pixel_x = -6
	},
/turf/open/floor/tile/vault{
	dir = 8
	},
/area/lv624/ground/caves/central1)
"ay" = (
/obj/effect/landmark/lv624/fog_blocker/xeno_spawn,
/obj/effect/landmark/xeno_resin_wall,
/turf/open/floor/plating/ground/dirt,
/area/lv624/ground/caves/central2)
"az" = (
/obj/structure/rack,
/obj/item/stack/sheet/mineral/silver{
	amount = 20
	},
/turf/open/floor/tile/vault{
	dir = 8
	},
/area/lv624/ground/caves/central1)
"aA" = (
/obj/effect/landmark/lv624/fog_blocker/xeno_spawn,
/turf/closed/mineral,
/area/lv624/ground/caves/rock)
"aB" = (
/obj/effect/landmark/weed_node,
/obj/effect/landmark/xeno_silo_spawn,
/turf/open/floor/plating/ground/dirt,
/area/lv624/ground/caves/central2)
"aC" = (
/turf/closed/mineral/smooth,
/area/lv624/ground/caves/rock)
"aD" = (
/obj/effect/landmark/excavation_site_spawner,
/turf/open/floor/plating/ground/dirt,
/area/lv624/ground/caves/central1)
"aE" = (
/obj/effect/landmark/lv624/fog_blocker/xeno_spawn,
/obj/effect/landmark/weed_node,
/turf/open/floor/plating/ground/dirt,
/area/lv624/ground/caves/central2)
"aF" = (
/obj/effect/landmark/lv624/fog_blocker/xeno_spawn,
/obj/effect/landmark/xeno_resin_wall,
/turf/open/floor/plating/ground/dirt,
/area/lv624/ground/caves/central2)
"aG" = (
/obj/structure/flora/ausbushes/fullgrass,
/turf/open/floor/plating/ground/dirt,
/area/lv624/ground/caves/central2)
"aH" = (
/obj/machinery/miner/damaged/platinum,
/turf/open/floor/plating/ground/dirt,
/area/lv624/ground/caves/central2)
"aI" = (
/turf/open/floor,
/area/lv624/ground/caves/central1)
"aJ" = (
/obj/effect/ai_node,
/turf/open/floor/plating/ground/dirt,
/area/lv624/ground/caves/central1)
"aK" = (
/turf/closed/mineral/indestructible,
/area/lv624/ground/caves/rock)
"aL" = (
/obj/effect/landmark/lv624/fog_blocker/xeno_spawn,
/turf/closed/wall/r_wall,
/area/lv624/ground/caves/rock)
"aM" = (
/turf/closed/mineral/smooth/indestructible,
/area/lv624/ground/caves/rock)
"aN" = (
/obj/effect/landmark/weed_node,
/obj/effect/ai_node,
/turf/open/floor/plating/ground/dirt,
/area/lv624/ground/caves/central1)
"aO" = (
/obj/effect/landmark/lv624/fog_blocker/xeno_spawn,
/obj/effect/landmark/weed_node,
/turf/open/floor/plating/ground/dirt,
/area/lv624/ground/caves/central2)
"aP" = (
/obj/structure/rack,
/obj/item/tool/shovel,
/turf/open/floor/tile/vault{
	dir = 8
	},
/area/lv624/ground/caves/central1)
"aQ" = (
/obj/effect/landmark/lv624/fog_blocker,
/turf/closed/mineral,
/area/lv624/ground/caves/rock)
"aR" = (
/obj/structure/rack,
/obj/item/stack/sheet/mineral/tritium{
	pixel_x = -4
	},
/turf/open/floor/tile/vault{
	dir = 8
	},
/area/lv624/ground/caves/central1)
"aS" = (
/obj/effect/landmark/xeno_resin_wall,
/turf/open/floor/plating/ground/dirt,
/area/lv624/ground/caves/central1)
"aT" = (
/obj/effect/landmark/excavation_site_spawner,
/turf/open/floor/plating/ground/dirt,
/area/lv624/ground/caves/central2)
"aU" = (
/obj/effect/landmark/lv624/fog_blocker/xeno_spawn,
/turf/closed/mineral/smooth,
/area/lv624/ground/caves/rock)
"aV" = (
/turf/open/floor/tile/dark,
/area/lv624/ground/caves/central1)
"aW" = (
/obj/effect/landmark/weed_node,
/turf/open/floor/plating/ground/dirt,
/area/lv624/ground/caves/central1)
"aX" = (
/obj/structure/rack,
/obj/item/tool/shovel,
/obj/effect/landmark/lv624/fog_blocker/xeno_spawn,
/turf/open/floor/tile/vault{
	dir = 8
	},
/area/lv624/ground/caves/central1)
"aY" = (
/turf/closed/mineral,
/area/lv624/ground/caves/central2)
"aZ" = (
/obj/effect/landmark/xeno_resin_door,
/turf/open/floor/plating/ground/dirt,
/area/lv624/ground/caves/central2)
"bq" = (
/obj/effect/landmark/lv624/fog_blocker,
/turf/closed/mineral/smooth,
/area/lv624/ground/caves/rock)
"dl" = (
/obj/effect/landmark/lv624/fog_blocker,
/obj/effect/landmark/lv624/fog_blocker/xeno_spawn,
/turf/closed/mineral/smooth,
/area/lv624/ground/caves/rock)
"dJ" = (
/obj/effect/landmark/weed_node,
/obj/effect/ai_node,
/turf/open/floor/plating/ground/dirt,
/area/lv624/ground/caves/central2)
"eP" = (
/obj/effect/landmark/weed_node,
/obj/effect/ai_node,
/turf/open/floor/plating/ground/dirt,
/area/lv624/ground/caves/central1)
"jE" = (
/obj/effect/landmark/xeno_resin_door,
/turf/open/floor/plating/ground/dirt,
/area/lv624/ground/caves/central3)
"mn" = (
/obj/effect/landmark/weed_node,
/turf/open/floor/plating/ground/dirt,
/area/lv624/ground/caves/central1)
"mY" = (
/obj/structure/rack,
/obj/item/tool/shovel,
/obj/effect/landmark/lv624/fog_blocker/xeno_spawn,
/turf/open/floor/tile/vault{
	dir = 8
	},
/area/lv624/ground/caves/central1)
"or" = (
/obj/effect/landmark/xeno_resin_wall,
/turf/open/floor/plating/ground/dirt,
/area/lv624/ground/caves/central2)
"tq" = (
/turf/closed/mineral/smooth,
/area/lv624/ground/caves/central2)
"uy" = (
/obj/effect/landmark/xeno_resin_wall,
/turf/open/floor/plating/ground/dirt,
/area/lv624/ground/caves/central1)
"xy" = (
/obj/structure/rack,
/obj/item/stack/sheet/mineral/iron{
	amount = 5
	},
/obj/item/stack/sheet/mineral/platinum,
/obj/machinery/light{
	dir = 8
	},
/obj/effect/landmark/lv624/fog_blocker/xeno_spawn,
/turf/open/floor/tile/vault{
	dir = 8
	},
/area/lv624/ground/caves/central1)
"BS" = (
/obj/effect/landmark/xeno_resin_door,
/turf/open/floor/plating/ground/dirt,
/area/lv624/ground/caves/central2)
"NV" = (
/obj/effect/ai_node,
/turf/open/floor/plating/ground/dirt,
/area/lv624/ground/caves/central2)
"Pf" = (
/obj/structure/rack,
/obj/effect/landmark/lv624/fog_blocker/xeno_spawn,
/turf/open/floor/tile/vault{
	dir = 8
	},
/area/lv624/ground/caves/central1)
"PN" = (
/obj/effect/landmark/excavation_site_spawner,
/turf/open/floor/plating/ground/dirt,
/area/lv624/ground/caves/central2)
"PX" = (
/obj/effect/landmark/lv624/fog_blocker/xeno_spawn,
/turf/closed/wall/r_wall,
/area/lv624/ground/caves/rock)
"Rp" = (
/obj/effect/landmark/weed_node,
/turf/open/floor/plating/ground/dirt,
/area/lv624/ground/caves/central2)
"VY" = (
/obj/effect/landmark/excavation_site_spawner,
/turf/open/floor/plating/ground/dirt,
/area/lv624/ground/caves/central1)
"YC" = (
/obj/effect/landmark/weed_node,
/obj/effect/landmark/xeno_silo_spawn,
/turf/open/floor/plating/ground/dirt,
/area/lv624/ground/caves/central2)
"YR" = (
/obj/effect/ai_node,
/turf/open/floor/plating/ground/dirt,
/area/lv624/ground/caves/central1)
"ZQ" = (
/obj/effect/landmark/xeno_resin_door,
/turf/open/floor/plating/ground/dirt,
/area/lv624/ground/caves/central1)

(1,1,1) = {"
aC
aC
aC
aC
aC
aC
aC
aC
aC
aC
jE
jE
jE
jE
jE
aC
aC
aC
aC
aC
aC
aC
aC
aC
aC
aC
aC
aa
aa
aa
aa
aa
aa
"}
(2,1,1) = {"
aC
aC
aC
aC
aC
aC
aC
aC
aC
aC
af
NV
af
af
NV
aC
aC
aC
aC
aC
aC
aC
aC
aC
aC
aC
aC
aC
aC
aC
aC
aC
aa
"}
(3,1,1) = {"
aC
aC
aC
aC
aC
aC
aC
aC
aC
aC
NV
af
Rp
af
Rp
af
aC
aC
aC
aC
aC
aC
aC
aC
aC
aC
aC
aC
aC
aC
aC
aC
aC
"}
(4,1,1) = {"
aC
aC
aC
aC
aC
aC
aC
af
af
af
af
or
or
af
af
Rp
or
aC
aC
aC
aC
aC
aC
aC
aC
aC
aC
aC
aC
aC
aC
aC
aC
"}
(5,1,1) = {"
aC
aC
aC
aC
aC
aC
aC
Rp
or
or
NV
af
af
af
NV
af
or
aC
aC
aC
aC
aC
aC
aC
aC
aC
aC
aC
aC
aC
aC
aC
aC
"}
(6,1,1) = {"
aC
aC
aC
aC
aC
aC
af
af
or
or
af
Rp
af
or
af
af
or
aC
aC
aC
aC
aC
aC
aC
aC
aC
aC
aC
aC
aC
aC
aC
aC
"}
(7,1,1) = {"
aC
aC
aC
aC
aC
aC
Rp
af
af
af
af
aG
af
af
af
Rp
aC
aC
aC
aC
aC
aC
aC
aC
aC
aC
aC
aC
aC
aC
aC
aC
aC
"}
(8,1,1) = {"
aC
aC
aC
aC
aC
af
af
or
af
af
aH
af
af
Rp
af
aC
aC
aC
aC
aC
aC
aC
aC
aC
aC
aC
aC
aC
aC
aC
aC
aC
aC
"}
(9,1,1) = {"
aC
aC
aC
aC
aC
af
or
or
or
af
af
af
or
or
af
aC
aC
aC
aC
aC
aC
aC
aC
aC
aC
aC
aC
aC
aC
aC
aC
aC
aC
"}
(10,1,1) = {"
aC
aC
aC
aC
aC
af
af
or
af
PN
af
Rp
or
or
af
aC
aC
aC
aC
aC
aC
aC
aC
aC
aC
aC
aC
aC
aC
aC
aC
aC
aC
"}
(11,1,1) = {"
aC
aC
aC
aC
aC
af
NV
af
af
af
NV
af
af
af
NV
af
aC
aC
aC
aC
aC
aC
aC
aC
aC
aC
aC
aC
aC
aC
aC
aC
aC
"}
(12,1,1) = {"
aC
aC
aC
aC
aC
af
Rp
af
Rp
af
aC
aC
af
af
Rp
af
aC
aC
aC
aC
aC
aC
aC
aC
aC
aC
aC
aC
aC
aC
aC
aC
aC
"}
(13,1,1) = {"
aC
aC
aC
aC
aC
af
af
af
af
aC
aC
aC
aC
af
af
af
aC
aC
aC
aC
aC
aC
aC
aC
aC
aC
aC
aC
aC
aC
aC
aC
aC
"}
(14,1,1) = {"
aC
aC
aC
aC
or
BS
BS
BS
aC
aC
aC
aC
aC
BS
BS
BS
aC
aC
aC
aC
aC
aC
aC
aC
aC
aC
aC
aC
aC
aC
aC
aC
aC
"}
(15,1,1) = {"
aC
aC
aC
or
or
af
Rp
aC
aC
aC
aC
aC
aC
af
af
af
aC
aC
aC
aC
aC
aC
aC
aC
aC
aC
aC
aC
aC
aC
aC
aC
aC
"}
(16,1,1) = {"
aC
aC
aC
or
af
af
NV
aC
aC
aC
aC
aC
af
af
Rp
af
aC
aC
aC
aC
aC
aC
aC
aC
aC
aC
aC
aC
aC
aC
aC
aC
aC
"}
(17,1,1) = {"
aC
aC
aC
or
af
NV
aC
aC
aC
aC
NV
af
af
af
NV
af
aC
aC
aC
aC
aC
aC
aC
aC
aC
aC
aC
aC
aC
aC
aC
aC
aC
"}
(18,1,1) = {"
aC
aC
aC
or
af
af
aC
aC
aC
af
af
or
Rp
af
af
aC
aC
aC
aC
aC
aC
aC
aC
aC
aC
aC
aC
aC
aC
aC
aC
aM
aM
"}
(19,1,1) = {"
aC
aC
aC
or
af
dJ
af
NV
af
af
NV
or
af
af
aC
aC
aC
aC
aC
aC
aC
aC
aC
aC
aC
aC
aC
aC
aC
aC
aC
aM
aM
"}
(20,1,1) = {"
aC
aC
or
or
af
af
af
Rp
af
af
Rp
af
af
aC
aC
aC
aC
aC
aC
aC
aC
aC
aC
aC
aC
aC
aC
aC
aC
aC
aC
aM
aM
"}
(21,1,1) = {"
aC
aC
or
af
af
aH
af
af
or
or
af
af
aC
aC
aC
aC
aC
aC
aC
aC
aC
aC
aC
aC
aC
aC
aC
aC
aC
aC
aC
aC
aC
"}
(22,1,1) = {"
aC
tq
or
Rp
af
Rp
af
af
or
or
af
af
aC
aC
aC
aC
aC
aC
aC
aC
aC
aC
aC
aC
aC
aC
aC
aC
aC
aC
aC
aC
aC
"}
(23,1,1) = {"
aC
or
or
af
af
af
or
NV
af
af
NV
aC
aC
aC
aC
aC
aC
aC
aC
aC
aC
aC
aC
aC
aC
aC
aC
aC
aC
aC
aC
aC
aC
"}
(24,1,1) = {"
aC
or
af
af
af
af
or
af
Rp
af
aC
aC
aC
aC
aC
aC
aC
aC
aC
aC
aC
aC
aC
aC
aC
aC
aC
aC
aC
aC
aC
aC
aC
"}
(25,1,1) = {"
aC
or
af
Rp
or
af
or
af
af
af
aC
aC
aC
aC
aC
aC
aC
aC
aC
aC
aC
aC
aC
aC
aC
aC
aC
aC
aC
aC
aC
aC
aC
"}
(26,1,1) = {"
aC
or
NV
aG
af
NV
af
NV
af
aC
aC
aC
aC
aC
aC
aC
aC
aC
aC
aC
aC
aC
aC
aC
aC
aC
aC
aC
aC
aC
aC
aC
aC
"}
(27,1,1) = {"
aC
or
af
aG
Rp
af
af
Rp
af
aC
aC
aC
aC
aC
aC
aC
aC
aC
aC
aC
aC
aC
aC
aC
aC
aC
aC
aC
aC
aC
aC
aC
aC
"}
(28,1,1) = {"
aC
or
af
af
or
or
af
af
or
aC
aC
aC
aC
aC
aC
aC
aC
aC
aC
aC
aC
aC
aC
aC
aC
aC
aC
aC
aC
aC
aC
aC
aC
"}
(29,1,1) = {"
aC
or
af
af
or
or
af
Rp
or
aC
aC
aC
aC
aC
aC
aC
aC
aC
aC
aC
aC
aC
aC
aC
aC
aC
aC
aC
aC
aC
aC
aC
aC
"}
(30,1,1) = {"
aC
or
Rp
af
Rp
af
af
af
or
aC
aC
aC
aC
aC
aC
aC
aC
aC
aC
aC
aC
aC
aC
aC
aC
aC
aC
aC
aC
aC
aC
aC
aC
"}
(31,1,1) = {"
aC
or
af
af
PN
af
Rp
af
af
aC
aC
aC
aC
aC
aC
aC
aC
aC
aC
aC
aC
aC
aC
aC
aC
aC
aC
aC
aC
aC
aC
aC
aC
"}
(32,1,1) = {"
aC
or
af
or
af
or
or
af
NV
aC
aC
aC
aC
aC
aC
aC
aC
aC
aC
aC
aC
aC
aC
aC
aC
aC
aC
aC
aC
aC
aC
aC
aC
"}
(33,1,1) = {"
aC
or
af
or
af
af
af
NV
Rp
aC
aC
aC
aC
aC
aC
aC
aC
aC
aC
aC
aC
aC
aC
aC
aC
aC
aC
aC
aC
aC
aC
aC
aC
"}
(34,1,1) = {"
aC
or
dJ
af
af
Rp
NV
or
af
aC
aC
aC
aC
aC
aC
aC
aC
aC
aC
aC
aC
aC
aC
aC
aC
aC
aC
aC
aC
aC
aC
aC
aC
"}
(35,1,1) = {"
aC
or
af
af
or
af
af
af
af
aC
aC
aC
aC
aC
aC
aC
aC
aC
aC
aC
aC
aC
aC
aC
aC
aC
aC
aC
aC
aC
aC
aC
aC
"}
(36,1,1) = {"
aC
or
NV
af
dJ
af
or
or
Rp
aC
aC
aC
aC
aC
aC
aC
aC
aC
aC
aC
aC
aC
aC
aC
aC
aC
aC
aC
aC
aC
aC
aC
aC
"}
(37,1,1) = {"
aC
or
or
af
af
af
or
or
af
af
aC
aC
aC
aC
aC
aC
aC
aC
aC
aC
aC
aC
aC
aC
aC
aC
aC
aC
aC
aC
aC
aC
aC
"}
(38,1,1) = {"
aC
aC
or
af
af
af
af
af
af
Rp
aC
aC
aC
aC
aC
aC
aC
aC
aC
aC
aC
aC
aC
aC
aC
aC
aC
aC
aC
aC
aC
aC
aC
"}
(39,1,1) = {"
aC
aC
or
af
Rp
aH
af
Rp
aG
af
aC
aC
aC
aC
aC
aC
aC
aC
aC
aC
aC
aC
aC
aC
aC
aC
aC
aC
aC
aC
aC
aC
aC
"}
(40,1,1) = {"
aC
aC
or
or
NV
af
af
af
NV
af
af
aC
aC
aC
aC
aC
aC
aC
aC
aC
aC
aC
aC
aC
aC
aC
aC
aC
aC
aC
aC
aC
aC
"}
(41,1,1) = {"
aC
aC
aC
or
af
af
or
or
af
af
Rp
aC
aC
aC
aC
aC
aC
aC
aC
aC
aC
aC
aC
aC
aC
aC
aC
aC
aC
aC
aC
aC
aC
"}
(42,1,1) = {"
aC
aC
aC
or
Rp
af
or
or
af
or
af
aC
aC
aC
aC
aC
aC
aC
aC
aC
aC
aC
aC
aC
aU
aU
aU
aU
aU
aU
aU
aU
aU
"}
(43,1,1) = {"
aC
aC
aC
or
af
af
af
af
af
af
af
aC
aC
aC
aC
aC
aC
aC
aC
aC
aC
aC
aC
aC
aU
aC
aC
aC
aC
aC
aC
or
aF
"}
(44,1,1) = {"
aC
aC
aC
or
NV
af
or
Rp
af
af
Rp
aC
aC
aC
aC
aC
aC
aC
aC
aC
aC
aC
aC
aC
aU
aC
aC
aC
or
or
or
or
ae
"}
(45,1,1) = {"
aC
aC
aC
or
or
NV
af
af
NV
af
af
NV
aC
aC
aC
aC
aC
aC
aC
aC
aC
aC
aC
aC
aU
aC
aC
or
or
Rp
af
af
aE
"}
(46,1,1) = {"
aC
aC
aC
aC
or
Rp
Rp
af
or
or
Rp
af
aC
aC
aC
aC
aC
aC
aC
aC
aC
aC
aC
aC
aU
aC
aC
or
af
af
af
YC
ae
"}
(47,1,1) = {"
aC
aC
aC
aC
or
af
af
af
or
or
af
af
aC
aC
aC
aC
aC
aC
aC
aC
aC
aC
aC
aC
aU
aC
aC
or
Rp
af
af
af
ae
"}
(48,1,1) = {"
aC
aC
aC
aC
or
af
af
af
af
af
af
af
aC
aC
aC
aC
aC
aC
aC
aC
aC
aC
aC
aC
aU
aC
aC
or
or
af
af
af
aE
"}
(49,1,1) = {"
aC
aC
aC
aC
or
NV
Rp
af
af
Rp
af
dJ
af
aC
aC
aC
aC
aC
aC
aC
aC
aC
aC
aC
aU
aC
aC
aC
or
af
af
Rp
ae
"}
(50,1,1) = {"
aC
aC
aC
aC
aC
af
or
or
af
af
or
or
NV
aC
aC
aC
aC
aC
aC
aC
aC
aC
aC
aC
aU
aC
aC
aC
or
or
af
af
ae
"}
(51,1,1) = {"
aC
aC
aC
aC
aC
af
or
or
af
af
or
or
af
Rp
aC
aC
aC
aC
aC
aC
aC
aC
aC
aC
aU
aC
aC
aC
aC
or
or
or
aF
"}
(52,1,1) = {"
aC
aC
aC
aC
aC
af
NV
af
af
af
af
af
af
af
or
aC
aC
aC
aC
aC
aC
aC
aC
aC
aU
aU
aU
aU
aU
aU
aU
aU
aU
"}
(53,1,1) = {"
aC
aC
aC
aC
aC
NV
af
af
af
Rp
af
af
dJ
af
or
or
aC
aC
aC
aC
aC
aC
aC
aC
aC
aC
aC
aC
aC
aC
aC
aC
aC
"}
(54,1,1) = {"
aC
aC
aC
aC
aC
or
Rp
af
or
or
af
af
or
NV
af
or
aC
aC
aC
aC
aC
aC
aC
aC
aC
aC
aC
aC
aC
aC
aC
aC
aC
"}
(55,1,1) = {"
aC
aC
aC
aC
aC
or
af
af
or
or
af
af
af
af
af
or
or
aC
aC
aC
aC
aC
aC
aC
aC
aC
aC
aC
aC
aC
aC
aC
aC
"}
(56,1,1) = {"
aC
aC
aC
aC
aC
or
NV
af
af
af
af
af
af
NV
Rp
NV
or
or
aC
aC
aC
aC
aC
aC
aC
aC
aC
aC
aC
aC
aC
aC
aC
"}
(57,1,1) = {"
aC
aC
aC
aC
aC
or
af
Rp
af
aH
af
Rp
af
or
af
af
af
or
aC
aC
aC
aC
aC
aC
aC
aC
aC
aC
aC
aC
aC
aC
aC
"}
(58,1,1) = {"
aC
aC
aC
aC
aC
or
af
af
af
Rp
af
af
or
or
or
af
af
or
or
aC
aC
aC
aC
aC
aC
aC
aC
aC
aC
aC
aC
aC
aC
"}
(59,1,1) = {"
aC
aC
aC
aC
aC
aC
NV
aG
af
NV
af
af
af
or
af
af
Rp
af
af
aC
aC
aC
aC
aC
aC
aC
aC
aC
aC
aC
aC
aC
aC
"}
(60,1,1) = {"
aC
aC
aC
aC
aC
aC
Rp
af
or
or
NV
Rp
af
af
af
NV
af
af
Rp
NV
aC
aC
aC
aC
aC
aC
aC
aC
aC
aC
aC
aC
aC
"}
(61,1,1) = {"
aC
aC
aC
aC
aC
aC
af
af
or
or
af
af
af
af
Rp
af
or
or
af
af
af
aC
aC
aC
aC
aC
aC
aC
aC
aC
aC
aC
aC
"}
(62,1,1) = {"
aC
aC
aC
aC
aC
aC
aC
af
af
af
PN
af
or
af
af
af
or
or
af
Rp
af
af
aC
aC
aC
aC
aC
aC
aC
aC
aC
aC
aC
"}
(63,1,1) = {"
aC
aC
aC
aC
aC
aC
aC
af
Rp
af
af
af
or
af
af
af
Rp
af
af
af
Rp
af
af
aC
aC
aC
aC
aC
aC
aC
aC
aC
aC
"}
(64,1,1) = {"
aC
aC
aC
aC
aC
aC
aC
aC
af
af
Rp
af
af
Rp
af
af
NV
af
Rp
NV
af
aG
NV
Rp
aC
aC
aC
aC
aC
aC
aC
aC
aC
"}
(65,1,1) = {"
aC
aC
aC
aC
aC
aC
aC
aC
NV
af
NV
af
af
NV
aG
NV
aC
aC
af
af
or
or
af
af
af
aC
aC
aC
aC
aC
aC
aC
aC
"}
(66,1,1) = {"
aC
aC
aC
aC
aC
aC
aC
aC
aC
af
af
or
or
af
af
aC
aC
aC
aC
af
af
af
Rp
af
af
or
aC
aC
aM
aM
aM
aM
aC
"}
(67,1,1) = {"
aC
aC
aC
aC
aC
aC
aC
aC
aC
Rp
af
or
or
af
af
aC
aC
aC
aC
af
Rp
af
NV
Rp
af
or
aC
aC
aM
aM
aM
aM
aC
"}
(68,1,1) = {"
aC
aC
aC
aC
aC
aC
aC
aC
aC
af
af
af
af
af
aC
aC
aC
aC
aC
aC
af
NV
or
or
af
af
aC
aC
aM
aM
aM
aM
aC
"}
(69,1,1) = {"
aC
aC
aC
aC
aC
aC
aC
aC
aC
aC
af
af
af
Rp
aC
aC
aC
aC
aC
aC
af
af
or
or
af
Rp
aC
aC
aC
aC
aC
aC
aC
"}
(70,1,1) = {"
aC
aC
aC
aC
aC
aC
aC
aC
aC
aC
af
or
or
NV
aC
aC
aC
aC
aC
aC
aC
af
af
af
af
af
aC
aC
aM
aM
aM
aM
aC
"}
(71,1,1) = {"
aM
aM
aM
aM
aC
aM
aM
aM
aM
aC
NV
af
af
af
NV
aC
aC
aC
aC
aC
aC
NV
Rp
af
af
dJ
aC
aC
aM
aM
aM
aM
aC
"}
(72,1,1) = {"
aM
aM
aM
aM
aC
aM
aM
aM
aM
aC
ZQ
ZQ
ZQ
ZQ
ZQ
aC
aC
aC
aC
aC
aC
ZQ
ZQ
ZQ
ZQ
ZQ
aC
aC
aM
aM
aM
aM
aC
"}
(73,1,1) = {"
aM
aM
aM
aM
aC
aM
aM
aM
aM
aC
ar
mn
ar
ar
mn
aC
aC
aC
aC
aC
ar
ar
ar
ar
ar
ar
aC
aC
aC
aC
aC
aC
aC
"}
(74,1,1) = {"
aM
aM
aM
aM
aC
aM
aM
aM
aM
aC
ar
ar
VY
ar
ar
aC
aC
aC
aC
aC
ar
mn
ar
aC
aC
aC
aC
dl
PX
mY
xy
Pf
PX
"}
(75,1,1) = {"
aC
aC
aC
aC
aC
aC
aC
aC
aC
aC
ar
mn
ar
ar
mn
aC
aC
aC
aC
ar
ar
ar
ar
ar
aC
aC
aC
bq
aq
ax
aV
aR
aq
"}
(76,1,1) = {"
aM
aM
aM
aM
aC
aM
aM
aM
aM
aC
ar
ar
ar
ar
ar
ar
aC
aC
ar
ar
ar
ar
ar
mn
aC
aC
aC
bq
aq
ab
aV
az
as
"}
(77,1,1) = {"
aM
aM
aM
aM
aC
aM
aM
aM
aM
aC
ar
ar
uy
uy
ar
ar
aC
YR
ar
ar
mn
YR
ar
aC
aC
aC
aC
bq
aq
ak
aV
ag
as
"}
(78,1,1) = {"
aM
aM
aM
aM
aC
aM
aM
aM
aM
aC
aC
ar
ar
ar
ar
ar
ar
ar
ar
uy
uy
ar
aC
aC
aC
aC
aC
bq
aq
aP
aV
av
as
"}
(79,1,1) = {"
aC
aC
aC
aC
aC
aC
aC
aC
aC
aC
aC
aC
ar
mn
YR
mn
ar
eP
ar
uy
uy
ar
aC
aC
aC
aC
aC
bq
aq
an
aj
an
as
"}
(80,1,1) = {"
aM
aM
aM
aM
aC
aM
aM
aM
aM
aC
aC
aC
aC
ar
ar
ar
ar
ar
ar
mn
ar
ar
ZQ
ar
aC
aC
aC
bq
aC
aI
aI
aI
aI
"}
