//MAP CONVERTED BY dmm2tgm.py THIS HEADER COMMENT PREVENTS RECONVERSION, DO NOT REMOVE
"bs" = (
/obj/structure/flora/jungle/vines/heavy,
/turf/open/floor/plating/ground/dirtgrassborder/corner{
	dir = 4
	},
/area/lv624/ground/jungle8)
"cm" = (
/obj/structure/sign/securearea,
/turf/open/floor/plating/ground/dirt,
/area/lv624/ground/sand9)
"dv" = (
/obj/effect/ai_node,
/turf/open/floor/plating/ground/dirt,
/area/lv624/lazarus/sandtemple/garbledradio)
"ee" = (
/obj/effect/turf_decal/sandytile,
/obj/structure/flora/jungle/vines,
/turf/open/floor/tile/whiteyellow/full,
/area/lv624/lazarus/sandtemple/garbledradio)
"er" = (
/obj/structure/stairs/seamless{
	dir = 4
	},
/turf/open/floor/plating/ground/dirt,
/area/lv624/lazarus/sandtemple/garbledradio)
"eP" = (
/obj/structure/flora/grass/brown,
/turf/open/liquid/water/river/autosmooth,
/area/lv624/ground/river3)
"fB" = (
/obj/structure/fence,
/obj/structure/sign/securearea,
/turf/open/floor/plating/ground/dirt,
/area/lv624/ground/sand9)
"gQ" = (
/obj/structure/fence,
/turf/open/floor/plating/ground/dirt,
/area/lv624/ground/sand9)
"hE" = (
/obj/effect/turf_decal/warning_stripes/thin{
	dir = 1
	},
/obj/effect/ai_node,
/turf/open/floor,
/area/lv624/ground/sand9)
"hG" = (
/obj/structure/stairs/seamless{
	dir = 8
	},
/turf/open/floor/plating/ground/dirt,
/area/lv624/lazarus/sandtemple/garbledradio)
"iX" = (
/obj/effect/turf_decal/sandytile,
/obj/effect/turf_decal/sandytile,
/turf/open/floor/tile/whiteyellow/full,
/area/lv624/lazarus/sandtemple/garbledradio)
"jh" = (
/obj/structure/flora/jungle/vines/heavy,
/turf/open/ground/grass,
/area/lv624/ground/jungle8)
"jq" = (
/turf/closed/wall/r_wall/chigusa,
/area/lv624/ground/sand3)
"km" = (
/turf/open/floor/plating/ground/dirtgrassborder/corner{
	dir = 4
	},
/area/lv624/ground/jungle8)
"kp" = (
/obj/structure/flora/ausbushes/reedbush,
/turf/open/floor/plating/ground/dirt,
/area/lv624/ground/river3)
"kv" = (
/obj/structure/platform_decoration{
	dir = 4
	},
/turf/open/floor/plating/ground/dirt/dug,
/area/lv624/lazarus/sandtemple/garbledradio)
"lb" = (
/turf/open/ground/grass/grass2,
/area/lv624/ground/jungle8)
"mm" = (
/obj/structure/flora/jungle/vines,
/turf/open/floor/plating/ground/dirtgrassborder/corner2{
	dir = 1
	},
/area/lv624/ground/jungle8)
"mz" = (
/obj/effect/turf_decal/sandytile,
/turf/open/floor/tile/whiteyellow/full,
/area/lv624/lazarus/sandtemple/garbledradio)
"mL" = (
/turf/closed/gm/dense,
/area/lv624/ground/caves/rock)
"mT" = (
/obj/effect/turf_decal/warning_stripes/thin{
	dir = 8
	},
/turf/open/floor/plating/ground/dirt,
/area/lv624/ground/sand9)
"og" = (
/obj/structure/flora/jungle/plantbot1/alien,
/turf/open/floor/plating/ground/dirt,
/area/lv624/ground/sand9)
"om" = (
/obj/effect/turf_decal/sandytile,
/obj/effect/turf_decal/sandytile,
/obj/structure/flora/jungle/vines{
	pixel_y = 1
	},
/obj/structure/flora/jungle/vines{
	pixel_y = 1
	},
/turf/open/floor/tile/whiteyellow/full,
/area/lv624/lazarus/sandtemple/garbledradio)
"oG" = (
/obj/structure/stairs/seamless/platform{
	dir = 1
	},
/turf/open/floor/tile/whiteyellow/full,
/area/lv624/lazarus/sandtemple/garbledradio)
"oJ" = (
/turf/closed/wall/r_wall/chigusa,
/area/lv624/lazarus/sandtemple/garbledradio)
"oY" = (
/obj/effect/landmark/weed_node,
/turf/open/floor/plating/ground/dirt,
/area/lv624/ground/sand3)
"qF" = (
/obj/effect/landmark/weed_node,
/turf/open/liquid/water/river/autosmooth,
/area/lv624/ground/river3)
"qK" = (
/obj/effect/turf_decal/warning_stripes/thin{
	dir = 2
	},
/obj/effect/landmark/weed_node,
/obj/effect/turf_decal/warning_stripes/thin{
	dir = 6
	},
/turf/open/floor,
/area/lv624/ground/sand9)
"qS" = (
/turf/open/floor/plating/ground/dirt,
/area/lv624/ground/river3)
"rc" = (
/obj/effect/ai_node,
/turf/open/liquid/water/river/autosmooth,
/area/lv624/ground/sand6)
"sy" = (
/obj/structure/girder,
/turf/open/floor/plating/ground/dirt,
/area/lv624/lazarus/sandtemple/garbledradio)
"sC" = (
/obj/effect/turf_decal/sandytile,
/obj/effect/ai_node,
/turf/open/floor/tile/whiteyellow/full,
/area/lv624/lazarus/sandtemple/garbledradio)
"tf" = (
/obj/structure/stairs/seamless/platform,
/turf/open/floor/tile/whiteyellow/full,
/area/lv624/lazarus/sandtemple/garbledradio)
"tl" = (
/obj/effect/decal/cleanable/blood/splatter/animated,
/obj/effect/landmark/weed_node,
/turf/open/floor/plating/ground/dirt,
/area/lv624/lazarus/sandtemple/garbledradio)
"tA" = (
/obj/item/weapon/sword/machete,
/turf/open/floor/plating/ground/dirt,
/area/lv624/lazarus/sandtemple/garbledradio)
"tP" = (
/obj/effect/decal/remains/xeno{
	pixel_x = 1;
	pixel_y = 31
	},
/obj/structure/showcase,
/obj/effect/turf_decal/sandytile,
/obj/structure/flora/jungle/vines{
	pixel_y = 1
	},
/turf/open/floor/tile/whiteyellow/full,
/area/lv624/lazarus/sandtemple/garbledradio)
"ut" = (
/obj/effect/turf_decal/sandytile,
/obj/effect/decal/cleanable/blood/gibs,
/turf/open/floor/tile/whiteyellow/full,
/area/lv624/lazarus/sandtemple/garbledradio)
"vt" = (
/obj/structure/flora/jungle/plantbot1/alien,
/turf/open/floor/plating/ground/dirt,
/area/lv624/ground/river3)
"vZ" = (
/obj/machinery/floodlight/colony,
/turf/open/floor/plating/ground/dirt,
/area/lv624/ground/sand9)
"wT" = (
/obj/structure/flora/jungle/vines,
/turf/open/liquid/water/river/autosmooth,
/area/lv624/ground/sand6)
"yc" = (
/turf/open/floor/plating/ground/dirt,
/area/lv624/ground/sand6)
"yt" = (
/turf/open/floor/plating/ground/dirt,
/area/lv624/lazarus/sandtemple/garbledradio)
"yL" = (
/obj/structure/flora/jungle/vines,
/turf/open/floor/plating/ground/dirt,
/area/lv624/lazarus/sandtemple/garbledradio)
"zi" = (
/obj/effect/decal/remains/xeno{
	pixel_x = -1;
	pixel_y = 31
	},
/obj/structure/showcase,
/obj/effect/turf_decal/sandytile,
/obj/effect/turf_decal/sandytile,
/turf/open/floor/tile/whiteyellow/full,
/area/lv624/lazarus/sandtemple/garbledradio)
"Ai" = (
/obj/structure/glowshroom,
/turf/open/floor/plating/ground/dirt,
/area/lv624/lazarus/sandtemple/garbledradio)
"Dl" = (
/obj/effect/ai_node,
/turf/open/floor/plating/ground/dirt,
/area/lv624/ground/sand3)
"Dm" = (
/obj/structure/flora/jungle/vines{
	pixel_y = 1
	},
/turf/closed/mineral/smooth,
/area/lv624/ground/caves/rock)
"FN" = (
/obj/effect/landmark/weed_node,
/obj/structure/flora/jungle/vines,
/turf/closed/wall/r_wall/chigusa,
/area/lv624/lazarus/sandtemple/garbledradio)
"Gx" = (
/obj/effect/landmark/weed_node,
/turf/open/floor/plating/ground/dirt,
/area/lv624/ground/sand9)
"HH" = (
/obj/item/weapon/sword/machete,
/obj/structure/flora/jungle/vines{
	pixel_y = 1
	},
/turf/open/floor/plating/ground/dirt,
/area/lv624/lazarus/sandtemple/garbledradio)
"HY" = (
/obj/structure/flora/jungle/vines,
/turf/closed/wall/r_wall/chigusa,
/area/lv624/lazarus/sandtemple/garbledradio)
"IP" = (
/turf/open/floor/plating/ground/dirtgrassborder/corner2{
	dir = 1
	},
/area/lv624/ground/river3)
"Jt" = (
/turf/open/floor/plating/ground/dirtgrassborder/corner2{
	dir = 1
	},
/area/lv624/ground/jungle8)
"JB" = (
/turf/closed/wall,
/area/lv624/ground/sand9)
"JK" = (
/turf/open/liquid/water/river/autosmooth,
/area/lv624/ground/sand6)
"Kb" = (
/obj/effect/landmark/weed_node,
/turf/open/floor/plating/ground/dirt,
/area/lv624/lazarus/sandtemple/garbledradio)
"KK" = (
/obj/structure/flora/jungle/vines{
	pixel_y = 1
	},
/turf/open/floor/plating/ground/dirt,
/area/lv624/lazarus/sandtemple/garbledradio)
"Lh" = (
/turf/open/floor/plating/ground/dirt,
/area/lv624/ground/sand3)
"Mo" = (
/obj/structure/platform_decoration{
	dir = 8
	},
/turf/open/liquid/water/river/autosmooth,
/area/lv624/ground/sand6)
"My" = (
/obj/effect/decal/cleanable/blood/gibs,
/turf/open/floor/plating/ground/dirt,
/area/lv624/lazarus/sandtemple/garbledradio)
"MG" = (
/turf/closed/wall/r_wall/chigusa,
/area/lv624/ground/river3)
"OZ" = (
/obj/structure/stairs/seamless{
	dir = 8
	},
/turf/open/floor/tile/whiteyellow/full,
/area/lv624/lazarus/sandtemple/garbledradio)
"PL" = (
/obj/structure/flora/jungle/plantbot1/alien,
/turf/open/liquid/water/river/autosmooth,
/area/lv624/ground/river3)
"PY" = (
/obj/structure/flora/jungle/plantbot1/alien,
/obj/structure/flora/jungle/vines{
	pixel_y = 1
	},
/turf/open/floor/plating/ground/dirt,
/area/lv624/lazarus/sandtemple/garbledradio)
"PZ" = (
/obj/structure/flora/jungle/vines,
/obj/effect/spawner/random/engineering/tool,
/turf/open/floor/plating/ground/dirt,
/area/lv624/lazarus/sandtemple/garbledradio)
"Qj" = (
/obj/structure/flora/jungle/vines,
/turf/open/floor/plating/ground/dirtgrassborder{
	dir = 1
	},
/area/lv624/ground/jungle8)
"QF" = (
/turf/open/ground/grass,
/area/lv624/ground/jungle8)
"QS" = (
/turf/closed/wall/r_wall/chigusa,
/area/lv624/ground/sand6)
"RJ" = (
/obj/effect/ai_node,
/turf/open/liquid/water/river/autosmooth,
/area/lv624/ground/river3)
"Sm" = (
/obj/structure/flora/ausbushes/palebush,
/turf/open/liquid/water/river/autosmooth,
/area/lv624/ground/river3)
"SD" = (
/turf/open/liquid/water/river/autosmooth,
/area/lv624/ground/sand3)
"SJ" = (
/obj/structure/stairs/seamless{
	dir = 4
	},
/turf/open/floor/tile/whiteyellow/full,
/area/lv624/lazarus/sandtemple/garbledradio)
"Tp" = (
/turf/open/liquid/water/river/autosmooth,
/area/lv624/ground/river3)
"Tt" = (
/obj/structure/flora/jungle/vines{
	pixel_y = 1
	},
/turf/closed/wall/r_wall/chigusa,
/area/lv624/lazarus/sandtemple/garbledradio)
"TF" = (
/obj/effect/turf_decal/sandytile,
/obj/structure/flora/jungle/vines{
	pixel_y = 1
	},
/turf/open/floor/tile/whiteyellow/full,
/area/lv624/lazarus/sandtemple/garbledradio)
"TX" = (
/obj/effect/ai_node,
/turf/open/floor/plating/ground/dirt,
/area/lv624/ground/sand9)
"UN" = (
/obj/structure/flora/ausbushes/reedbush,
/turf/open/liquid/water/river/autosmooth,
/area/lv624/ground/river3)
"UW" = (
/obj/docking_port/stationary/crashmode,
/obj/structure/stairs/seamless{
	dir = 8
	},
/turf/open/floor/plating/ground/dirt,
/area/lv624/lazarus/sandtemple/garbledradio)
"Wt" = (
/turf/open/floor/plating/ground/dirt,
/area/lv624/ground/sand9)
"Wv" = (
/obj/effect/decal/cleanable/blood/splatter/animated,
/turf/open/floor/plating/ground/dirt,
/area/lv624/lazarus/sandtemple/garbledradio)
"WB" = (
/obj/effect/turf_decal/sandytile,
/obj/effect/turf_decal/sandytile,
/obj/effect/landmark/weed_node,
/turf/open/floor/tile/whiteyellow/full,
/area/lv624/lazarus/sandtemple/garbledradio)
"Xv" = (
/obj/structure/flora/jungle/vines{
	pixel_y = 1
	},
/obj/machinery/door/airlock/mainship/generic{
	desc = "This strange temple is covered in runes. It looks extremely ancient.";
	dir = 2;
	name = "Strange Temple"
	},
/obj/effect/mapping_helpers/airlock/locked,
/turf/open/floor/plating/ground/dirt,
/area/lv624/lazarus/sandtemple/garbledradio)
"Xx" = (
/turf/closed/mineral/smooth,
/area/lv624/ground/caves/rock)
"XR" = (
/obj/effect/turf_decal/warning_stripes/thin{
	dir = 8
	},
/obj/effect/turf_decal/warning_stripes/thin{
	dir = 9
	},
/turf/open/floor/plating/ground/dirt,
/area/lv624/ground/sand9)

(1,1,1) = {"
JK
JK
JK
SD
Lh
Lh
Xx
Xx
Xx
Xx
Xx
Xx
Xx
Wt
Wt
Wt
TX
Wt
hE
qK
Wt
Wt
Tp
Tp
"}
(2,1,1) = {"
Mo
JK
JK
Lh
jq
Lh
Lh
Xx
Xx
Xx
Xx
Xx
Xx
Xx
Wt
Wt
Wt
Wt
XR
mT
Wt
Wt
Tp
Tp
"}
(3,1,1) = {"
wT
rc
yc
Lh
Lh
Dl
Lh
Xx
Xx
Xx
Xx
Xx
Xx
Xx
Wt
Wt
Gx
Wt
Wt
Wt
Wt
Wt
Tp
Tp
"}
(4,1,1) = {"
yc
yc
QS
Lh
oY
Lh
jq
Xx
Xx
Xx
Xx
Xx
Wt
gQ
Wt
Wt
Wt
Wt
Wt
Wt
Wt
Wt
Tp
Tp
"}
(5,1,1) = {"
yc
yc
QS
Lh
Lh
Lh
Lh
Xx
Xx
Xx
Xx
Wt
Wt
gQ
Wt
vZ
Wt
Wt
Wt
Wt
Wt
vZ
qS
Tp
"}
(6,1,1) = {"
tf
OZ
hG
hG
hG
UW
HY
Tt
Dm
Dm
Wt
Wt
Wt
gQ
Wt
Wt
Wt
Wt
Wt
Wt
Wt
Wt
qS
Tp
"}
(7,1,1) = {"
yt
yt
mz
WB
iX
mz
yL
Tt
Tt
Xx
Wt
Wt
cm
JB
gQ
gQ
fB
JB
gQ
gQ
fB
JB
qS
Tp
"}
(8,1,1) = {"
Kb
mz
mz
mz
Kb
yL
yL
TF
Tt
tP
Wt
Wt
Wt
Gx
Wt
Wt
Wt
Wt
Wt
Wt
Wt
Wt
qS
Tp
"}
(9,1,1) = {"
yt
sC
mz
yt
yt
dv
yt
KK
Xv
iX
Wt
Wt
og
Wt
Wt
Wt
Wt
og
Wt
Wt
Tp
Tp
Tp
Tp
"}
(10,1,1) = {"
mz
ut
Wv
yt
yt
yt
ee
om
Tt
zi
Wt
TX
Wt
Wt
Wt
Wt
Wt
Tp
RJ
Tp
Tp
Tp
Tp
Tp
"}
(11,1,1) = {"
WB
yt
yt
mz
yt
yt
KK
Tt
oJ
yt
Wt
Wt
Wt
Wt
Wt
Wt
Wt
Tp
Tp
Tp
Tp
Tp
UN
Tp
"}
(12,1,1) = {"
oG
SJ
er
er
er
er
oJ
Tt
KK
yt
Wt
Wt
Wt
Wt
Wt
Tp
Tp
Tp
eP
qF
Tp
Tp
Tp
Tp
"}
(13,1,1) = {"
yt
yt
oJ
yt
yt
yt
mL
Tt
sy
Tt
Wt
Wt
Wt
og
Wt
Tp
Tp
Tp
Tp
Tp
Tp
PL
Tp
Tp
"}
(14,1,1) = {"
yt
yt
HY
yt
yt
yt
yt
PY
KK
sy
Wt
Wt
Tp
Tp
Tp
Tp
Tp
Tp
Tp
UN
Tp
Tp
Tp
Tp
"}
(15,1,1) = {"
yt
dv
mz
yt
yt
dv
yt
yt
Wv
yt
Wt
RJ
Tp
Tp
Tp
Tp
Tp
Tp
PL
Tp
Tp
Tp
Tp
Tp
"}
(16,1,1) = {"
kv
yt
yt
yt
FN
KK
KK
yt
My
yt
Tp
Tp
Tp
Tp
Tp
Sm
Tp
Tp
Tp
Tp
Tp
Tp
Tp
Tp
"}
(17,1,1) = {"
Xx
yt
yt
yt
oJ
Tt
sy
yt
HH
oJ
Tp
eP
Tp
Tp
Tp
Tp
Tp
Tp
Tp
Tp
Tp
UN
Tp
Tp
"}
(18,1,1) = {"
Xx
Kb
yt
Ai
yt
KK
PZ
yt
KK
oJ
Tp
Tp
Tp
qS
kp
qS
Tp
Tp
Tp
UN
Tp
Tp
Tp
mm
"}
(19,1,1) = {"
oJ
dv
tl
yt
sy
HY
mL
HY
yt
yt
Tp
Tp
UN
qS
qS
qS
vt
Tp
Tp
Tp
Tp
Tp
Tp
Qj
"}
(20,1,1) = {"
oJ
tA
My
yt
HY
Xx
mL
mL
mL
Tp
Tp
Tp
Tp
Tp
Tp
kp
Tp
Tp
eP
Tp
Tp
Tp
Jt
bs
"}
(21,1,1) = {"
oJ
yt
yt
yt
Xx
Xx
Xx
Xx
mL
Tp
PL
Tp
Tp
UN
Tp
Tp
Tp
Tp
Tp
Tp
Tp
Jt
km
lb
"}
(22,1,1) = {"
oJ
oJ
QS
QS
Xx
Xx
Xx
Xx
mL
Tp
Tp
MG
Tp
Tp
Tp
Tp
Tp
Tp
Tp
Tp
IP
km
QF
jh
"}
