//MAP CONVERTED BY dmm2tgm.py THIS HEADER COMMENT PREVENTS RECONVERSION, DO NOT REMOVE
"aw" = (
/turf/open/floor/plating/ground/dirt,
/area/lv624/ground/sand6)
"aS" = (
/obj/effect/turf_decal/warning_stripes/thin{
	dir = 2
	},
/turf/open/floor,
/area/lv624/ground/sand9)
"bc" = (
/obj/effect/turf_decal/warning_stripes/thin{
	dir = 4
	},
/turf/open/floor,
/area/lv624/ground/sand9)
"bt" = (
/obj/structure/table,
/obj/item/book/manual/research_and_development,
/turf/open/floor/tile/purple/whitepurple{
	dir = 1
	},
/area/lv624/ground/sand9)
"bE" = (
/turf/open/ground/river/autosmooth,
/area/lv624/ground/sand3)
"bM" = (
/turf/open/floor/tile/purple/whitepurple{
	dir = 4
	},
/area/lv624/ground/sand9)
"cK" = (
/turf/open/floor/tile/purple/whitepurple{
	dir = 8
	},
/area/lv624/ground/sand9)
"cT" = (
/obj/effect/ai_node,
/turf/open/floor/plating/ground/dirt,
/area/lv624/ground/sand9)
"dD" = (
/obj/machinery/floodlight/colony,
/turf/open/floor/plating/ground/dirt,
/area/lv624/ground/sand9)
"dH" = (
/turf/open/floor/plating/ground/dirtgrassborder/corner2{
	dir = 4
	},
/area/lv624/ground/sand9)
"er" = (
/obj/structure/table,
/obj/structure/paper_bin,
/turf/open/floor/plating/ground/dirt,
/area/lv624/lazarus/sandtemple)
"fi" = (
/obj/effect/landmark/weed_node,
/turf/open/floor/plating/ground/dirt,
/area/lv624/ground/sand9)
"hm" = (
/obj/structure/jungle/plantbot1/alien,
/turf/open/floor/plating/ground/dirt,
/area/lv624/ground/sand9)
"iB" = (
/turf/closed/wall/r_wall/chigusa,
/area/lv624/ground/sand6)
"jL" = (
/obj/machinery/chem_dispenser,
/turf/open/floor/tile/purple/whitepurple{
	dir = 9
	},
/area/lv624/ground/sand9)
"kA" = (
/obj/structure/flora/ausbushes/reedbush,
/turf/open/floor/plating/ground/dirt,
/area/lv624/ground/sand9)
"ls" = (
/obj/effect/turf_decal/sandytile,
/obj/effect/turf_decal/sandytile,
/obj/effect/landmark/weed_node,
/turf/open/floor/tile/whiteyellow/full,
/area/lv624/lazarus/sandtemple)
"lD" = (
/turf/open/ground/grass,
/area/lv624/ground/jungle8)
"oo" = (
/obj/structure/flora/ausbushes/palebush,
/obj/effect/ai_node,
/turf/open/ground/river/autosmooth,
/area/lv624/ground/river3)
"px" = (
/obj/structure/stairs/seamless/platform{
	dir = 1
	},
/turf/open/floor/tile/whiteyellow/full,
/area/lv624/lazarus/sandtemple)
"pM" = (
/obj/effect/ai_node,
/turf/open/floor/tile/purple/whitepurple{
	dir = 2
	},
/area/lv624/ground/sand9)
"qf" = (
/turf/closed/wall/r_wall/chigusa,
/area/lv624/lazarus/sandtemple)
"qV" = (
/obj/effect/turf_decal/sandytile,
/obj/effect/decal/cleanable/blood/gibs/xeno/body,
/turf/open/floor/tile/whiteyellow/full,
/area/lv624/lazarus/sandtemple)
"re" = (
/obj/effect/ai_node,
/turf/open/ground/river/autosmooth,
/area/lv624/ground/sand6)
"rI" = (
/obj/effect/turf_decal/warning_stripes/thin{
	dir = 2
	},
/obj/effect/turf_decal/warning_stripes/thin{
	dir = 8
	},
/turf/open/floor,
/area/lv624/ground/sand9)
"rS" = (
/obj/docking_port/stationary/crashmode,
/obj/structure/stairs/seamless{
	dir = 8
	},
/turf/open/floor/plating/ground/dirt,
/area/lv624/lazarus/sandtemple)
"sb" = (
/turf/open/floor/plating/ground/dirt,
/area/lv624/ground/sand3)
"sZ" = (
/obj/effect/spawner/random/engineering/pickaxe,
/obj/effect/turf_decal/tracks/human2/bloody,
/turf/open/floor/plating/ground/dirt,
/area/lv624/lazarus/sandtemple)
"td" = (
/obj/effect/decal/remains/xeno{
	pixel_x = -1;
	pixel_y = 31
	},
/obj/structure/showcase,
/obj/effect/turf_decal/sandytile,
/obj/effect/turf_decal/sandytile,
/turf/open/floor/tile/whiteyellow/full,
/area/lv624/lazarus/sandtemple)
"ti" = (
/obj/effect/turf_decal/sandytile,
/obj/effect/decal/cleanable/blood,
/turf/open/floor/tile/whiteyellow/full,
/area/lv624/lazarus/sandtemple)
"ue" = (
/obj/structure/platform{
	dir = 1
	},
/turf/open/floor/plating/ground/dirt,
/area/lv624/ground/sand6)
"um" = (
/obj/structure/window/framed/colony,
/turf/open/floor/plating,
/area/lv624/ground/sand9)
"uu" = (
/obj/effect/turf_decal/warning_stripes/thin{
	dir = 9
	},
/obj/effect/turf_decal/warning_stripes/thin{
	dir = 1
	},
/turf/open/floor,
/area/lv624/ground/sand9)
"uE" = (
/obj/structure/platform_decoration{
	dir = 4
	},
/turf/open/floor/plating/ground/dirt/dug,
/area/lv624/ground/sand6)
"uN" = (
/obj/effect/landmark/weed_node,
/turf/open/floor/plating/ground/dirt,
/area/lv624/ground/sand6)
"uO" = (
/obj/structure/jungle/vines,
/turf/open/floor/plating/ground/dirtgrassborder/corner2{
	dir = 1
	},
/area/lv624/ground/jungle8)
"uX" = (
/obj/structure/inflatable/door,
/turf/open/floor/plating/ground/dirt,
/area/lv624/lazarus/sandtemple)
"vU" = (
/obj/effect/turf_decal/sandytile,
/turf/open/floor/tile/whiteyellow/full,
/area/lv624/ground/sand6)
"wv" = (
/obj/effect/turf_decal/sandytile,
/obj/effect/turf_decal/sandytile,
/obj/effect/landmark/corpsespawner/scientist,
/obj/item/clipboard,
/turf/open/floor/tile/whiteyellow/full,
/area/lv624/lazarus/sandtemple)
"wB" = (
/obj/structure/flora/grass/brown,
/turf/open/ground/river/autosmooth,
/area/lv624/ground/river3)
"wJ" = (
/obj/structure/stairs/seamless/platform,
/turf/open/floor/tile/whiteyellow/full,
/area/lv624/lazarus/sandtemple)
"xO" = (
/obj/structure/platform_decoration{
	dir = 8
	},
/turf/open/floor/plating/ground/dirt,
/area/lv624/ground/sand9)
"yn" = (
/turf/closed/wall/r_wall/chigusa,
/area/lv624/ground/river3)
"yp" = (
/obj/effect/turf_decal/warning_stripes/thin{
	dir = 2
	},
/obj/effect/turf_decal/warning_stripes/thin{
	dir = 4
	},
/turf/open/floor,
/area/lv624/ground/sand9)
"yu" = (
/turf/open/ground/grass/grass2,
/area/lv624/ground/jungle8)
"yW" = (
/obj/effect/landmark/corpsespawner/scientist,
/turf/open/floor/tile/purple/whitepurple{
	dir = 10
	},
/area/lv624/ground/sand9)
"zx" = (
/turf/closed/gm/dense,
/area/lv624/ground/caves/rock)
"zE" = (
/turf/open/floor/plating/ground/dirtgrassborder/corner2{
	dir = 1
	},
/area/lv624/ground/jungle8)
"Am" = (
/obj/effect/turf_decal/warning_stripes/thin{
	dir = 8
	},
/turf/open/floor,
/area/lv624/ground/sand9)
"AA" = (
/obj/structure/jungle/vines/heavy,
/turf/open/floor/plating/ground/dirtgrassborder/corner{
	dir = 4
	},
/area/lv624/ground/jungle8)
"AP" = (
/turf/open/floor/plating/ground/dirt,
/area/lv624/ground/sand9)
"Bd" = (
/obj/effect/decal/cleanable/blood/gibs/limb,
/turf/open/floor/plating/ground/dirt,
/area/lv624/ground/sand6)
"Bi" = (
/obj/effect/turf_decal/sandytile,
/obj/effect/landmark/weed_node,
/turf/open/floor/tile/whiteyellow/full,
/area/lv624/lazarus/sandtemple)
"Bo" = (
/obj/effect/landmark/weed_node,
/turf/open/floor/tile/white,
/area/lv624/ground/sand9)
"BP" = (
/turf/closed/wall,
/area/lv624/ground/sand9)
"CB" = (
/obj/effect/turf_decal/sandytile,
/obj/effect/turf_decal/sandytile,
/obj/effect/decal/cleanable/blood/writing,
/turf/open/floor/tile/whiteyellow/full,
/area/lv624/lazarus/sandtemple)
"Dk" = (
/obj/structure/jungle/vines/heavy,
/turf/open/ground/grass,
/area/lv624/ground/jungle8)
"Dr" = (
/obj/structure/stairs/seamless{
	dir = 8
	},
/turf/open/floor/tile/whiteyellow/full,
/area/lv624/lazarus/sandtemple)
"ED" = (
/obj/effect/landmark/weed_node,
/obj/effect/turf_decal/warning_stripes/thin{
	dir = 4
	},
/turf/open/floor,
/area/lv624/ground/sand9)
"EE" = (
/obj/effect/turf_decal/sandytile,
/obj/effect/turf_decal/sandytile,
/obj/structure/table,
/obj/item/flashlight/lantern,
/obj/item/flashlight/lantern,
/turf/open/floor/tile/whiteyellow/full,
/area/lv624/lazarus/sandtemple)
"EJ" = (
/obj/effect/ai_node,
/turf/open/floor/plating/ground/dirt,
/area/lv624/lazarus/sandtemple)
"ES" = (
/obj/machinery/door/airlock/mainship/medical/glass/free_access{
	dir = 4;
	name = "\improper Hydroponics Dome"
	},
/turf/open/floor/tile/white,
/area/lv624/ground/sand9)
"Fc" = (
/obj/structure/stairs/cornerdark/seamless{
	dir = 1
	},
/turf/open/floor/plating/ground/dirt,
/area/lv624/lazarus/sandtemple)
"Fm" = (
/obj/structure/jungle/vines,
/turf/open/ground/river/autosmooth,
/area/lv624/ground/river3)
"Gj" = (
/obj/structure/stairs/seamless{
	dir = 4
	},
/turf/open/floor/plating/ground/dirt,
/area/lv624/lazarus/sandtemple)
"GH" = (
/turf/closed/wall/r_wall/chigusa,
/area/lv624/ground/sand3)
"GR" = (
/obj/effect/landmark/corpsespawner/scientist,
/turf/open/floor/plating/ground/dirt,
/area/lv624/lazarus/sandtemple)
"GT" = (
/turf/open/floor,
/area/lv624/ground/sand9)
"Hq" = (
/obj/effect/turf_decal/warning_stripes/thin{
	dir = 1
	},
/turf/open/floor,
/area/lv624/ground/sand9)
"Hu" = (
/obj/effect/landmark/corpsespawner/scientist,
/turf/open/floor/plating/ground/dirt,
/area/lv624/ground/sand9)
"HW" = (
/turf/closed/mineral/smooth,
/area/lv624/ground/caves/rock)
"Ix" = (
/obj/structure/jungle/vines,
/turf/open/floor/plating/ground/dirtgrassborder{
	dir = 1
	},
/area/lv624/ground/jungle8)
"ID" = (
/obj/effect/decal/cleanable/blood/gibs/xeno/body,
/turf/open/floor/tile/purple/whitepurple{
	dir = 8
	},
/area/lv624/ground/sand9)
"IN" = (
/obj/structure/table,
/obj/item/clothing/glasses/regular,
/turf/open/floor/tile/purple/whitepurple{
	dir = 2
	},
/area/lv624/ground/sand9)
"IU" = (
/obj/effect/turf_decal/warning_stripes/thin{
	dir = 2
	},
/obj/effect/landmark/weed_node,
/obj/effect/turf_decal/warning_stripes/thin{
	dir = 6
	},
/turf/open/floor,
/area/lv624/ground/sand9)
"Js" = (
/obj/effect/turf_decal/warning_stripes/thin{
	dir = 4
	},
/obj/effect/turf_decal/warning_stripes/thin,
/turf/open/floor,
/area/lv624/ground/sand9)
"JI" = (
/obj/effect/ai_node,
/turf/open/ground/river/autosmooth,
/area/lv624/ground/river3)
"Kf" = (
/obj/structure/platform_decoration{
	dir = 8
	},
/turf/open/ground/river/autosmooth,
/area/lv624/ground/sand6)
"KR" = (
/obj/effect/landmark/weed_node,
/turf/open/floor/plating/ground/dirt,
/area/lv624/ground/sand3)
"LN" = (
/obj/effect/turf_decal/warning_stripes/thin{
	dir = 1
	},
/obj/effect/turf_decal/warning_stripes/thin{
	dir = 4
	},
/turf/open/floor,
/area/lv624/ground/sand9)
"Mb" = (
/obj/structure/bed/chair/office/dark{
	dir = 4
	},
/turf/open/floor/tile/purple/whitepurple{
	dir = 2
	},
/area/lv624/ground/sand9)
"NH" = (
/obj/structure/table,
/obj/item/flashlight/lamp,
/turf/open/floor/tile/purple/whitepurple{
	dir = 1
	},
/area/lv624/ground/sand9)
"NK" = (
/turf/open/floor/plating/ground/dirt,
/area/lv624/lazarus/sandtemple)
"NU" = (
/obj/effect/decal/remains/xeno{
	pixel_x = 1;
	pixel_y = 31
	},
/obj/structure/showcase,
/obj/effect/turf_decal/sandytile,
/turf/open/floor/tile/whiteyellow/full,
/area/lv624/lazarus/sandtemple)
"Ow" = (
/obj/item/trash/cheesie,
/turf/open/floor,
/area/lv624/ground/sand9)
"OA" = (
/obj/effect/decal/cleanable/blood/writing,
/obj/effect/ai_node,
/turf/open/floor/plating/ground/dirt,
/area/lv624/lazarus/sandtemple)
"Pb" = (
/obj/effect/turf_decal/sandytile,
/obj/effect/ai_node,
/turf/open/floor/tile/whiteyellow/full,
/area/lv624/lazarus/sandtemple)
"Pw" = (
/obj/effect/ai_node,
/turf/open/floor/plating/ground/dirt,
/area/lv624/ground/sand3)
"PR" = (
/obj/structure/platform{
	dir = 1
	},
/obj/structure/jungle/vines,
/turf/open/ground/river/autosmooth,
/area/lv624/ground/sand6)
"PV" = (
/obj/structure/flora/grass/green,
/turf/open/ground/river/autosmooth,
/area/lv624/ground/river3)
"Qq" = (
/obj/structure/stairs/seamless{
	dir = 8
	},
/turf/open/floor/plating/ground/dirt,
/area/lv624/lazarus/sandtemple)
"Qt" = (
/turf/open/floor/tile/purple/whitepurple{
	dir = 6
	},
/area/lv624/ground/sand9)
"QK" = (
/obj/structure/jungle/vines,
/turf/closed/wall/r_wall/chigusa,
/area/lv624/lazarus/sandtemple)
"QQ" = (
/turf/open/floor/plating/ground/dirtgrassborder/corner2{
	dir = 1
	},
/area/lv624/ground/river3)
"Ri" = (
/obj/structure/stairs/seamless,
/turf/open/floor/plating/ground/dirt,
/area/lv624/lazarus/sandtemple)
"Rx" = (
/obj/structure/table,
/turf/open/floor/plating/ground/dirt,
/area/lv624/lazarus/sandtemple)
"RZ" = (
/obj/effect/landmark/corpsespawner/scientist,
/obj/effect/spawner/random/engineering/pickaxe,
/turf/open/floor/plating/ground/dirt,
/area/lv624/lazarus/sandtemple)
"SL" = (
/turf/open/ground/river/autosmooth,
/area/lv624/ground/sand9)
"SR" = (
/obj/effect/landmark/corpsespawner/scientist,
/turf/open/floor/tile/purple/whitepurple{
	dir = 4
	},
/area/lv624/ground/sand9)
"Te" = (
/obj/structure/stairs/seamless{
	dir = 4
	},
/turf/open/floor/tile/whiteyellow/full,
/area/lv624/lazarus/sandtemple)
"Ue" = (
/obj/structure/jungle/plantbot1/alien,
/turf/open/ground/river/autosmooth,
/area/lv624/ground/river3)
"Vd" = (
/obj/structure/platform_decoration{
	dir = 4
	},
/turf/open/floor/plating/ground/dirtgrassborder/corner{
	dir = 1
	},
/area/lv624/ground/sand9)
"Vj" = (
/turf/open/floor/plating/ground/dirtgrassborder/corner{
	dir = 4
	},
/area/lv624/ground/jungle8)
"Vu" = (
/obj/effect/turf_decal/sandytile,
/obj/structure/inflatable/wall,
/turf/open/floor/tile/whiteyellow/full,
/area/lv624/lazarus/sandtemple)
"VY" = (
/obj/structure/stairs/cornerdark/seamless{
	dir = 4
	},
/turf/open/floor/plating/ground/dirt,
/area/lv624/lazarus/sandtemple)
"Ww" = (
/turf/open/ground/river/autosmooth,
/area/lv624/ground/sand6)
"WD" = (
/obj/structure/jungle/vines,
/turf/closed/mineral/smooth,
/area/lv624/ground/caves/rock)
"WV" = (
/obj/effect/turf_decal/sandytile,
/obj/effect/decal/cleanable/blood/gibs,
/obj/effect/turf_decal/tracks/claw1/bloody,
/turf/open/floor/tile/whiteyellow/full,
/area/lv624/lazarus/sandtemple)
"Xp" = (
/obj/effect/turf_decal/warning_stripes/thin{
	dir = 1
	},
/obj/effect/turf_decal/warning_stripes/thin{
	dir = 8
	},
/turf/open/floor,
/area/lv624/ground/sand9)
"XN" = (
/obj/structure/flora/ausbushes/reedbush,
/turf/open/ground/river/autosmooth,
/area/lv624/ground/river3)
"Ya" = (
/obj/effect/landmark/weed_node,
/turf/open/floor/plating/ground/dirt,
/area/lv624/lazarus/sandtemple)
"Yf" = (
/obj/structure/inflatable/wall,
/turf/open/floor/plating/ground/dirt,
/area/lv624/lazarus/sandtemple)
"Yg" = (
/obj/effect/ai_node,
/turf/open/floor/plating/ground/dirt,
/area/lv624/ground/sand6)
"YA" = (
/obj/item/clothing/suit/armor/vest/admiral,
/obj/effect/turf_decal/sandytile,
/turf/open/floor/tile/whiteyellow/full,
/area/lv624/lazarus/sandtemple)
"YR" = (
/turf/open/ground/river/autosmooth,
/area/lv624/ground/river3)
"Zk" = (
/obj/effect/turf_decal/sandytile,
/turf/open/floor/tile/whiteyellow/full,
/area/lv624/lazarus/sandtemple)
"ZE" = (
/obj/structure/filingcabinet,
/turf/open/floor/tile/purple/whitepurple{
	dir = 5
	},
/area/lv624/ground/sand9)
"ZM" = (
/obj/structure/jungle/vines,
/turf/open/floor/plating/ground/dirt,
/area/lv624/ground/sand6)
"ZP" = (
/obj/structure/table,
/obj/effect/spawner/random/engineering/tool,
/turf/open/floor/tile/purple/whitepurple{
	dir = 1
	},
/area/lv624/ground/sand9)
"ZZ" = (
/obj/effect/landmark/weed_node,
/obj/structure/table,
/turf/open/floor/plating/ground/dirt,
/area/lv624/lazarus/sandtemple)

(1,1,1) = {"
Ww
Ww
Ww
bE
sb
sb
HW
HW
HW
HW
HW
HW
HW
AP
AP
AP
AP
AP
Hq
IU
cT
AP
YR
YR
"}
(2,1,1) = {"
Kf
Ww
Ww
sb
GH
sb
sb
HW
HW
HW
HW
HW
HW
HW
AP
AP
AP
AP
uu
aS
Hu
AP
YR
YR
"}
(3,1,1) = {"
PR
re
aw
Pw
sb
sb
sb
HW
HW
HW
HW
HW
HW
HW
AP
AP
dD
AP
Hq
aS
AP
AP
YR
YR
"}
(4,1,1) = {"
ue
aw
iB
sb
KR
sb
GH
HW
HW
HW
HW
HW
AP
AP
AP
AP
Xp
Am
Ow
GT
Am
rI
YR
YR
"}
(5,1,1) = {"
ue
aw
iB
sb
sb
sb
sb
HW
HW
HW
HW
AP
AP
AP
fi
cT
Hq
ED
bc
bc
bc
yp
AP
YR
"}
(6,1,1) = {"
wJ
Dr
Qq
Qq
Qq
rS
qf
qf
HW
HW
xO
AP
AP
AP
AP
AP
Hq
BP
BP
BP
ES
BP
AP
YR
"}
(7,1,1) = {"
GR
NK
Zk
ls
EE
Vu
Yf
qf
QK
HW
wJ
Dr
Qq
Fc
AP
AP
Hq
BP
jL
ID
yW
BP
AP
YR
"}
(8,1,1) = {"
Ya
Zk
Zk
Zk
ZZ
Yf
sZ
Zk
qf
NU
YA
Zk
qV
Ri
AP
AP
Hq
um
bt
cK
pM
um
AP
YR
"}
(9,1,1) = {"
NK
Pb
ti
OA
NK
uX
EJ
NK
uX
CB
Bi
Pb
Zk
Ri
AP
cT
Hq
um
ZP
Bo
Mb
um
AP
YR
"}
(10,1,1) = {"
Zk
Zk
NK
RZ
Rx
Yf
WV
wv
qf
td
Zk
qV
Bi
Ri
AP
AP
Hq
um
NH
bM
IN
um
AP
YR
"}
(11,1,1) = {"
ls
NK
NK
Zk
er
Yf
Yf
qf
qf
HW
px
Te
Gj
VY
AP
AP
Hq
BP
ZE
SR
Qt
BP
AP
YR
"}
(12,1,1) = {"
px
Te
Gj
Gj
Gj
Gj
qf
QK
HW
HW
Vd
dH
AP
AP
AP
AP
Hq
BP
BP
BP
ES
BP
AP
YR
"}
(13,1,1) = {"
ue
aw
iB
aw
aw
YR
YR
YR
YR
zx
zx
HW
HW
hm
AP
AP
LN
bc
bc
bc
bc
Js
YR
YR
"}
(14,1,1) = {"
ue
aw
iB
aw
aw
YR
YR
Ue
YR
Fm
zx
zx
zx
SL
SL
AP
dD
AP
AP
kA
YR
YR
YR
YR
"}
(15,1,1) = {"
ue
aw
vU
aw
aw
YR
YR
YR
YR
Fm
zx
zx
YR
YR
YR
YR
YR
YR
Ue
YR
YR
YR
YR
YR
"}
(16,1,1) = {"
uE
Yg
aw
Yg
uN
YR
YR
YR
YR
YR
Fm
JI
YR
YR
YR
oo
YR
YR
YR
YR
YR
YR
YR
YR
"}
(17,1,1) = {"
HW
aw
aw
aw
aw
aw
aw
YR
YR
YR
YR
YR
YR
yn
YR
Ue
YR
YR
YR
YR
YR
XN
YR
YR
"}
(18,1,1) = {"
HW
uN
aw
aw
aw
aw
ZM
YR
YR
Ue
YR
YR
YR
YR
XN
YR
YR
YR
Ue
YR
YR
YR
YR
uO
"}
(19,1,1) = {"
qf
aw
aw
aw
uN
WD
zx
Fm
YR
YR
YR
YR
XN
YR
YR
YR
YR
YR
YR
YR
YR
YR
YR
Ix
"}
(20,1,1) = {"
qf
aw
aw
aw
aw
HW
zx
zx
zx
YR
YR
YR
YR
YR
PV
YR
YR
YR
wB
YR
YR
YR
zE
AA
"}
(21,1,1) = {"
qf
Bd
aw
aw
HW
HW
HW
HW
zx
YR
YR
YR
YR
XN
YR
YR
Ue
YR
YR
YR
YR
zE
Vj
yu
"}
(22,1,1) = {"
qf
qf
HW
HW
HW
HW
HW
HW
zx
YR
YR
yn
YR
YR
YR
YR
YR
YR
YR
YR
QQ
Vj
lD
Dk
"}
