//MAP CONVERTED BY dmm2tgm.py THIS HEADER COMMENT PREVENTS RECONVERSION, DO NOT REMOVE
"aw" = (
/turf/open/floor/plating/ground/dirt,
/area/lv624/ground/sand6)
"aS" = (
/obj/effect/turf_decal/warning_stripes/thin{
	dir = 8
	},
/turf/open/floor/plating/ground/dirt,
/area/lv624/ground/sand9)
"ba" = (
/obj/structure/flora/jungle/vines,
/turf/open/floor/plating/ground/dirt,
/area/lv624/ground/sand3)
"bt" = (
/obj/structure/flora/jungle/vines{
	pixel_y = 1
	},
/turf/closed/gm/dense,
/area/lv624/ground/caves/rock)
"bE" = (
/turf/open/liquid/water/river/autosmooth,
/area/lv624/ground/sand3)
"bO" = (
/obj/effect/turf_decal/sandytile,
/obj/effect/turf_decal/sandytile,
/turf/open/floor/tile/whiteyellow/full,
/area/lv624/ground/sand9)
"bU" = (
/obj/structure/showcase/six,
/obj/effect/turf_decal/sandytile,
/obj/effect/turf_decal/sandytile,
/obj/structure/platform{
	dir = 10
	},
/turf/open/floor/tile/whiteyellow/full,
/area/lv624/ground/sand9)
"bX" = (
/obj/structure/stairs/seamless/platform,
/turf/open/floor/tile/whiteyellow/full,
/area/lv624/ground/sand9)
"cK" = (
/obj/effect/turf_decal/sandytile,
/obj/effect/turf_decal/sandytile,
/turf/open/floor/tile/whiteyellow/full,
/area/lv624/ground/sand3)
"cT" = (
/obj/effect/ai_node,
/turf/open/floor/plating/ground/dirt,
/area/lv624/ground/sand9)
"dm" = (
/obj/structure/platform_decoration,
/obj/effect/turf_decal/sandytile,
/obj/effect/turf_decal/sandytile,
/obj/effect/turf_decal/sandytile,
/turf/open/floor/tile/whiteyellow/full,
/area/lv624/ground/sand9)
"dD" = (
/turf/open/floor/plating/ground/dirt,
/area/lv624/ground/river3)
"er" = (
/obj/structure/flora/jungle/vines,
/turf/closed/gm/dense,
/area/lv624/ground/caves/rock)
"fi" = (
/obj/effect/landmark/weed_node,
/turf/open/floor/plating/ground/dirt,
/area/lv624/ground/sand9)
"hm" = (
/obj/structure/flora/jungle/plantbot1/alien,
/turf/open/floor/plating/ground/dirt,
/area/lv624/ground/river3)
"hB" = (
/obj/structure/flora/ausbushes/palebush,
/turf/open/floor/plating/ground/dirt,
/area/lv624/ground/river3)
"iB" = (
/turf/closed/wall/r_wall/chigusa,
/area/lv624/ground/sand6)
"jg" = (
/obj/structure/stairs/seamless/platform{
	dir = 1
	},
/turf/open/floor/tile/whiteyellow/full,
/area/lv624/ground/sand9)
"jL" = (
/obj/structure/platform_decoration{
	dir = 4
	},
/turf/open/floor/plating/ground/dirt,
/area/lv624/ground/river3)
"kA" = (
/obj/structure/flora/ausbushes/reedbush,
/turf/open/floor/plating/ground/dirt,
/area/lv624/ground/river3)
"kY" = (
/obj/structure/platform_decoration{
	dir = 1
	},
/obj/effect/turf_decal/sandytile,
/obj/effect/turf_decal/sandytile,
/turf/open/floor/plating/ground/dirt,
/area/lv624/ground/sand9)
"ls" = (
/obj/effect/turf_decal/sandytile,
/obj/effect/turf_decal/sandytile,
/obj/effect/landmark/weed_node,
/turf/open/floor/tile/whiteyellow/full,
/area/lv624/lazarus/sandtemple/garbledradio)
"lD" = (
/turf/open/ground/grass,
/area/lv624/ground/jungle8)
"mS" = (
/obj/effect/ai_node,
/turf/open/liquid/water/river/autosmooth,
/area/lv624/ground/sand6)
"oo" = (
/obj/structure/flora/ausbushes/palebush,
/turf/open/liquid/water/river/autosmooth,
/area/lv624/ground/river3)
"oF" = (
/obj/effect/turf_decal/sandytile,
/turf/open/floor/plating/ground/dirt,
/area/lv624/ground/sand9)
"oX" = (
/obj/structure/showcase/six,
/obj/effect/turf_decal/sandytile,
/obj/effect/turf_decal/sandytile,
/obj/structure/platform{
	dir = 6
	},
/turf/open/floor/tile/whiteyellow/full,
/area/lv624/ground/sand9)
"px" = (
/obj/structure/stairs/seamless/platform{
	dir = 1
	},
/turf/open/floor/tile/whiteyellow/full,
/area/lv624/lazarus/sandtemple/garbledradio)
"qf" = (
/turf/closed/wall/r_wall/chigusa,
/area/lv624/lazarus/sandtemple)
"rS" = (
/obj/docking_port/stationary/crashmode,
/obj/structure/stairs/seamless{
	dir = 8
	},
/turf/open/floor/plating/ground/dirt,
/area/lv624/lazarus/sandtemple/garbledradio)
"sb" = (
/turf/open/floor/plating/ground/dirt,
/area/lv624/ground/sand3)
"sZ" = (
/obj/structure/flora/jungle/vines,
/turf/open/floor/plating/ground/dirt,
/area/lv624/lazarus/sandtemple/garbledradio)
"td" = (
/obj/effect/decal/remains/xeno{
	pixel_x = -1;
	pixel_y = 31
	},
/obj/effect/turf_decal/sandytile,
/obj/effect/turf_decal/sandytile,
/turf/open/floor/tile/whiteyellow/full,
/area/lv624/lazarus/sandtemple/garbledradio)
"um" = (
/obj/effect/ai_node,
/obj/effect/turf_decal/sandytile,
/obj/structure/platform,
/turf/open/floor/tile/whiteyellow/full,
/area/lv624/ground/sand9)
"uu" = (
/obj/effect/turf_decal/warning_stripes/thin{
	dir = 8
	},
/obj/effect/turf_decal/warning_stripes/thin{
	dir = 9
	},
/turf/open/floor/plating/ground/dirt,
/area/lv624/ground/sand9)
"uE" = (
/obj/structure/platform_decoration{
	dir = 4
	},
/turf/open/floor/plating/ground/dirt/dug,
/area/lv624/ground/sand6)
"uN" = (
/obj/effect/landmark/weed_node,
/turf/open/floor/plating/ground/dirt,
/area/lv624/ground/sand6)
"uO" = (
/obj/structure/flora/jungle/vines,
/turf/open/floor/plating/ground/dirtgrassborder/corner2{
	dir = 1
	},
/area/lv624/ground/jungle8)
"uY" = (
/obj/structure/stairs/seamless{
	dir = 4
	},
/turf/open/floor/tile/whiteyellow/full,
/area/lv624/ground/sand9)
"va" = (
/obj/structure/stairs/seamless{
	dir = 4
	},
/turf/open/floor/plating/ground/dirt,
/area/lv624/ground/sand9)
"vn" = (
/obj/structure/stairs/seamless{
	dir = 8
	},
/turf/open/floor/tile/whiteyellow/full,
/area/lv624/ground/sand9)
"vU" = (
/obj/effect/turf_decal/sandytile,
/turf/open/floor/tile/whiteyellow/full,
/area/lv624/ground/sand6)
"wv" = (
/obj/structure/platform_decoration{
	dir = 4
	},
/obj/structure/stairs/corner_seamless,
/turf/open/floor/tile/whiteyellow/full,
/area/lv624/ground/sand9)
"wB" = (
/obj/structure/flora/grass/brown,
/turf/open/liquid/water/river/autosmooth,
/area/lv624/ground/river3)
"wJ" = (
/obj/structure/stairs/seamless/platform,
/turf/open/floor/tile/whiteyellow/full,
/area/lv624/lazarus/sandtemple/garbledradio)
"xO" = (
/obj/structure/platform_decoration{
	dir = 8
	},
/turf/open/floor/plating/ground/dirt,
/area/lv624/ground/sand9)
"yu" = (
/turf/open/ground/grass/grass2,
/area/lv624/ground/jungle8)
"zx" = (
/turf/closed/gm/dense,
/area/lv624/ground/caves/rock)
"zE" = (
/turf/open/floor/plating/ground/dirtgrassborder/corner2{
	dir = 1
	},
/area/lv624/ground/jungle8)
"zG" = (
/obj/structure/showcase,
/obj/effect/turf_decal/sandytile,
/obj/effect/turf_decal/sandytile,
/obj/effect/turf_decal/sandytile,
/obj/effect/turf_decal/sandytile,
/obj/structure/flora/jungle/vines,
/turf/open/floor/plating/ground/dirt,
/area/lv624/lazarus/sandtemple/garbledradio)
"AA" = (
/obj/structure/flora/jungle/vines/heavy,
/turf/open/floor/plating/ground/dirtgrassborder/corner{
	dir = 4
	},
/area/lv624/ground/jungle8)
"AP" = (
/turf/open/floor/plating/ground/dirt,
/area/lv624/ground/sand9)
"Bi" = (
/obj/effect/turf_decal/sandytile,
/obj/effect/landmark/weed_node,
/turf/open/floor/tile/whiteyellow/full,
/area/lv624/ground/sand9)
"BH" = (
/obj/structure/stairs/seamless{
	dir = 8
	},
/turf/open/floor/plating/ground/dirt,
/area/lv624/ground/sand9)
"BI" = (
/obj/structure/showcase/six,
/obj/effect/turf_decal/sandytile,
/obj/effect/turf_decal/sandytile,
/obj/structure/platform{
	dir = 9
	},
/turf/open/floor/tile/whiteyellow/full,
/area/lv624/ground/sand9)
"BP" = (
/obj/structure/stairs/corner_seamless{
	dir = 4
	},
/turf/open/floor/plating/ground/dirt,
/area/lv624/ground/sand9)
"CB" = (
/obj/effect/turf_decal/sandytile,
/obj/effect/ai_node,
/obj/effect/turf_decal/sandytile,
/turf/open/floor/tile/whiteyellow/full,
/area/lv624/ground/sand9)
"Dk" = (
/obj/structure/flora/jungle/vines/heavy,
/turf/open/ground/grass,
/area/lv624/ground/jungle8)
"Dr" = (
/obj/structure/stairs/seamless{
	dir = 8
	},
/turf/open/floor/tile/whiteyellow/full,
/area/lv624/lazarus/sandtemple/garbledradio)
"Eu" = (
/obj/structure/flora/jungle/vines,
/turf/closed/wall/r_wall/chigusa,
/area/lv624/ground/caves/rock)
"EE" = (
/turf/closed/wall/r_wall/chigusa,
/area/lv624/ground/caves/rock)
"ES" = (
/obj/structure/platform_decoration,
/obj/structure/stairs/seamless{
	dir = 8
	},
/turf/open/floor/tile/whiteyellow/full,
/area/lv624/ground/sand9)
"Fc" = (
/obj/effect/turf_decal/sandytile,
/obj/effect/turf_decal/sandytile,
/turf/open/floor/tile/whiteyellow/full,
/area/lv624/lazarus/sandtemple/garbledradio)
"Fm" = (
/obj/structure/flora/jungle/vines{
	pixel_y = 1
	},
/turf/closed/mineral/smooth,
/area/lv624/ground/caves/rock)
"Gj" = (
/obj/structure/stairs/seamless{
	dir = 4
	},
/turf/open/floor/plating/ground/dirt,
/area/lv624/lazarus/sandtemple/garbledradio)
"GH" = (
/turf/closed/wall/r_wall/chigusa,
/area/lv624/ground/sand3)
"GR" = (
/obj/structure/stairs/seamless/platform,
/turf/open/floor/plating/ground/dirt,
/area/lv624/ground/sand9)
"GT" = (
/obj/effect/turf_decal/sandytile,
/obj/effect/ai_node,
/turf/open/floor/plating/ground/dirt,
/area/lv624/ground/sand9)
"Hq" = (
/obj/effect/turf_decal/warning_stripes/thin{
	dir = 1
	},
/turf/open/floor,
/area/lv624/ground/sand9)
"HV" = (
/obj/effect/turf_decal/sandytile,
/turf/open/floor/tile/whiteyellow/full,
/area/lv624/ground/sand9)
"HW" = (
/turf/closed/mineral/smooth,
/area/lv624/ground/caves/rock)
"If" = (
/obj/effect/turf_decal/sandytile,
/obj/structure/platform,
/turf/open/floor/tile/whiteyellow/full,
/area/lv624/ground/sand9)
"Ix" = (
/obj/structure/flora/jungle/vines,
/turf/open/floor/plating/ground/dirtgrassborder{
	dir = 1
	},
/area/lv624/ground/jungle8)
"IB" = (
/obj/effect/turf_decal/sandytile,
/obj/effect/turf_decal/sandytile,
/obj/structure/showcase/six,
/obj/structure/platform{
	dir = 5
	},
/turf/open/floor/tile/whiteyellow/full,
/area/lv624/ground/sand9)
"IU" = (
/obj/effect/turf_decal/warning_stripes/thin{
	dir = 2
	},
/obj/effect/landmark/weed_node,
/obj/effect/turf_decal/warning_stripes/thin{
	dir = 6
	},
/turf/open/floor,
/area/lv624/ground/sand9)
"JI" = (
/obj/effect/ai_node,
/turf/open/floor/plating/ground/dirt,
/area/lv624/lazarus/sandtemple/garbledradio)
"Kf" = (
/obj/structure/platform_decoration{
	dir = 8
	},
/turf/open/liquid/water/river/autosmooth,
/area/lv624/ground/sand6)
"KR" = (
/obj/effect/landmark/weed_node,
/obj/effect/ai_node,
/turf/open/floor/plating/ground/dirt,
/area/lv624/ground/sand3)
"LN" = (
/obj/effect/turf_decal/sandytile,
/obj/effect/turf_decal/sandytile,
/obj/effect/turf_decal/sandytile,
/turf/open/floor/plating/ground/dirt,
/area/lv624/lazarus/sandtemple/garbledradio)
"Mb" = (
/obj/structure/platform_decoration{
	dir = 8
	},
/obj/structure/stairs/corner_seamless{
	dir = 8
	},
/turf/open/floor/tile/whiteyellow/full,
/area/lv624/ground/sand9)
"NH" = (
/obj/structure/stairs/corner_seamless{
	dir = 1
	},
/turf/open/floor/plating/ground/dirt,
/area/lv624/ground/sand9)
"NK" = (
/turf/open/floor/plating/ground/dirt,
/area/lv624/lazarus/sandtemple/garbledradio)
"NU" = (
/obj/effect/decal/remains/xeno{
	pixel_x = 1;
	pixel_y = 31
	},
/obj/effect/turf_decal/sandytile,
/turf/open/floor/tile/whiteyellow/full,
/area/lv624/lazarus/sandtemple/garbledradio)
"Ow" = (
/obj/structure/stairs/seamless/platform{
	dir = 1
	},
/turf/open/floor/plating/ground/dirt,
/area/lv624/ground/sand9)
"Pb" = (
/obj/effect/turf_decal/sandytile,
/obj/effect/ai_node,
/turf/open/floor/tile/whiteyellow/full,
/area/lv624/lazarus/sandtemple/garbledradio)
"Pw" = (
/obj/effect/ai_node,
/turf/open/floor/plating/ground/dirt,
/area/lv624/ground/sand3)
"PR" = (
/obj/structure/flora/jungle/vines,
/turf/open/liquid/water/river/autosmooth,
/area/lv624/ground/sand6)
"PV" = (
/obj/structure/flora/grass/green,
/turf/open/liquid/water/river/autosmooth,
/area/lv624/ground/river3)
"Qi" = (
/obj/structure/showcase/six,
/obj/effect/turf_decal/sandytile,
/obj/effect/turf_decal/sandytile,
/obj/structure/platform{
	dir = 5
	},
/turf/open/floor/tile/whiteyellow/full,
/area/lv624/ground/sand9)
"Qq" = (
/obj/structure/stairs/seamless{
	dir = 8
	},
/turf/open/floor/plating/ground/dirt,
/area/lv624/lazarus/sandtemple/garbledradio)
"Qt" = (
/obj/structure/flora/jungle/vines{
	pixel_y = 1
	},
/obj/structure/flora/jungle/vines{
	pixel_y = 1
	},
/turf/open/liquid/water/river/autosmooth,
/area/lv624/ground/river3)
"Qz" = (
/obj/effect/turf_decal/sandytile,
/obj/effect/turf_decal/sandytile,
/turf/open/floor/plating/ground/dirt,
/area/lv624/ground/sand9)
"QK" = (
/obj/structure/flora/jungle/vines,
/turf/closed/wall/r_wall/chigusa,
/area/lv624/lazarus/sandtemple/garbledradio)
"QQ" = (
/turf/open/floor/plating/ground/dirtgrassborder/corner2{
	dir = 1
	},
/area/lv624/ground/river3)
"RZ" = (
/obj/structure/flora/jungle/plantbot1/alien,
/turf/open/floor/plating/ground/dirt,
/area/lv624/ground/sand9)
"Sq" = (
/obj/effect/landmark/weed_node,
/obj/effect/turf_decal/sandytile,
/turf/open/floor/tile/whiteyellow/full,
/area/lv624/ground/sand9)
"SR" = (
/obj/effect/turf_decal/sandytile,
/turf/open/floor/plating/ground/dirt,
/area/lv624/lazarus/sandtemple/garbledradio)
"Te" = (
/obj/structure/stairs/seamless{
	dir = 4
	},
/turf/open/floor/tile/whiteyellow/full,
/area/lv624/lazarus/sandtemple/garbledradio)
"Ue" = (
/obj/structure/flora/jungle/plantbot1/alien,
/turf/open/liquid/water/river/autosmooth,
/area/lv624/ground/river3)
"Vd" = (
/obj/effect/turf_decal/sandytile,
/obj/item/weapon/twohanded/spear,
/turf/open/floor/tile/whiteyellow/full,
/area/lv624/ground/sand9)
"Vj" = (
/turf/open/floor/plating/ground/dirtgrassborder/corner{
	dir = 4
	},
/area/lv624/ground/jungle8)
"VY" = (
/obj/structure/showcase,
/obj/effect/turf_decal/sandytile,
/obj/effect/turf_decal/sandytile,
/obj/effect/turf_decal/sandytile,
/turf/open/floor/plating/ground/dirt,
/area/lv624/lazarus/sandtemple/garbledradio)
"Ww" = (
/turf/open/liquid/water/river/autosmooth,
/area/lv624/ground/sand6)
"WD" = (
/obj/structure/flora/jungle/vines,
/turf/closed/mineral/smooth,
/area/lv624/ground/caves/rock)
"WO" = (
/obj/effect/turf_decal/sandytile,
/obj/effect/turf_decal/sandytile,
/turf/open/floor/plating/ground/dirt,
/area/lv624/lazarus/sandtemple/garbledradio)
"Xp" = (
/obj/effect/turf_decal/sandytile,
/obj/effect/turf_decal/sandytile,
/obj/structure/showcase/six,
/obj/structure/platform{
	dir = 9
	},
/turf/open/floor/tile/whiteyellow/full,
/area/lv624/ground/sand9)
"XN" = (
/obj/structure/flora/ausbushes/reedbush,
/turf/open/liquid/water/river/autosmooth,
/area/lv624/ground/river3)
"Ya" = (
/obj/effect/landmark/weed_node,
/turf/open/floor/plating/ground/dirt,
/area/lv624/lazarus/sandtemple/garbledradio)
"Yf" = (
/obj/structure/flora/jungle/vines{
	pixel_y = 1
	},
/obj/structure/flora/jungle/vines{
	pixel_y = 1
	},
/turf/closed/mineral/smooth,
/area/lv624/ground/caves/rock)
"Yg" = (
/obj/effect/ai_node,
/turf/open/floor/plating/ground/dirt,
/area/lv624/ground/sand6)
"YA" = (
/obj/item/clothing/suit/armor/vest/admiral,
/obj/effect/turf_decal/sandytile,
/turf/open/floor/tile/whiteyellow/full,
/area/lv624/ground/sand9)
"YR" = (
/turf/open/liquid/water/river/autosmooth,
/area/lv624/ground/river3)
"Zk" = (
/obj/effect/turf_decal/sandytile,
/turf/open/floor/tile/whiteyellow/full,
/area/lv624/lazarus/sandtemple/garbledradio)
"ZE" = (
/obj/structure/platform_decoration{
	dir = 1
	},
/obj/structure/stairs/seamless{
	dir = 4
	},
/turf/open/floor/tile/whiteyellow/full,
/area/lv624/ground/sand9)
"ZP" = (
/obj/structure/flora/jungle/vines{
	pixel_y = 1
	},
/turf/open/liquid/water/river/autosmooth,
/area/lv624/ground/river3)
"ZZ" = (
/obj/effect/turf_decal/sandytile,
/obj/effect/turf_decal/sandytile,
/obj/effect/turf_decal/sandytile,
/turf/open/floor/tile/whiteyellow/full,
/area/lv624/lazarus/sandtemple/garbledradio)

(1,1,1) = {"
Ww
Ww
Ww
bE
sb
sb
HW
HW
HW
HW
HW
HW
HW
AP
cT
AP
AP
cT
Hq
IU
AP
AP
YR
YR
"}
(2,1,1) = {"
Kf
Ww
Ww
sb
cK
sb
sb
HW
HW
HW
HW
HW
HW
HW
AP
AP
AP
AP
uu
aS
AP
AP
YR
XN
"}
(3,1,1) = {"
PR
mS
aw
Pw
sb
sb
sb
HW
HW
HW
HW
HW
HW
HW
AP
AP
fi
AP
AP
AP
AP
AP
YR
YR
"}
(4,1,1) = {"
aw
aw
iB
sb
KR
sb
GH
HW
HW
HW
HW
HW
AP
AP
AP
AP
AP
AP
AP
AP
AP
AP
YR
YR
"}
(5,1,1) = {"
aw
aw
iB
sb
sb
sb
ba
HW
HW
HW
HW
AP
AP
AP
cT
AP
AP
fi
AP
xO
AP
AP
dD
YR
"}
(6,1,1) = {"
wJ
Dr
Qq
Qq
Qq
rS
QK
QK
Eu
EE
xO
AP
AP
AP
AP
AP
Mb
BH
Xp
GR
ES
NH
dD
YR
"}
(7,1,1) = {"
NK
NK
Zk
ls
Fc
Zk
sZ
QK
zG
EE
bX
vn
vn
BH
BH
BI
oF
oF
HV
oF
oF
bU
dD
YR
"}
(8,1,1) = {"
Ya
Zk
Zk
Zk
Ya
sZ
sZ
Zk
LN
NU
YA
HV
bO
HV
kY
HV
HV
HV
HV
Sq
bO
If
dD
YR
"}
(9,1,1) = {"
NK
Pb
Zk
NK
JI
WO
NK
JI
WO
WO
Bi
Vd
HV
HV
CB
bO
HV
GT
HV
HV
HV
um
dD
YR
"}
(10,1,1) = {"
Zk
Zk
WO
NK
SR
NK
Zk
ZZ
WO
td
HV
HV
HV
Bi
dm
bO
AP
RZ
Qz
HV
HV
If
dD
YR
"}
(11,1,1) = {"
ls
NK
NK
Zk
NK
NK
sZ
QK
VY
EE
jg
uY
uY
va
va
Qi
oF
oF
HV
oF
oF
oX
dD
YR
"}
(12,1,1) = {"
px
Te
Gj
Gj
Gj
Gj
QK
QK
Eu
EE
jL
dD
dD
dD
dD
dD
wv
va
IB
Ow
ZE
BP
dD
YR
"}
(13,1,1) = {"
aw
aw
iB
aw
aw
HW
HW
HW
HW
HW
HW
dD
dD
hm
dD
dD
dD
hB
dD
jL
dD
hm
YR
YR
"}
(14,1,1) = {"
aw
aw
iB
aw
aw
aw
iB
HW
HW
HW
Fm
YR
YR
YR
YR
dD
dD
dD
dD
kA
YR
YR
YR
YR
"}
(15,1,1) = {"
aw
aw
vU
aw
aw
aw
aw
HW
HW
WD
WD
ZP
YR
YR
YR
YR
YR
YR
YR
YR
YR
YR
YR
YR
"}
(16,1,1) = {"
uE
aw
aw
aw
uN
aw
aw
HW
Fm
Fm
ZP
YR
YR
Ue
YR
oo
YR
YR
YR
YR
YR
YR
YR
YR
"}
(17,1,1) = {"
HW
aw
aw
aw
Yg
aw
HW
Yf
Yf
ZP
YR
PV
YR
YR
YR
YR
YR
XN
YR
YR
YR
XN
YR
YR
"}
(18,1,1) = {"
HW
uN
aw
aw
aw
HW
HW
Fm
Qt
Ue
ZP
YR
YR
YR
YR
YR
YR
YR
YR
YR
YR
YR
YR
uO
"}
(19,1,1) = {"
qf
aw
aw
aw
uN
WD
zx
Fm
ZP
ZP
YR
YR
XN
YR
YR
Ue
YR
YR
YR
YR
YR
YR
YR
Ix
"}
(20,1,1) = {"
qf
aw
aw
aw
aw
HW
zx
zx
er
ZP
YR
YR
YR
YR
YR
YR
YR
YR
wB
YR
YR
YR
zE
AA
"}
(21,1,1) = {"
qf
aw
aw
aw
HW
HW
HW
Fm
bt
ZP
Ue
YR
YR
XN
YR
YR
Ue
YR
YR
YR
YR
zE
Vj
yu
"}
(22,1,1) = {"
qf
qf
HW
HW
HW
HW
HW
Fm
zx
ZP
YR
YR
YR
YR
YR
YR
YR
YR
YR
YR
QQ
Vj
lD
Dk
"}
