//MAP CONVERTED BY dmm2tgm.py THIS HEADER COMMENT PREVENTS RECONVERSION, DO NOT REMOVE
"aL" = (
/obj/structure/desertdam/decals/road{
	dir = 4;
	pixel_x = 14
	},
/obj/structure/window/reinforced/toughened{
	dir = 4
	},
/obj/effect/turf_decal/trimline/yellow/warning,
/turf/open/floor/mainship/red/full,
/area/mainship/roomba_stadium)
"aP" = (
/obj/structure/bed/chair/sofa/corsat/verticaltop,
/obj/structure/platform/metalplatform{
	dir = 1
	},
/turf/open/floor/mainship/red/full,
/area/mainship/roomba_stadium)
"bk" = (
/obj/structure/bed/chair/sofa/corsat/verticaltop,
/turf/open/floor/plating/ground/concrete,
/area/mainship/roomba_stadium)
"bE" = (
/turf/open/floor/mainship/terragov/north{
	dir = 6
	},
/area/mainship/roomba_stadium)
"bO" = (
/obj/structure/platform/metalplatform,
/turf/open/floor/plating/ground/concrete,
/area/mainship/roomba_stadium)
"bX" = (
/obj/machinery/vending/boozeomat,
/turf/open/floor/plating/ground/concrete,
/area/mainship/roomba_stadium)
"cH" = (
/obj/effect/landmark/patrol_point{
	id = "TGMC_24";
	name = "TGMC exit point 24"
	},
/turf/open/floor/plating/ground/concrete,
/area/mainship/roomba_stadium)
"dA" = (
/obj/effect/turf_decal/siding{
	dir = 5
	},
/obj/structure/window/reinforced/toughened{
	dir = 4
	},
/turf/open/floor/mainship/som/nw,
/area/mainship/roomba_stadium)
"dS" = (
/obj/structures/win,
/turf/open/floor/plating/ground/concrete,
/area/mainship/roomba_stadium)
"eD" = (
/turf/closed/mineral/smooth/indestructible,
/area/lv624/lazarus/console)
"eY" = (
/obj/effect/landmark/patrol_point{
	id = "TGMC_11";
	name = "TGMC exit point 11"
	},
/turf/open/floor/plating/ground/concrete,
/area/mainship/roomba_stadium)
"eZ" = (
/obj/effect/forcefield,
/turf/open/floor/plating/ground/concrete,
/area/mainship/roomba_stadium)
"fb" = (
/obj/effect/landmark/patrol_point{
	id = "SOM_13";
	name = "SOM exit point 13"
	},
/turf/open/floor/plating/ground/concrete,
/area/mainship/roomba_stadium)
"fv" = (
/obj/effect/landmark/patrol_point{
	id = "SOM_24";
	name = "SOM exit point 24"
	},
/turf/open/floor/plating/ground/concrete,
/area/mainship/roomba_stadium)
"fz" = (
/obj/effect/landmark/patrol_point{
	id = "TGMC_14";
	name = "TGMC exit point 14"
	},
/turf/open/floor/plating/ground/concrete,
/area/mainship/roomba_stadium)
"fI" = (
/obj/effect/landmark/patrol_point{
	id = "TGMC_12";
	name = "TGMC exit point 12"
	},
/turf/open/floor/plating/ground/concrete,
/area/mainship/roomba_stadium)
"gy" = (
/obj/effect/landmark/patrol_point{
	id = "SOM_11";
	name = "SOM exit point 11"
	},
/turf/open/floor/plating/ground/concrete,
/area/mainship/roomba_stadium)
"gC" = (
/obj/effect/landmark/patrol_point{
	id = "SOM_12";
	name = "SOM exit point 12"
	},
/turf/open/floor/plating/ground/concrete,
/area/mainship/roomba_stadium)
"gU" = (
/obj/item/binoculars,
/turf/open/floor/plating/ground/concrete,
/area/mainship/roomba_stadium)
"hx" = (
/obj/effect/turf_decal/siding{
	dir = 6
	},
/obj/structure/window/reinforced/toughened{
	dir = 4
	},
/turf/open/floor/mainship/som/sw,
/area/mainship/roomba_stadium)
"hy" = (
/obj/structure/bed/chair/sofa/corsat/verticaltop,
/obj/structure/platform/metalplatform{
	dir = 1
	},
/turf/open/floor/mainship/blue/full,
/area/mainship/roomba_stadium)
"ie" = (
/obj/structure/desertdam/decals/road{
	dir = 4;
	pixel_x = 14
	},
/obj/structure/window/reinforced/toughened{
	dir = 4
	},
/obj/machinery/roomba/indestructible,
/turf/open/floor/plating/ground/concrete,
/area/mainship/roomba_stadium)
"kG" = (
/obj/structure/window/reinforced/toughened{
	dir = 4
	},
/turf/open/floor/mainship/terragov/north{
	dir = 8
	},
/area/mainship/roomba_stadium)
"kZ" = (
/obj/structure/platform/metalplatform{
	dir = 1
	},
/turf/open/floor/plating/ground/concrete,
/area/mainship/roomba_stadium)
"lo" = (
/obj/structure/bed/chair/sofa/corsat/verticalmiddle,
/turf/open/floor/mainship/red/full,
/area/mainship/roomba_stadium)
"lr" = (
/obj/structure/desertdam/decals/road{
	dir = 4;
	pixel_x = 14
	},
/obj/structure/window/reinforced/toughened{
	dir = 4
	},
/turf/open/floor/plating/ground/concrete,
/area/mainship/roomba_stadium)
"lD" = (
/obj/structure/bed/chair/sofa/corsat/verticalsouth,
/turf/open/floor/plating/ground/concrete,
/area/mainship/roomba_stadium)
"lL" = (
/turf/open/floor/mainship/red/full,
/area/mainship/roomba_stadium)
"md" = (
/obj/machinery/vending/snack,
/turf/open/floor/plating/ground/concrete,
/area/mainship/roomba_stadium)
"mC" = (
/obj/effect/turf_decal/trimline/yellow/warning,
/turf/open/floor/mainship/blue/full,
/area/mainship/roomba_stadium)
"mG" = (
/obj/structure/bed/chair/sofa/corsat/verticaltop,
/turf/open/floor/mainship/red/full,
/area/mainship/roomba_stadium)
"pc" = (
/obj/effect/landmark/patrol_point{
	id = "TGMC_13";
	name = "TGMC exit point 13"
	},
/turf/open/floor/plating/ground/concrete,
/area/mainship/roomba_stadium)
"pu" = (
/obj/structure/window/reinforced/toughened{
	dir = 4
	},
/turf/open/floor/mainship/terragov/north{
	dir = 1
	},
/area/mainship/roomba_stadium)
"qu" = (
/turf/closed/mineral/smooth/indestructible,
/area/mainship/roomba_stadium)
"rp" = (
/obj/effect/landmark/patrol_point{
	id = "SOM_22";
	name = "SOM exit point 22"
	},
/turf/open/floor/plating/ground/concrete,
/area/mainship/roomba_stadium)
"sA" = (
/obj/effect/landmark/patrol_point{
	id = "TGMC_21";
	name = "TGMC exit point 21"
	},
/turf/open/floor/plating/ground/concrete,
/area/mainship/roomba_stadium)
"sK" = (
/obj/structure/platform/metalplatform{
	dir = 4
	},
/turf/open/floor/mainship/red/full,
/area/mainship/roomba_stadium)
"tH" = (
/obj/structure/bed/chair/sofa/corsat/verticalsouth,
/obj/structure/platform/metalplatform,
/turf/open/floor/mainship/red/full,
/area/mainship/roomba_stadium)
"tP" = (
/obj/structure/window/reinforced/toughened{
	dir = 4
	},
/turf/open/floor/mainship/terragov/north,
/area/mainship/roomba_stadium)
"uT" = (
/obj/effect/forcefield,
/obj/machinery/door/poddoor/timed_late/containment{
	dir = 1
	},
/turf/open/floor/plating/ground/concrete,
/area/mainship/roomba_stadium)
"vB" = (
/obj/machinery/door/poddoor/timed_late/containment{
	dir = 1
	},
/turf/open/floor/plating/ground/concrete,
/area/mainship/roomba_stadium)
"wy" = (
/obj/structure/desertdam/decals/road{
	dir = 4;
	pixel_x = 14
	},
/obj/structure/window/reinforced/toughened{
	dir = 4
	},
/obj/structures/win,
/turf/open/floor/plating/ground/concrete,
/area/mainship/roomba_stadium)
"yf" = (
/obj/effect/landmark/patrol_point{
	id = "TGMC_23";
	name = "TGMC exit point 23"
	},
/turf/open/floor/plating/ground/concrete,
/area/mainship/roomba_stadium)
"yC" = (
/obj/structure/bed/chair/sofa/corsat/verticalmiddle,
/turf/open/floor/mainship/blue/full,
/area/mainship/roomba_stadium)
"yG" = (
/turf/open/floor/plating/ground/concrete,
/area/mainship/roomba_stadium)
"zy" = (
/obj/machinery/roomba/valhalla,
/turf/open/floor/plating/ground/concrete,
/area/mainship/roomba_stadium)
"Ah" = (
/obj/machinery/telecomms/relay/preset/telecomms,
/turf/open/floor/plating/icefloor,
/area/lv624/lazarus/console)
"Bb" = (
/obj/effect/turf_decal/siding{
	dir = 10
	},
/obj/structure/window/reinforced/toughened{
	dir = 4
	},
/turf/open/floor/mainship/som/se,
/area/mainship/roomba_stadium)
"By" = (
/obj/effect/landmark/patrol_point{
	id = "SOM_14";
	name = "SOM exit point 14"
	},
/turf/open/floor/plating/ground/concrete,
/area/mainship/roomba_stadium)
"CW" = (
/obj/machinery/vending/sovietsoda,
/turf/open/floor/plating/ground/concrete,
/area/mainship/roomba_stadium)
"Ds" = (
/obj/effect/landmark/patrol_point{
	id = "TGMC_22";
	name = "TGMC exit point 22"
	},
/turf/open/floor/plating/ground/concrete,
/area/mainship/roomba_stadium)
"Dz" = (
/obj/structure/desertdam/decals/road{
	dir = 4;
	pixel_x = 14
	},
/obj/structure/window/reinforced/toughened{
	dir = 4
	},
/obj/machinery/door/poddoor/timed_late/containment{
	dir = 1
	},
/turf/open/floor/plating/ground/concrete,
/area/mainship/roomba_stadium)
"EK" = (
/obj/structure/desertdam/decals/road{
	dir = 4;
	pixel_x = 14
	},
/obj/structure/window/reinforced/toughened{
	dir = 4
	},
/obj/effect/turf_decal/trimline/yellow/warning,
/turf/open/floor/mainship/blue/full,
/area/mainship/roomba_stadium)
"EP" = (
/turf/open/floor/mainship/terragov/north{
	dir = 4
	},
/area/mainship/roomba_stadium)
"Ff" = (
/obj/structure/bed/chair/sofa/corsat/verticaltop,
/turf/open/floor/mainship/blue/full,
/area/mainship/roomba_stadium)
"Gm" = (
/obj/structure/desertdam/decals/road{
	dir = 4;
	pixel_x = 14
	},
/obj/structure/window/reinforced/toughened{
	dir = 4
	},
/obj/effect/forcefield,
/turf/open/floor/plating/ground/concrete,
/area/mainship/roomba_stadium)
"GH" = (
/obj/structure/window/reinforced/toughened{
	dir = 4
	},
/turf/open/floor/mainship/terragov/north{
	dir = 10
	},
/area/mainship/roomba_stadium)
"GI" = (
/turf/open/space/basic,
/area/mainship/roomba_stadium)
"Hh" = (
/obj/effect/landmark/patrol_point{
	id = "SOM_21";
	name = "SOM exit point 21"
	},
/turf/open/floor/plating/ground/concrete,
/area/mainship/roomba_stadium)
"JQ" = (
/obj/structure/platform/metalplatform{
	dir = 8
	},
/turf/open/floor/mainship/blue/full,
/area/mainship/roomba_stadium)
"JX" = (
/obj/structure/bed/chair/sofa/corsat/verticalsouth,
/obj/structure/platform/metalplatform,
/turf/open/floor/mainship/blue/full,
/area/mainship/roomba_stadium)
"Ky" = (
/obj/structure/desertdam/decals/road{
	dir = 4;
	pixel_x = 14
	},
/obj/structure/window/reinforced/toughened{
	dir = 4
	},
/obj/structures/win/som,
/turf/open/floor/plating/ground/concrete,
/area/mainship/roomba_stadium)
"LA" = (
/obj/structure/bed/chair/sofa/corsat/verticalmiddle,
/turf/open/floor/plating/ground/concrete,
/area/mainship/roomba_stadium)
"LU" = (
/obj/effect/turf_decal/siding{
	dir = 9
	},
/obj/structure/window/reinforced/toughened{
	dir = 4
	},
/turf/open/floor/mainship/som/ne,
/area/mainship/roomba_stadium)
"Ow" = (
/obj/effect/turf_decal/siding{
	dir = 1
	},
/obj/structure/window/reinforced/toughened{
	dir = 4
	},
/turf/open/floor/mainship/som,
/area/mainship/roomba_stadium)
"Rq" = (
/turf/open/floor/mainship/terragov/north{
	dir = 5
	},
/area/mainship/roomba_stadium)
"Rr" = (
/obj/machinery/vending/cola,
/turf/open/floor/plating/ground/concrete,
/area/mainship/roomba_stadium)
"Uq" = (
/obj/structure/window/reinforced/toughened{
	dir = 4
	},
/turf/open/floor/mainship/terragov/north{
	dir = 9
	},
/area/mainship/roomba_stadium)
"Vp" = (
/turf/open/floor/mainship/blue/full,
/area/mainship/roomba_stadium)
"Ws" = (
/obj/effect/turf_decal/siding,
/obj/structure/window/reinforced/toughened{
	dir = 4
	},
/turf/open/floor/mainship/som/s,
/area/mainship/roomba_stadium)
"Yd" = (
/obj/effect/landmark/patrol_point{
	id = "SOM_23";
	name = "SOM exit point 23"
	},
/turf/open/floor/plating/ground/concrete,
/area/mainship/roomba_stadium)
"Yq" = (
/obj/structure/window/reinforced/toughened{
	dir = 4
	},
/turf/open/floor/mainship/terragov{
	dir = 1
	},
/area/mainship/roomba_stadium)

(1,1,1) = {"
GI
GI
GI
GI
GI
GI
GI
GI
eD
eD
eD
qu
qu
qu
qu
qu
qu
qu
qu
qu
qu
qu
qu
qu
qu
qu
qu
qu
qu
qu
qu
qu
qu
qu
qu
qu
qu
qu
qu
qu
qu
qu
qu
qu
qu
qu
qu
qu
qu
qu
qu
qu
qu
qu
qu
qu
qu
qu
qu
qu
qu
qu
qu
qu
qu
qu
qu
qu
qu
qu
qu
qu
qu
qu
qu
qu
qu
qu
qu
qu
qu
qu
qu
qu
qu
qu
qu
qu
qu
qu
qu
qu
qu
qu
qu
qu
qu
qu
qu
qu
qu
qu
qu
qu
qu
qu
qu
qu
qu
qu
"}
(2,1,1) = {"
GI
GI
GI
GI
GI
GI
GI
GI
eD
Ah
eD
yG
yG
yG
yG
yG
yG
yG
yG
yG
yG
yG
yG
yG
yG
yG
yG
yG
yG
yG
yG
yG
yG
yG
yG
yG
yG
yG
yG
yG
yG
yG
yG
yG
yG
yG
yG
yG
yG
yG
yG
yG
yG
yG
yG
yG
yG
yG
yG
yG
yG
yG
yG
yG
yG
yG
yG
yG
yG
yG
yG
yG
yG
yG
yG
yG
yG
yG
yG
yG
yG
yG
yG
yG
yG
yG
yG
yG
yG
yG
yG
yG
yG
yG
yG
yG
yG
yG
yG
yG
yG
yG
yG
yG
yG
yG
gy
fv
yG
qu
"}
(3,1,1) = {"
GI
GI
GI
GI
GI
GI
GI
GI
eD
eD
eD
yG
yG
yG
yG
yG
yG
yG
yG
yG
yG
yG
yG
yG
yG
yG
yG
yG
yG
yG
yG
yG
yG
yG
yG
yG
yG
yG
yG
yG
yG
yG
yG
yG
yG
yG
yG
yG
yG
yG
yG
yG
yG
yG
yG
yG
yG
yG
yG
yG
yG
yG
yG
yG
yG
yG
yG
yG
yG
yG
yG
yG
yG
yG
yG
yG
yG
yG
yG
yG
yG
yG
yG
yG
yG
yG
yG
yG
yG
yG
yG
yG
yG
yG
yG
yG
yG
yG
yG
yG
yG
yG
yG
yG
yG
yG
gC
By
rp
qu
"}
(4,1,1) = {"
GI
yG
yG
yG
yG
yG
yG
yG
yG
GI
qu
yG
yG
yG
CW
bX
yG
yG
yG
yG
yG
yG
CW
bX
yG
yG
yG
yG
yG
yG
CW
bX
yG
yG
yG
yG
yG
yG
CW
bX
yG
yG
yG
yG
yG
yG
CW
bX
yG
yG
yG
yG
yG
yG
CW
bX
yG
yG
yG
yG
yG
yG
CW
bX
yG
yG
yG
yG
yG
yG
CW
bX
yG
yG
yG
yG
yG
yG
CW
bX
yG
yG
yG
yG
yG
yG
CW
bX
yG
yG
yG
yG
yG
yG
CW
bX
yG
yG
yG
yG
yG
yG
CW
bX
yG
yG
fb
Hh
Yd
qu
"}
(5,1,1) = {"
GI
yG
GI
GI
yG
GI
GI
GI
GI
GI
qu
yG
yG
yG
Rr
md
yG
yG
yG
yG
yG
yG
Rr
md
yG
yG
yG
yG
yG
yG
Rr
md
yG
yG
yG
yG
yG
yG
Rr
md
yG
yG
yG
yG
yG
yG
Rr
md
yG
yG
yG
yG
yG
yG
Rr
md
yG
yG
yG
yG
yG
yG
Rr
md
yG
yG
yG
yG
yG
yG
Rr
md
yG
yG
yG
yG
yG
yG
Rr
md
yG
yG
yG
yG
yG
yG
Rr
md
yG
yG
yG
yG
yG
yG
Rr
md
yG
yG
yG
yG
yG
yG
Rr
md
yG
yG
yG
yG
yG
qu
"}
(6,1,1) = {"
GI
yG
GI
GI
yG
GI
GI
GI
GI
GI
qu
yG
yG
yG
yG
yG
yG
yG
yG
yG
yG
yG
yG
yG
yG
yG
yG
yG
yG
yG
yG
yG
yG
yG
yG
yG
yG
yG
yG
yG
yG
yG
yG
yG
yG
yG
yG
yG
yG
yG
yG
yG
yG
yG
yG
yG
yG
yG
yG
yG
yG
yG
yG
yG
yG
yG
yG
yG
yG
yG
yG
yG
yG
yG
yG
yG
yG
yG
yG
yG
yG
yG
yG
yG
yG
yG
yG
yG
yG
yG
yG
yG
yG
yG
yG
yG
yG
yG
yG
yG
yG
yG
yG
yG
yG
yG
yG
yG
yG
qu
"}
(7,1,1) = {"
GI
yG
GI
GI
yG
GI
GI
GI
GI
GI
qu
bk
LA
lD
yG
yG
bk
LA
LA
LA
LA
lD
yG
yG
bk
LA
LA
LA
LA
lD
yG
yG
bk
LA
LA
LA
LA
lD
yG
yG
bk
LA
LA
LA
LA
lD
yG
yG
bk
LA
LA
LA
LA
lD
yG
yG
bk
LA
LA
LA
LA
lD
yG
yG
bk
LA
LA
LA
LA
lD
yG
yG
bk
LA
LA
LA
LA
lD
yG
yG
bk
LA
LA
LA
LA
lD
yG
yG
bk
LA
LA
LA
LA
lD
yG
yG
bk
LA
LA
LA
LA
lD
yG
yG
bk
LA
lD
yG
yG
qu
"}
(8,1,1) = {"
GI
GI
GI
GI
GI
GI
GI
GI
GI
GI
qu
gU
gU
gU
gU
gU
gU
gU
gU
gU
gU
gU
gU
gU
gU
gU
gU
gU
gU
gU
gU
gU
gU
gU
gU
gU
gU
gU
gU
gU
gU
gU
gU
gU
gU
gU
gU
gU
gU
gU
gU
gU
gU
gU
gU
gU
gU
gU
gU
gU
gU
gU
gU
gU
gU
gU
gU
gU
gU
gU
gU
gU
gU
gU
gU
gU
gU
gU
gU
gU
gU
gU
gU
gU
gU
gU
gU
gU
gU
gU
gU
gU
gU
gU
gU
gU
gU
gU
gU
gU
gU
gU
gU
gU
gU
gU
gU
gU
gU
qu
"}
(9,1,1) = {"
GI
yG
yG
yG
yG
yG
yG
yG
GI
GI
qu
yG
yG
bO
yG
yG
kZ
yG
yG
yG
yG
bO
yG
yG
kZ
yG
yG
yG
yG
bO
yG
yG
kZ
yG
yG
yG
yG
bO
yG
yG
kZ
yG
yG
yG
yG
bO
yG
yG
kZ
yG
yG
yG
yG
bO
yG
yG
kZ
yG
yG
yG
yG
bO
yG
yG
kZ
yG
yG
yG
yG
bO
yG
yG
kZ
yG
yG
yG
yG
bO
yG
yG
kZ
yG
yG
yG
yG
bO
yG
yG
kZ
yG
yG
yG
yG
bO
yG
yG
kZ
yG
yG
yG
yG
bO
yG
yG
kZ
yG
bO
yG
yG
qu
"}
(10,1,1) = {"
GI
GI
GI
GI
GI
GI
GI
GI
yG
GI
qu
mG
lo
tH
lL
lL
aP
lo
lo
lo
lo
tH
lL
lL
aP
lo
lo
lo
lo
tH
lL
lL
aP
lo
lo
lo
lo
tH
lL
lL
aP
lo
lo
lo
lo
tH
lL
lL
aP
lo
lo
lo
lo
tH
lL
lL
aP
lo
lo
lo
lo
tH
lL
lL
aP
lo
lo
lo
lo
tH
lL
lL
aP
lo
lo
lo
lo
tH
lL
lL
aP
lo
lo
lo
lo
tH
lL
lL
aP
lo
lo
lo
lo
tH
lL
lL
aP
lo
lo
lo
lo
tH
lL
lL
aP
lo
tH
lL
lL
qu
"}
(11,1,1) = {"
GI
GI
GI
GI
GI
GI
GI
GI
yG
GI
qu
sK
sK
sK
sK
sK
sK
sK
sK
sK
sK
sK
sK
sK
sK
sK
sK
sK
sK
sK
sK
sK
sK
sK
sK
sK
sK
sK
sK
sK
sK
sK
sK
sK
sK
sK
sK
sK
sK
sK
sK
sK
sK
sK
sK
sK
sK
sK
sK
sK
sK
sK
sK
sK
sK
sK
sK
sK
sK
sK
sK
sK
sK
sK
sK
sK
sK
sK
sK
sK
sK
sK
sK
sK
sK
sK
sK
sK
sK
sK
sK
sK
sK
sK
sK
sK
sK
sK
sK
sK
sK
sK
sK
sK
sK
sK
sK
sK
sK
qu
"}
(12,1,1) = {"
GI
GI
GI
GI
GI
GI
GI
GI
yG
GI
qu
eZ
eZ
eZ
eZ
eZ
eZ
eZ
eZ
eZ
eZ
eZ
eZ
eZ
eZ
eZ
eZ
eZ
eZ
eZ
eZ
eZ
eZ
eZ
eZ
eZ
eZ
eZ
eZ
eZ
eZ
eZ
eZ
eZ
eZ
eZ
eZ
eZ
eZ
eZ
eZ
eZ
eZ
eZ
eZ
eZ
eZ
eZ
eZ
eZ
eZ
eZ
eZ
eZ
eZ
eZ
eZ
eZ
eZ
eZ
eZ
eZ
eZ
eZ
eZ
eZ
eZ
eZ
eZ
eZ
eZ
eZ
eZ
eZ
eZ
eZ
eZ
eZ
eZ
eZ
eZ
eZ
eZ
eZ
eZ
eZ
eZ
eZ
eZ
eZ
eZ
eZ
eZ
eZ
eZ
eZ
uT
eZ
eZ
qu
"}
(13,1,1) = {"
GI
yG
yG
yG
yG
yG
yG
yG
GI
GI
qu
eZ
Ky
aL
lr
LU
Bb
lr
lr
lr
lr
lr
lr
lr
lr
lr
lr
lr
lr
lr
lr
lr
lr
lr
lr
lr
lr
lr
lr
lr
lr
lr
lr
lr
lr
lr
lr
lr
lr
lr
lr
lr
lr
lr
lr
lr
lr
lr
lr
lr
lr
lr
lr
lr
lr
lr
lr
lr
lr
lr
lr
lr
lr
lr
lr
lr
lr
lr
lr
lr
lr
lr
lr
lr
lr
lr
lr
lr
lr
lr
lr
lr
lr
lr
lr
lr
lr
lr
lr
lr
lr
lr
lr
LU
Bb
lr
Dz
ie
Gm
qu
"}
(14,1,1) = {"
GI
GI
GI
GI
GI
GI
GI
GI
GI
GI
qu
eZ
Ky
aL
lr
Ow
Ws
lr
lr
lr
lr
lr
lr
lr
lr
lr
lr
lr
lr
lr
lr
lr
lr
lr
lr
lr
lr
lr
lr
lr
lr
lr
lr
lr
lr
lr
lr
lr
lr
lr
lr
lr
lr
lr
lr
lr
lr
lr
lr
lr
lr
lr
lr
lr
lr
lr
lr
lr
lr
lr
lr
lr
lr
lr
lr
lr
lr
lr
lr
lr
lr
lr
lr
lr
lr
lr
lr
lr
lr
lr
lr
lr
lr
lr
lr
lr
lr
lr
lr
lr
lr
lr
lr
Ow
Ws
lr
Dz
ie
Gm
qu
"}
(15,1,1) = {"
GI
GI
yG
yG
yG
yG
yG
yG
GI
GI
qu
eZ
Ky
aL
lr
dA
hx
lr
lr
lr
lr
lr
lr
lr
lr
lr
lr
lr
lr
lr
lr
lr
lr
lr
lr
lr
lr
lr
lr
lr
lr
lr
lr
lr
lr
lr
lr
lr
lr
lr
lr
lr
lr
lr
lr
lr
lr
lr
lr
lr
lr
lr
lr
lr
lr
lr
lr
lr
lr
lr
lr
lr
lr
lr
lr
lr
lr
lr
lr
lr
lr
lr
lr
lr
lr
lr
lr
lr
lr
lr
lr
lr
lr
lr
lr
lr
lr
lr
lr
lr
lr
lr
lr
dA
hx
lr
Dz
ie
Gm
qu
"}
(16,1,1) = {"
GI
yG
GI
GI
GI
GI
GI
GI
yG
GI
qu
eZ
wy
EK
lr
Uq
kG
GH
lr
lr
lr
lr
lr
lr
lr
lr
lr
lr
lr
lr
lr
lr
lr
lr
lr
lr
lr
lr
lr
lr
lr
lr
lr
lr
lr
lr
lr
lr
lr
lr
lr
lr
lr
lr
lr
lr
lr
lr
lr
lr
lr
lr
lr
lr
lr
lr
lr
lr
lr
lr
lr
lr
lr
lr
lr
lr
lr
lr
lr
lr
lr
lr
lr
lr
lr
lr
lr
lr
lr
lr
lr
lr
lr
lr
lr
lr
lr
lr
lr
lr
lr
lr
lr
Uq
kG
GH
Dz
ie
Gm
qu
"}
(17,1,1) = {"
GI
yG
GI
GI
GI
GI
GI
GI
yG
GI
qu
eZ
wy
EK
lr
pu
Yq
tP
lr
lr
lr
lr
lr
lr
lr
lr
lr
lr
lr
lr
lr
lr
lr
lr
lr
lr
lr
lr
lr
lr
lr
lr
lr
lr
lr
lr
lr
lr
lr
lr
lr
lr
lr
lr
lr
lr
lr
lr
lr
lr
lr
lr
lr
lr
lr
lr
lr
lr
lr
lr
lr
lr
lr
lr
lr
lr
lr
lr
lr
lr
lr
lr
lr
lr
lr
lr
lr
lr
lr
lr
lr
lr
lr
lr
lr
lr
lr
lr
lr
lr
lr
lr
lr
pu
Yq
tP
Dz
ie
Gm
qu
"}
(18,1,1) = {"
GI
yG
GI
GI
GI
GI
GI
GI
yG
GI
qu
eZ
dS
mC
yG
Rq
EP
bE
yG
yG
yG
yG
yG
yG
yG
yG
yG
yG
yG
yG
yG
yG
yG
yG
yG
yG
yG
yG
yG
yG
yG
yG
yG
yG
yG
yG
yG
yG
yG
yG
yG
yG
yG
yG
yG
yG
yG
yG
yG
yG
yG
yG
yG
yG
yG
yG
yG
yG
yG
yG
yG
yG
yG
yG
yG
yG
yG
yG
yG
yG
yG
yG
yG
yG
yG
yG
yG
yG
yG
yG
yG
yG
yG
yG
yG
yG
yG
yG
yG
yG
yG
yG
yG
Rq
EP
bE
vB
zy
eZ
qu
"}
(19,1,1) = {"
GI
yG
GI
GI
GI
GI
GI
GI
yG
GI
qu
eZ
eZ
eZ
eZ
eZ
eZ
eZ
eZ
eZ
eZ
eZ
eZ
eZ
eZ
eZ
eZ
eZ
eZ
eZ
eZ
eZ
eZ
eZ
eZ
eZ
eZ
eZ
eZ
eZ
eZ
eZ
eZ
eZ
eZ
eZ
eZ
eZ
eZ
eZ
eZ
eZ
eZ
eZ
eZ
eZ
eZ
eZ
eZ
eZ
eZ
eZ
eZ
eZ
eZ
eZ
eZ
eZ
eZ
eZ
eZ
eZ
eZ
eZ
eZ
eZ
eZ
eZ
eZ
eZ
eZ
eZ
eZ
eZ
eZ
eZ
eZ
eZ
eZ
eZ
eZ
eZ
eZ
eZ
eZ
eZ
eZ
eZ
eZ
eZ
eZ
eZ
eZ
eZ
eZ
eZ
uT
eZ
eZ
qu
"}
(20,1,1) = {"
GI
yG
GI
GI
GI
GI
GI
GI
yG
GI
qu
JQ
JQ
JQ
JQ
JQ
JQ
JQ
JQ
JQ
JQ
JQ
JQ
JQ
JQ
JQ
JQ
JQ
JQ
JQ
JQ
JQ
JQ
JQ
JQ
JQ
JQ
JQ
JQ
JQ
JQ
JQ
JQ
JQ
JQ
JQ
JQ
JQ
JQ
JQ
JQ
JQ
JQ
JQ
JQ
JQ
JQ
JQ
JQ
JQ
JQ
JQ
JQ
JQ
JQ
JQ
JQ
JQ
JQ
JQ
JQ
JQ
JQ
JQ
JQ
JQ
JQ
JQ
JQ
JQ
JQ
JQ
JQ
JQ
JQ
JQ
JQ
JQ
JQ
JQ
JQ
JQ
JQ
JQ
JQ
JQ
JQ
JQ
JQ
JQ
JQ
JQ
JQ
JQ
JQ
JQ
JQ
JQ
JQ
qu
"}
(21,1,1) = {"
GI
GI
GI
GI
GI
GI
GI
GI
GI
GI
qu
Ff
yC
JX
Vp
Vp
hy
yC
yC
yC
yC
JX
Vp
Vp
hy
yC
yC
yC
yC
JX
Vp
Vp
hy
yC
yC
yC
yC
JX
Vp
Vp
hy
yC
yC
yC
yC
JX
Vp
Vp
hy
yC
yC
yC
yC
JX
Vp
Vp
hy
yC
yC
yC
yC
JX
Vp
Vp
hy
yC
yC
yC
yC
JX
Vp
Vp
hy
yC
yC
yC
yC
JX
Vp
Vp
hy
yC
yC
yC
yC
JX
Vp
Vp
hy
yC
yC
yC
yC
JX
Vp
Vp
hy
yC
yC
yC
yC
JX
Vp
Vp
hy
yC
JX
Vp
Vp
qu
"}
(22,1,1) = {"
GI
yG
yG
yG
yG
yG
yG
yG
yG
GI
qu
yG
yG
bO
yG
yG
kZ
yG
yG
yG
yG
bO
yG
yG
kZ
yG
yG
yG
yG
bO
yG
yG
kZ
yG
yG
yG
yG
bO
yG
yG
kZ
yG
yG
yG
yG
bO
yG
yG
kZ
yG
yG
yG
yG
bO
yG
yG
kZ
yG
yG
yG
yG
bO
yG
yG
kZ
yG
yG
yG
yG
bO
yG
yG
kZ
yG
yG
yG
yG
bO
yG
yG
kZ
yG
yG
yG
yG
bO
yG
yG
kZ
yG
yG
yG
yG
bO
yG
yG
kZ
yG
yG
yG
yG
bO
yG
yG
kZ
yG
bO
yG
yG
qu
"}
(23,1,1) = {"
GI
GI
GI
GI
yG
GI
GI
GI
GI
GI
qu
gU
gU
gU
gU
gU
gU
gU
gU
gU
gU
gU
gU
gU
gU
gU
gU
gU
gU
gU
gU
gU
gU
gU
gU
gU
gU
gU
gU
gU
gU
gU
gU
gU
gU
gU
gU
gU
gU
gU
gU
gU
gU
gU
gU
gU
gU
gU
gU
gU
gU
gU
gU
gU
gU
gU
gU
gU
gU
gU
gU
gU
gU
gU
gU
gU
gU
gU
gU
gU
gU
gU
gU
gU
gU
gU
gU
gU
gU
gU
gU
gU
gU
gU
gU
gU
gU
gU
gU
gU
gU
gU
gU
gU
gU
gU
gU
gU
gU
qu
"}
(24,1,1) = {"
GI
GI
GI
yG
GI
yG
GI
GI
GI
GI
qu
bk
LA
lD
yG
yG
bk
LA
LA
LA
LA
lD
yG
yG
bk
LA
LA
LA
LA
lD
yG
yG
bk
LA
LA
LA
LA
lD
yG
yG
bk
LA
LA
LA
LA
lD
yG
yG
bk
LA
LA
LA
LA
lD
yG
yG
bk
LA
LA
LA
LA
lD
yG
yG
bk
LA
LA
LA
LA
lD
yG
yG
bk
LA
LA
LA
LA
lD
yG
yG
bk
LA
LA
LA
LA
lD
yG
yG
bk
LA
LA
LA
LA
lD
yG
yG
bk
LA
LA
LA
LA
lD
yG
yG
bk
LA
lD
yG
yG
qu
"}
(25,1,1) = {"
GI
GI
yG
GI
GI
GI
yG
GI
GI
GI
qu
yG
yG
yG
yG
yG
yG
yG
yG
yG
yG
yG
yG
yG
yG
yG
yG
yG
yG
yG
yG
yG
yG
yG
yG
yG
yG
yG
yG
yG
yG
yG
yG
yG
yG
yG
yG
yG
yG
yG
yG
yG
yG
yG
yG
yG
yG
yG
yG
yG
yG
yG
yG
yG
yG
yG
yG
yG
yG
yG
yG
yG
yG
yG
yG
yG
yG
yG
yG
yG
yG
yG
yG
yG
yG
yG
yG
yG
yG
yG
yG
yG
yG
yG
yG
yG
yG
yG
yG
yG
yG
yG
yG
yG
yG
yG
yG
yG
yG
qu
"}
(26,1,1) = {"
GI
yG
GI
GI
GI
GI
GI
yG
GI
GI
qu
yG
yG
yG
CW
bX
yG
yG
yG
yG
yG
yG
CW
bX
yG
yG
yG
yG
yG
yG
CW
bX
yG
yG
yG
yG
yG
yG
CW
bX
yG
yG
yG
yG
yG
yG
CW
bX
yG
yG
yG
yG
yG
yG
CW
bX
yG
yG
yG
yG
yG
yG
CW
bX
yG
yG
yG
yG
yG
yG
CW
bX
yG
yG
yG
yG
yG
yG
CW
bX
yG
yG
yG
yG
yG
yG
CW
bX
yG
yG
yG
yG
yG
yG
CW
bX
yG
yG
yG
yG
yG
yG
CW
bX
yG
yG
yG
yG
yG
qu
"}
(27,1,1) = {"
GI
GI
GI
GI
GI
GI
GI
GI
GI
GI
qu
yG
yG
yG
Rr
md
yG
yG
yG
yG
yG
yG
Rr
md
yG
yG
yG
yG
yG
yG
Rr
md
yG
yG
yG
yG
yG
yG
Rr
md
yG
yG
yG
yG
yG
yG
Rr
md
yG
yG
yG
yG
yG
yG
Rr
md
yG
yG
yG
yG
yG
yG
Rr
md
yG
yG
yG
yG
yG
yG
Rr
md
yG
yG
yG
yG
yG
yG
Rr
md
yG
yG
yG
yG
yG
yG
Rr
md
yG
yG
yG
yG
yG
yG
Rr
md
yG
yG
yG
yG
yG
yG
Rr
md
yG
yG
eY
pc
sA
qu
"}
(28,1,1) = {"
GI
GI
GI
GI
GI
GI
GI
GI
GI
GI
qu
yG
yG
yG
yG
yG
yG
yG
yG
yG
yG
yG
yG
yG
yG
yG
yG
yG
yG
yG
yG
yG
yG
yG
yG
yG
yG
yG
yG
yG
yG
yG
yG
yG
yG
yG
yG
yG
yG
yG
yG
yG
yG
yG
yG
yG
yG
yG
yG
yG
yG
yG
yG
yG
yG
yG
yG
yG
yG
yG
yG
yG
yG
yG
yG
yG
yG
yG
yG
yG
yG
yG
yG
yG
yG
yG
yG
yG
yG
yG
yG
yG
yG
yG
yG
yG
yG
yG
yG
yG
yG
yG
yG
yG
yG
yG
fI
fz
Ds
qu
"}
(29,1,1) = {"
GI
GI
GI
GI
GI
GI
GI
GI
GI
GI
qu
yG
yG
yG
yG
yG
yG
yG
yG
yG
yG
yG
yG
yG
yG
yG
yG
yG
yG
yG
yG
yG
yG
yG
yG
yG
yG
yG
yG
yG
yG
yG
yG
yG
yG
yG
yG
yG
yG
yG
yG
yG
yG
yG
yG
yG
yG
yG
yG
yG
yG
yG
yG
yG
yG
yG
yG
yG
yG
yG
yG
yG
yG
yG
yG
yG
yG
yG
yG
yG
yG
yG
yG
yG
yG
yG
yG
yG
yG
yG
yG
yG
yG
yG
yG
yG
yG
yG
yG
yG
yG
yG
yG
yG
yG
yG
yf
cH
yG
qu
"}
(30,1,1) = {"
GI
GI
GI
GI
GI
GI
GI
GI
GI
GI
qu
qu
qu
qu
qu
qu
qu
qu
qu
qu
qu
qu
qu
qu
qu
qu
qu
qu
qu
qu
qu
qu
qu
qu
qu
qu
qu
qu
qu
qu
qu
qu
qu
qu
qu
qu
qu
qu
qu
qu
qu
qu
qu
qu
qu
qu
qu
qu
qu
qu
qu
qu
qu
qu
qu
qu
qu
qu
qu
qu
qu
qu
qu
qu
qu
qu
qu
qu
qu
qu
qu
qu
qu
qu
qu
qu
qu
qu
qu
qu
qu
qu
qu
qu
qu
qu
qu
qu
qu
qu
qu
qu
qu
qu
qu
qu
qu
qu
qu
qu
"}
