//MAP CONVERTED BY dmm2tgm.py THIS HEADER COMMENT PREVENTS RECONVERSION, DO NOT REMOVE
"a" = (
/turf/open/floor/prison/bright_clean/two,
/area/template_noop)
"e" = (
/obj/machinery/light/small{
	dir = 8
	},
/turf/open/floor/prison/bright_clean/two,
/area/template_noop)
"i" = (
/obj/structure/bed/chair/sofa/left,
/turf/open/floor/prison/bright_clean/two,
/area/template_noop)
"j" = (
/atom/movable/effect/landmark/excavation_site_spawner,
/turf/open/floor/prison/bright_clean/two,
/area/template_noop)
"m" = (
/obj/item/toy/inflatable_duck,
/turf/open/nostromowater,
/area/template_noop)
"n" = (
/obj/machinery/light/small{
	dir = 1
	},
/turf/open/floor/prison/bright_clean/two,
/area/template_noop)
"o" = (
/obj/structure/bed/chair/sofa,
/turf/open/floor/prison/bright_clean/two,
/area/template_noop)
"r" = (
/obj/machinery/holopad,
/turf/open/floor/prison/bright_clean/two,
/area/template_noop)
"v" = (
/obj/machinery/atmospherics/pipe/simple/supply/hidden/layer1{
	dir = 5
	},
/turf/open/floor/prison/bright_clean/two,
/area/template_noop)
"x" = (
/turf/open/nostromowater,
/area/template_noop)
"C" = (
/obj/machinery/light/small{
	dir = 4
	},
/turf/open/floor/prison/bright_clean/two,
/area/template_noop)
"D" = (
/obj/item/clothing/under/lightbrown,
/obj/item/clothing/shoes/ruggedboot{
	pixel_x = 5;
	pixel_y = -9
	},
/turf/open/floor/prison/bright_clean/two,
/area/template_noop)
"E" = (
/atom/movable/effect/landmark/corpsespawner/scientist,
/turf/open/floor/prison/bright_clean/two,
/area/template_noop)
"I" = (
/obj/structure/bed/chair/sofa/right,
/obj/machinery/atmospherics/components/unary/vent_pump/layer1{
	dir = 8;
	on = 1
	},
/turf/open/floor/prison/bright_clean/two,
/area/template_noop)
"K" = (
/obj/machinery/light/small,
/atom/movable/effect/landmark/excavation_site_spawner,
/turf/open/floor/prison/bright_clean/two,
/area/template_noop)
"L" = (
/obj/machinery/vending/cigarette,
/turf/open/floor/prison/bright_clean/two,
/area/template_noop)
"M" = (
/obj/machinery/atmospherics/pipe/simple/scrubbers/hidden{
	dir = 9
	},
/turf/open/floor/prison/bright_clean/two,
/area/template_noop)
"N" = (
/obj/structure/closet/athletic_mixed,
/turf/open/floor/prison/bright_clean/two,
/area/template_noop)
"V" = (
/obj/machinery/light/small,
/turf/open/floor/prison/bright_clean/two,
/area/template_noop)
"Z" = (
/obj/machinery/atmospherics/components/unary/vent_scrubber{
	dir = 4
	},
/turf/open/floor/prison/bright_clean/two,
/area/template_noop)

(1,1,1) = {"
N
E
a
a
a
e
a
a
a
a
a
"}
(2,1,1) = {"
L
j
a
a
a
a
a
a
a
a
V
"}
(3,1,1) = {"
Z
a
a
x
x
x
x
x
x
x
a
"}
(4,1,1) = {"
M
a
a
x
m
x
x
x
x
x
a
"}
(5,1,1) = {"
n
r
a
x
x
x
x
x
x
x
a
"}
(6,1,1) = {"
v
a
a
x
x
x
x
x
x
x
a
"}
(7,1,1) = {"
I
D
a
x
x
x
x
x
x
x
a
"}
(8,1,1) = {"
o
a
a
a
a
a
a
a
a
a
K
"}
(9,1,1) = {"
i
a
a
a
a
C
a
a
a
a
a
"}
