"a" = (/turf/open/floor/wood,/area/campaign/jungle_outpost/outpost/bar)
"b" = (/obj/machinery/vending/boozeomat,/turf/open/floor/grimy,/area/campaign/jungle_outpost/outpost/bar)
"c" = (/obj/structure/bed/chair/wood/normal{dir = 4},/turf/open/floor/wood,/area/campaign/jungle_outpost/outpost/bar)
"d" = (/obj/structure/platform{dir = 5},/turf/closed/wall/wood,/area/campaign/jungle_outpost/outpost/bar)
"e" = (/obj/structure/table/woodentable,/obj/item/reagent_containers/food/drinks/drinkingglass{pixel_y = 4},/turf/open/floor/grimy,/area/campaign/jungle_outpost/outpost/bar)
"f" = (/obj/structure/cable,/turf/open/floor/wood,/area/campaign/jungle_outpost/outpost/bar)
"g" = (/obj/structure/device/piano/full,/turf/open/floor/wood,/area/campaign/jungle_outpost/outpost/bar)
"i" = (/obj/structure/bed/chair/wood/normal{dir = 1},/obj/machinery/light{dir = 4},/turf/open/floor/wood,/area/campaign/jungle_outpost/outpost/bar)
"j" = (/obj/structure/bed/chair/wood/normal{dir = 1},/turf/open/floor/cult/clock,/area/campaign/jungle_outpost/outpost/bar)
"k" = (/turf/closed/wall/wood,/area/campaign/jungle_outpost/outpost/bar)
"l" = (/turf/open/floor/grimy,/area/campaign/jungle_outpost/outpost/bar)
"m" = (/obj/structure/table/woodentable,/obj/effect/spawner/random/food_or_drink/drink_cans,/turf/open/floor/wood,/area/campaign/jungle_outpost/outpost/bar)
"n" = (/obj/structure/bed/chair/wood/normal{dir = 4},/turf/open/floor/cult/clock,/area/campaign/jungle_outpost/outpost/bar)
"o" = (/obj/structure/table/woodentable,/obj/effect/spawner/random/food_or_drink/drink_alcohol_bottle,/turf/open/floor/cult/clock,/area/campaign/jungle_outpost/outpost/bar)
"p" = (/obj/structure/table/woodentable,/obj/effect/spawner/random/misc/cigarettes,/turf/open/floor/wood,/area/campaign/jungle_outpost/outpost/bar)
"q" = (/obj/structure/cable,/obj/machinery/power/apc/drained,/turf/open/floor/wood,/area/campaign/jungle_outpost/outpost/bar)
"r" = (/obj/machinery/light,/turf/open/floor/wood,/area/campaign/jungle_outpost/outpost/bar)
"t" = (/obj/effect/landmark/campaign_structure/phoron_crate,/turf/open/floor/cult,/area/campaign/jungle_outpost/outpost/bar)
"u" = (/obj/structure/platform{dir = 4},/turf/closed/wall/wood,/area/campaign/jungle_outpost/outpost/bar)
"v" = (/obj/structure/platform{dir = 1},/turf/closed/wall/wood,/area/campaign/jungle_outpost/outpost/bar)
"w" = (/obj/structure/table/woodentable,/obj/item/reagent_containers/food/drinks/shaker,/turf/open/floor/grimy,/area/campaign/jungle_outpost/outpost/bar)
"x" = (/obj/structure/bed/chair/wood/normal,/turf/open/floor/cult/clock,/area/campaign/jungle_outpost/outpost/bar)
"y" = (/obj/structure/platform{dir = 8},/turf/closed/wall/wood,/area/campaign/jungle_outpost/outpost/bar)
"z" = (/obj/structure/platform{dir = 9},/turf/closed/wall/wood,/area/campaign/jungle_outpost/outpost/bar)
"A" = (/obj/structure/table/gamblingtable,/obj/item/toy/dice/d20,/turf/open/floor/wood,/area/campaign/jungle_outpost/outpost/bar)
"B" = (/turf/open/floor/cult,/area/campaign/jungle_outpost/outpost/bar)
"C" = (/obj/structure/bed/chair/wood/normal,/obj/machinery/light{dir = 4},/turf/open/floor/wood,/area/campaign/jungle_outpost/outpost/bar)
"D" = (/obj/machinery/door/window,/turf/open/floor/grimy,/area/campaign/jungle_outpost/outpost/bar)
"E" = (/obj/structure/bed/chair/wood/normal{dir = 8},/turf/open/floor/wood,/area/campaign/jungle_outpost/outpost/bar)
"F" = (/obj/structure/table/woodentable,/obj/item/reagent_containers/food/drinks/drinkingglass{pixel_y = 4},/obj/effect/spawner/random/misc/cigar,/turf/open/floor/grimy,/area/campaign/jungle_outpost/outpost/bar)
"G" = (/obj/structure/bed/stool,/obj/machinery/light{dir = 8},/turf/open/floor/grimy,/area/campaign/jungle_outpost/outpost/bar)
"H" = (/obj/structure/bed/chair/wood/normal,/turf/open/floor/wood,/area/campaign/jungle_outpost/outpost/bar)
"I" = (/obj/machinery/light{dir = 8},/turf/open/floor/wood,/area/campaign/jungle_outpost/outpost/bar)
"J" = (/obj/structure/platform{dir = 10},/turf/closed/wall/wood,/area/campaign/jungle_outpost/outpost/bar)
"K" = (/obj/structure/bed/chair/wood/normal{dir = 8},/turf/open/floor/cult/clock,/area/campaign/jungle_outpost/outpost/bar)
"M" = (/obj/structure/window/framed/wood,/obj/structure/platform{dir = 4},/turf/open/floor/wood,/area/campaign/jungle_outpost/outpost/bar)
"N" = (/obj/structure/table/reinforced,/obj/machinery/chem_dispenser/soda{pixel_y = 32},/turf/open/floor/grimy,/area/campaign/jungle_outpost/outpost/bar)
"O" = (/obj/structure/bed/stool,/turf/open/floor/grimy,/area/campaign/jungle_outpost/outpost/bar)
"P" = (/turf/open/space/basic,/area/campaign/jungle_outpost/ground/jungle/west)
"Q" = (/obj/machinery/door/airlock/multi_tile/mainship/generic,/turf/open/floor/wood,/area/campaign/jungle_outpost/outpost/bar)
"R" = (/obj/structure/platform,/turf/closed/wall/wood,/area/campaign/jungle_outpost/outpost/bar)
"S" = (/obj/structure/platform{dir = 6},/turf/closed/wall/wood,/area/campaign/jungle_outpost/outpost/bar)
"T" = (/obj/structure/table/woodentable,/turf/open/floor/cult/clock,/area/campaign/jungle_outpost/outpost/bar)
"U" = (/obj/machinery/door/airlock/colony/medical/hydroponics{dir = 1},/obj/structure/platform,/turf/open/floor/wood,/area/campaign/jungle_outpost/outpost/bar)
"V" = (/obj/structure/bed/chair/wood/wings{dir = 8},/turf/open/floor/wood,/area/campaign/jungle_outpost/outpost/bar)
"X" = (/obj/machinery/light{dir = 1},/turf/open/floor/wood,/area/campaign/jungle_outpost/outpost/bar)
"Y" = (/obj/structure/window/framed/wood,/obj/structure/platform{dir = 8},/turf/open/floor/wood,/area/campaign/jungle_outpost/outpost/bar)
"Z" = (/obj/structure/bed/chair/wood/normal{dir = 1},/turf/open/floor/wood,/area/campaign/jungle_outpost/outpost/bar)

(1,1,1) = {"
PzvvvvvQfvdP
zkbNwXqffakd
ylllDaBxBaHu
yeeFeanoKapu
yGOOOatjBaiu
YaaaaaaaaaaM
YaBxBaBxBaaM
yInoKanTKaCu
yaBjBaBjBamu
yaaaaHaaaaZu
JkaacAErgVkS
PJRURRRRRRSP
"}
