//MAP CONVERTED BY dmm2tgm.py THIS HEADER COMMENT PREVENTS RECONVERSION, DO NOT REMOVE
"a" = (
/obj/machinery/light{
	light_color = "#da2f1b"
	},
/obj/effect/ai_node,
/turf/open/floor/plating/ground/concrete,
/area/campaign/jungle_outpost/outpost/req/depot)
"b" = (
/obj/structure/cable,
/turf/open/floor/plating/ground/concrete,
/area/campaign/jungle_outpost/outpost/req/depot)
"c" = (
/obj/effect/turf_decal/grassdecal,
/turf/open/floor/plating/ground/concrete,
/area/campaign/jungle_outpost/ground/jungle/south)
"d" = (
/obj/structure/largecrate/random/barrel,
/turf/open/floor/plating/ground/concrete,
/area/campaign/jungle_outpost/outpost/req/depot)
"e" = (
/obj/structure/stairs/seamless/edge,
/obj/effect/ai_node,
/turf/open/floor/plating/ground/concrete,
/area/campaign/jungle_outpost/outpost/req/depot)
"h" = (
/obj/structure/extinguisher_cabinet/mini{
	dir = 1
	},
/turf/open/floor/plating/ground/concrete,
/area/campaign/jungle_outpost/outpost/req/depot)
"i" = (
/obj/effect/turf_decal/grassdecal{
	dir = 1
	},
/turf/open/floor/plating/ground/concrete,
/area/campaign/jungle_outpost/outpost/req/depot)
"k" = (
/turf/open/ground/grass/weedable,
/area/campaign/jungle_outpost/ground/jungle/south)
"l" = (
/obj/structure/rack,
/obj/effect/spawner/random/engineering/engibelt,
/obj/machinery/light{
	dir = 1
	},
/turf/open/floor/plating/ground/concrete,
/area/campaign/jungle_outpost/outpost/req/depot)
"m" = (
/obj/effect/turf_decal/grassdecal,
/turf/open/floor/plating/ground/concrete,
/area/campaign/jungle_outpost/outpost/req/depot)
"n" = (
/obj/structure/largecrate/random,
/turf/open/floor/plating/ground/concrete,
/area/campaign/jungle_outpost/outpost/req/depot)
"o" = (
/turf/open/floor/plating/ground/concrete,
/area/campaign/jungle_outpost/outpost/req/depot)
"q" = (
/obj/structure/cable,
/obj/effect/ai_node,
/turf/open/floor/plating/ground/concrete,
/area/campaign/jungle_outpost/outpost/req/depot)
"r" = (
/obj/structure/largecrate/random/barrel/red,
/turf/open/floor/plating/ground/concrete,
/area/campaign/jungle_outpost/outpost/req/depot)
"s" = (
/obj/structure/rack,
/obj/item/radio/survivor,
/turf/open/floor/plating/ground/concrete,
/area/campaign/jungle_outpost/outpost/req/depot)
"t" = (
/obj/effect/turf_decal/grassdecal/corner{
	dir = 4
	},
/turf/open/floor/plating/ground/concrete,
/area/campaign/jungle_outpost/outpost/req/depot)
"u" = (
/turf/closed/wall,
/area/campaign/jungle_outpost/outpost/req/depot)
"v" = (
/obj/structure/reagent_dispensers/watertank,
/turf/open/floor/plating/ground/concrete,
/area/campaign/jungle_outpost/outpost/req/depot)
"x" = (
/obj/effect/turf_decal/grassdecal/corner2{
	dir = 1
	},
/turf/open/floor/plating/ground/concrete,
/area/campaign/jungle_outpost/outpost/req/depot)
"z" = (
/obj/structure/largecrate/random/case/small,
/turf/open/floor/plating/ground/concrete,
/area/campaign/jungle_outpost/outpost/req/depot)
"B" = (
/obj/structure/largecrate/random/barrel/yellow,
/turf/open/floor/plating/ground/concrete,
/area/campaign/jungle_outpost/outpost/req/depot)
"C" = (
/obj/effect/spawner/random/misc/structure/supplycrate,
/turf/open/floor/plating/ground/concrete,
/area/campaign/jungle_outpost/outpost/req/depot)
"F" = (
/obj/structure/largecrate/random/case,
/turf/open/floor/plating/ground/concrete,
/area/campaign/jungle_outpost/outpost/req/depot)
"H" = (
/obj/structure/largecrate/random/case/double,
/turf/open/floor/plating/ground/concrete,
/area/campaign/jungle_outpost/outpost/req/depot)
"I" = (
/obj/structure/prop/vehicle/truck/truckcargo{
	dir = 8
	},
/turf/open/floor/plating/ground/concrete,
/area/campaign/jungle_outpost/outpost/req/depot)
"J" = (
/obj/effect/ai_node,
/turf/open/floor/plating/ground/concrete,
/area/campaign/jungle_outpost/outpost/req/depot)
"L" = (
/obj/effect/turf_decal/grassdecal,
/obj/effect/ai_node,
/turf/open/floor/plating/ground/concrete,
/area/campaign/jungle_outpost/outpost/req/depot)
"M" = (
/obj/structure/cable,
/obj/structure/prop/vehicle/truck/truckcargo{
	dir = 8
	},
/turf/open/floor/plating/ground/concrete,
/area/campaign/jungle_outpost/outpost/req/depot)
"N" = (
/obj/effect/turf_decal/grassdecal{
	dir = 8
	},
/turf/open/floor/plating/ground/concrete,
/area/campaign/jungle_outpost/outpost/req/depot)
"O" = (
/obj/structure/stairs/seamless/edge{
	dir = 4
	},
/obj/structure/cable,
/turf/open/floor/plating/ground/concrete,
/area/campaign/jungle_outpost/outpost/req/depot)
"Q" = (
/obj/effect/turf_decal/grassdecal{
	dir = 1
	},
/obj/structure/flora/jungle/grass/thin,
/turf/open/floor/plating/ground/concrete,
/area/campaign/jungle_outpost/outpost/req/depot)
"R" = (
/obj/structure/largecrate/random/barrel/white,
/turf/open/floor/plating/ground/concrete,
/area/campaign/jungle_outpost/outpost/req/depot)
"S" = (
/obj/structure/largecrate/random/barrel/green,
/turf/open/floor/plating/ground/concrete,
/area/campaign/jungle_outpost/outpost/req/depot)
"T" = (
/obj/machinery/light{
	dir = 4
	},
/turf/open/floor/plating/ground/concrete,
/area/campaign/jungle_outpost/outpost/req/depot)
"U" = (
/obj/effect/turf_decal/grassdecal,
/obj/structure/flora/jungle/grass/thin,
/turf/open/floor/plating/ground/concrete,
/area/campaign/jungle_outpost/outpost/req/depot)
"V" = (
/obj/structure/largecrate/random/secure,
/turf/open/floor/plating/ground/concrete,
/area/campaign/jungle_outpost/outpost/req/depot)
"W" = (
/obj/machinery/light{
	dir = 8
	},
/turf/open/floor/plating/ground/concrete,
/area/campaign/jungle_outpost/outpost/req/depot)
"X" = (
/obj/effect/landmark/campaign_structure/asat_system,
/turf/open/floor/plating/ground/concrete,
/area/campaign/jungle_outpost/outpost/req/depot)
"Y" = (
/obj/effect/spawner/random/engineering/structure/tank/fuelweighted,
/turf/open/floor/plating/ground/concrete,
/area/campaign/jungle_outpost/outpost/req/depot)
"Z" = (
/obj/structure/rack,
/obj/effect/spawner/random/engineering/tool,
/turf/open/floor/plating/ground/concrete,
/area/campaign/jungle_outpost/outpost/req/depot)

(1,1,1) = {"
u
I
W
M
b
M
b
q
b
o
o
o
s
u
"}
(2,1,1) = {"
u
o
o
b
o
o
o
o
o
o
o
o
Z
u
"}
(3,1,1) = {"
u
o
o
q
o
o
o
J
o
o
o
o
a
u
"}
(4,1,1) = {"
u
o
o
b
o
z
z
F
R
o
o
o
h
u
"}
(5,1,1) = {"
U
o
o
b
B
d
u
u
d
H
o
o
o
i
"}
(6,1,1) = {"
m
o
o
b
n
u
u
u
u
H
o
o
J
i
"}
(7,1,1) = {"
L
o
o
q
V
u
u
u
u
V
o
o
o
i
"}
(8,1,1) = {"
u
o
o
b
H
S
u
u
r
n
o
o
o
Q
"}
(9,1,1) = {"
u
l
o
b
o
n
n
d
d
o
o
X
Y
u
"}
(10,1,1) = {"
u
Z
o
b
o
o
o
o
T
o
o
o
v
u
"}
(11,1,1) = {"
u
u
o
q
o
o
C
C
u
u
o
o
u
u
"}
(12,1,1) = {"
c
o
o
O
e
o
o
o
x
N
N
N
t
k
"}
