//MAP CONVERTED BY dmm2tgm.py THIS HEADER COMMENT PREVENTS RECONVERSION, DO NOT REMOVE
"a" = (
/turf/open/floor,
/area/campaign/jungle_outpost/outpost/outer/west)
"b" = (
/obj/structure/table/reinforced,
/turf/open/floor,
/area/campaign/jungle_outpost/outpost/outer/west)
"c" = (
/obj/structure/table/reinforced,
/obj/effect/spawner/random/engineering/engibelt,
/turf/open/floor,
/area/campaign/jungle_outpost/outpost/outer/west)
"d" = (
/turf/open/floor/plating/ground/dirtgrassborder2/corner,
/area/campaign/jungle_outpost/ground/jungle/west)
"e" = (
/obj/effect/spawner/random/misc/structure/supplycrate/normalweighted,
/turf/open/floor,
/area/campaign/jungle_outpost/outpost/outer/west)
"f" = (
/obj/structure/cable,
/turf/open/floor,
/area/campaign/jungle_outpost/outpost/outer/west)
"g" = (
/obj/effect/spawner/random/misc/structure/broken_window/colonyspawn,
/turf/open/floor,
/area/campaign/jungle_outpost/outpost/outer/west)
"h" = (
/obj/effect/spawner/random/engineering/structure/tank/fuelweighted,
/turf/open/floor,
/area/campaign/jungle_outpost/outpost/outer/west)
"i" = (
/obj/effect/spawner/random/misc/structure/broken_window/colonyspawn,
/obj/structure/platform{
	dir = 1
	},
/turf/open/floor,
/area/campaign/jungle_outpost/outpost/outer/west)
"j" = (
/obj/machinery/door/airlock/colony/medical/hydroponics{
	dir = 1
	},
/turf/open/floor,
/area/campaign/jungle_outpost/outpost/outer/west)
"k" = (
/obj/item/trash/cheesie,
/turf/open/floor,
/area/campaign/jungle_outpost/outpost/outer/west)
"l" = (
/obj/structure/platform{
	dir = 8
	},
/turf/closed/wall,
/area/campaign/jungle_outpost/outpost/outer/west)
"m" = (
/obj/effect/landmark/campaign_structure/phoron_crate,
/turf/open/floor,
/area/campaign/jungle_outpost/outpost/outer/west)
"n" = (
/obj/item/trash/raisins,
/turf/open/floor,
/area/campaign/jungle_outpost/outpost/outer/west)
"o" = (
/obj/machinery/light,
/turf/open/floor,
/area/campaign/jungle_outpost/outpost/outer/west)
"p" = (
/obj/effect/spawner/random/misc/structure/broken_window/colonyspawn,
/obj/structure/platform{
	dir = 8
	},
/turf/open/floor,
/area/campaign/jungle_outpost/outpost/outer/west)
"q" = (
/obj/structure/platform_decoration{
	dir = 5
	},
/turf/open/ground/grass/weedable,
/area/campaign/jungle_outpost/ground/jungle/west)
"r" = (
/obj/structure/platform{
	dir = 1
	},
/turf/closed/wall,
/area/campaign/jungle_outpost/outpost/outer/west)
"s" = (
/obj/structure/platform{
	dir = 5
	},
/turf/closed/wall,
/area/campaign/jungle_outpost/outpost/outer/west)
"t" = (
/obj/machinery/door/airlock/multi_tile/mainship/generic,
/turf/open/floor,
/area/campaign/jungle_outpost/outpost/outer/west)
"u" = (
/obj/structure/flora/jungle/grass/thin,
/turf/open/ground/grass/weedable,
/area/campaign/jungle_outpost/ground/jungle/west)
"v" = (
/obj/structure/table/reinforced,
/obj/item/paper,
/obj/effect/spawner/random/medical/pillbottle,
/turf/open/floor,
/area/campaign/jungle_outpost/outpost/outer/west)
"w" = (
/turf/open/floor/plating/ground/dirtgrassborder2{
	dir = 1
	},
/area/campaign/jungle_outpost/ground/jungle/west)
"x" = (
/obj/structure/stairs/edge{
	dir = 1
	},
/turf/open/floor/plating/ground/dirtgrassborder2,
/area/campaign/jungle_outpost/ground/jungle/west)
"y" = (
/obj/structure/flora/jungle/grass/thin,
/turf/open/floor/plating/ground/dirtgrassborder2/corner{
	dir = 8
	},
/area/campaign/jungle_outpost/ground/jungle/west)
"z" = (
/obj/machinery/door/airlock/multi_tile/mainship/generic{
	dir = 1
	},
/turf/open/floor,
/area/campaign/jungle_outpost/outpost/outer/west)
"A" = (
/obj/structure/platform,
/turf/closed/wall,
/area/campaign/jungle_outpost/outpost/outer/west)
"B" = (
/obj/structure/table/reinforced,
/obj/item/clipboard,
/turf/open/floor,
/area/campaign/jungle_outpost/outpost/outer/west)
"C" = (
/obj/machinery/light{
	dir = 8
	},
/turf/open/floor,
/area/campaign/jungle_outpost/outpost/outer/west)
"D" = (
/obj/effect/ai_node,
/turf/open/floor,
/area/campaign/jungle_outpost/outpost/outer/west)
"E" = (
/obj/structure/platform_decoration{
	dir = 10
	},
/turf/open/ground/grass/weedable,
/area/campaign/jungle_outpost/ground/jungle/west)
"F" = (
/turf/open/floor/plating/ground/dirtgrassborder2/corner{
	dir = 4
	},
/area/campaign/jungle_outpost/ground/jungle/west)
"G" = (
/turf/closed/wall,
/area/campaign/jungle_outpost/outpost/outer/west)
"H" = (
/turf/open/floor/plating/ground/dirtgrassborder2/corner{
	dir = 1
	},
/area/campaign/jungle_outpost/ground/jungle/west)
"I" = (
/obj/structure/platform{
	dir = 4
	},
/obj/effect/spawner/random/misc/structure/broken_window/colonyspawn,
/turf/open/floor,
/area/campaign/jungle_outpost/outpost/outer/west)
"J" = (
/obj/structure/platform{
	dir = 10
	},
/turf/closed/wall,
/area/campaign/jungle_outpost/outpost/outer/west)
"K" = (
/obj/structure/platform_decoration{
	dir = 9
	},
/turf/open/ground/grass/weedable,
/area/campaign/jungle_outpost/ground/jungle/west)
"L" = (
/obj/structure/platform{
	dir = 6
	},
/turf/closed/wall,
/area/campaign/jungle_outpost/outpost/outer/west)
"M" = (
/obj/effect/spawner/random/engineering/tool,
/turf/open/floor,
/area/campaign/jungle_outpost/outpost/outer/west)
"N" = (
/obj/structure/flora/jungle/bush,
/turf/open/ground/grass/weedable,
/area/campaign/jungle_outpost/ground/jungle/west)
"O" = (
/obj/structure/platform{
	dir = 9
	},
/turf/closed/wall,
/area/campaign/jungle_outpost/outpost/outer/west)
"P" = (
/obj/item/trash/cigbutt,
/turf/open/floor,
/area/campaign/jungle_outpost/outpost/outer/west)
"Q" = (
/obj/structure/stairs/seamless/edge_vert,
/turf/open/floor/plating/ground/dirtgrassborder2{
	dir = 1
	},
/area/campaign/jungle_outpost/ground/jungle/west)
"R" = (
/obj/structure/platform_decoration{
	dir = 6
	},
/turf/open/ground/grass/weedable,
/area/campaign/jungle_outpost/ground/jungle/west)
"S" = (
/obj/structure/cable,
/obj/effect/ai_node,
/turf/open/floor,
/area/campaign/jungle_outpost/outpost/outer/west)
"T" = (
/obj/machinery/power/apc/drained{
	dir = 1
	},
/obj/structure/cable,
/turf/open/floor,
/area/campaign/jungle_outpost/outpost/outer/west)
"U" = (
/obj/machinery/light{
	dir = 1
	},
/turf/open/floor,
/area/campaign/jungle_outpost/outpost/outer/west)
"V" = (
/obj/effect/spawner/random/misc/structure/broken_window/colonyspawn,
/obj/structure/platform,
/turf/open/floor,
/area/campaign/jungle_outpost/outpost/outer/west)
"W" = (
/obj/structure/platform{
	dir = 4
	},
/turf/closed/wall,
/area/campaign/jungle_outpost/outpost/outer/west)
"X" = (
/obj/structure/stairs/seamless/edge_vert{
	dir = 1
	},
/turf/open/floor/plating/ground/dirtgrassborder2{
	dir = 1
	},
/area/campaign/jungle_outpost/ground/jungle/west)
"Y" = (
/turf/open/ground/grass/weedable,
/area/campaign/jungle_outpost/ground/jungle/west)

(1,1,1) = {"
Y
R
O
l
l
l
l
l
p
p
l
J
K
u
"}
(2,1,1) = {"
Y
O
G
c
b
a
G
a
a
a
C
G
J
Y
"}
(3,1,1) = {"
Y
r
a
P
n
a
g
a
a
a
a
a
A
d
"}
(4,1,1) = {"
y
i
a
D
a
a
j
a
a
D
a
a
j
x
"}
(5,1,1) = {"
w
i
a
a
a
o
G
U
a
a
a
a
A
H
"}
(6,1,1) = {"
w
r
U
a
f
T
G
G
a
z
G
G
A
u
"}
(7,1,1) = {"
w
r
a
a
f
m
G
h
a
a
C
M
A
N
"}
(8,1,1) = {"
Q
t
a
a
f
a
t
a
M
a
P
a
V
Y
"}
(9,1,1) = {"
X
f
f
S
f
a
a
a
a
D
a
B
V
Y
"}
(10,1,1) = {"
F
r
a
a
a
o
G
U
a
a
k
v
A
Y
"}
(11,1,1) = {"
Y
s
G
a
e
e
G
h
a
a
a
G
L
Y
"}
(12,1,1) = {"
Y
E
s
W
W
W
W
W
I
I
W
L
q
u
"}
