//MAP CONVERTED BY dmm2tgm.py THIS HEADER COMMENT PREVENTS RECONVERSION, DO NOT REMOVE
"a" = (
/obj/effect/spawner/random/misc/structure/broken_window/colonyspawn,
/turf/open/floor/tile/dark/gray,
/area/campaign/jungle_outpost/outpost/req/depot)
"b" = (
/obj/structure/flora/jungle/bush,
/turf/open/ground/grass/weedable,
/area/campaign/jungle_outpost/ground/jungle/south)
"c" = (
/obj/structure/cable,
/turf/open/floor/tile/dark/gray,
/area/campaign/jungle_outpost/outpost/req/depot)
"d" = (
/obj/structure/flora/jungle/large_bush,
/turf/open/ground/grass/weedable,
/area/campaign/jungle_outpost/ground/jungle/south)
"f" = (
/obj/structure/table,
/obj/effect/spawner/random/misc/folder,
/turf/open/floor/tile/dark/gray,
/area/campaign/jungle_outpost/outpost/req/depot)
"g" = (
/obj/machinery/light{
	dir = 1
	},
/turf/open/floor/tile/dark/gray,
/area/campaign/jungle_outpost/outpost/req/depot)
"h" = (
/obj/item/reagent_containers/glass/bucket/janibucket,
/obj/item/tool/mop,
/turf/open/floor/tile/dark/gray,
/area/campaign/jungle_outpost/outpost/req/depot)
"i" = (
/turf/open/ground/grass/weedable,
/area/campaign/jungle_outpost/ground/jungle/south)
"j" = (
/obj/structure/cable,
/obj/effect/turf_decal/grassdecal,
/turf/open/floor/plating/ground/concrete,
/area/campaign/jungle_outpost/ground/jungle/south)
"k" = (
/obj/structure/table,
/obj/item/reagent_containers/food/snacks/pastries/birthdaycakeslice,
/turf/open/floor/tile/dark/gray,
/area/campaign/jungle_outpost/outpost/req/depot)
"l" = (
/obj/machinery/door/airlock/maintenance{
	dir = 1
	},
/turf/open/floor/tile/dark/gray,
/area/campaign/jungle_outpost/outpost/req/depot)
"m" = (
/obj/structure/bed/chair/sofa,
/turf/open/floor/tile/dark/gray,
/area/campaign/jungle_outpost/outpost/req/depot)
"n" = (
/obj/effect/landmark/campaign_structure/asat_system,
/turf/open/floor/tile/dark/gray,
/area/campaign/jungle_outpost/outpost/req/depot)
"o" = (
/obj/structure/janitorialcart,
/obj/machinery/light/small,
/turf/open/floor/tile/dark/gray,
/area/campaign/jungle_outpost/outpost/req/depot)
"p" = (
/obj/machinery/light{
	dir = 4
	},
/turf/open/floor/tile/dark/gray,
/area/campaign/jungle_outpost/outpost/req/depot)
"q" = (
/obj/effect/spawner/random/misc/plant,
/obj/effect/ai_node,
/turf/open/floor/tile/dark/gray,
/area/campaign/jungle_outpost/outpost/req/depot)
"r" = (
/obj/structure/stairs/seamless/edge{
	dir = 4
	},
/obj/structure/cable,
/obj/effect/turf_decal/grassdecal,
/turf/open/floor/plating/ground/concrete,
/area/campaign/jungle_outpost/ground/jungle/south)
"s" = (
/obj/structure/sink,
/turf/open/floor/tile/dark/gray,
/area/campaign/jungle_outpost/outpost/req/depot)
"t" = (
/obj/structure/bed/chair/sofa/corner,
/turf/open/floor/tile/dark/gray,
/area/campaign/jungle_outpost/outpost/req/depot)
"u" = (
/obj/structure/bed/chair/office/light{
	dir = 4
	},
/turf/open/floor/tile/dark/gray,
/area/campaign/jungle_outpost/outpost/req/depot)
"v" = (
/obj/machinery/vending/cigarette/colony,
/turf/open/floor/tile/dark/gray,
/area/campaign/jungle_outpost/outpost/req/depot)
"x" = (
/obj/machinery/door/airlock/multi_tile/mainship/generic{
	dir = 1
	},
/turf/open/floor/tile/dark/gray,
/area/campaign/jungle_outpost/outpost/req/depot)
"z" = (
/obj/structure/table,
/obj/machinery/computer/camera,
/turf/open/floor/tile/dark/gray,
/area/campaign/jungle_outpost/outpost/req/depot)
"A" = (
/obj/effect/turf_decal/grassdecal/corner2{
	dir = 1
	},
/obj/effect/ai_node,
/turf/open/floor/plating/ground/concrete,
/area/campaign/jungle_outpost/ground/jungle/south)
"B" = (
/obj/structure/rack,
/obj/item/reagent_containers/spray/cleaner,
/turf/open/floor/tile/dark/gray,
/area/campaign/jungle_outpost/outpost/req/depot)
"C" = (
/turf/open/floor/tile/dark/gray,
/area/campaign/jungle_outpost/outpost/req/depot)
"E" = (
/obj/structure/table,
/obj/item/ashtray/bronze,
/obj/item/trash/cigbutt,
/turf/open/floor/tile/dark/gray,
/area/campaign/jungle_outpost/outpost/req/depot)
"F" = (
/obj/structure/bed/chair/sofa/left{
	dir = 8
	},
/turf/open/floor/tile/dark/gray,
/area/campaign/jungle_outpost/outpost/req/depot)
"G" = (
/obj/structure/table,
/obj/item/pizzabox,
/turf/open/floor/tile/dark/gray,
/area/campaign/jungle_outpost/outpost/req/depot)
"H" = (
/obj/machinery/door/airlock/colony/medical/hydroponics{
	dir = 1
	},
/turf/open/floor/tile/dark/gray,
/area/campaign/jungle_outpost/outpost/req/depot)
"I" = (
/obj/machinery/light{
	light_color = "#da2f1b"
	},
/turf/open/floor/tile/dark/gray,
/area/campaign/jungle_outpost/outpost/req/depot)
"J" = (
/obj/structure/stairs/seamless/edge,
/obj/effect/turf_decal/grassdecal{
	dir = 1
	},
/turf/open/floor/plating/ground/concrete,
/area/campaign/jungle_outpost/ground/jungle/south)
"K" = (
/obj/structure/cable,
/obj/effect/ai_node,
/turf/open/floor/tile/dark/gray,
/area/campaign/jungle_outpost/outpost/req/depot)
"L" = (
/obj/structure/bed/chair{
	dir = 4
	},
/turf/open/floor/tile/dark/gray,
/area/campaign/jungle_outpost/outpost/req/depot)
"N" = (
/obj/machinery/light{
	dir = 8
	},
/turf/open/floor/tile/dark/gray,
/area/campaign/jungle_outpost/outpost/req/depot)
"P" = (
/obj/structure/flora/jungle/grass/thin,
/turf/open/ground/grass/weedable,
/area/campaign/jungle_outpost/ground/jungle/south)
"Q" = (
/obj/structure/table,
/obj/effect/spawner/random/food_or_drink/drink_cans,
/turf/open/floor/tile/dark/gray,
/area/campaign/jungle_outpost/outpost/req/depot)
"R" = (
/obj/effect/turf_decal/grassdecal{
	dir = 1
	},
/turf/open/ground/grass/weedable,
/area/campaign/jungle_outpost/ground/jungle/south)
"S" = (
/turf/open/floor/plating/ground/concrete,
/area/campaign/jungle_outpost/ground/jungle/south)
"T" = (
/obj/structure/bed/chair/sofa/right,
/turf/open/floor/tile/dark/gray,
/area/campaign/jungle_outpost/outpost/req/depot)
"U" = (
/obj/effect/spawner/random/misc/structure/broken_window/colonyspawn,
/obj/structure/cable,
/turf/open/floor/tile/dark/gray,
/area/campaign/jungle_outpost/outpost/req/depot)
"V" = (
/obj/machinery/vending/snack,
/turf/open/floor/tile/dark/gray,
/area/campaign/jungle_outpost/outpost/req/depot)
"W" = (
/obj/effect/spawner/random/misc/plant,
/turf/open/floor/tile/dark/gray,
/area/campaign/jungle_outpost/outpost/req/depot)
"X" = (
/turf/closed/wall,
/area/campaign/jungle_outpost/outpost/req/depot)
"Y" = (
/obj/effect/ai_node,
/turf/open/floor/tile/dark/gray,
/area/campaign/jungle_outpost/outpost/req/depot)
"Z" = (
/obj/effect/spawner/random/engineering/structure/tank/waterweighted,
/turf/open/floor/tile/dark/gray,
/area/campaign/jungle_outpost/outpost/req/depot)

(1,1,1) = {"
X
G
k
V
X
W
W
X
U
C
x
X
X
X
"}
(2,1,1) = {"
a
T
Y
C
H
K
c
c
c
C
Y
C
q
X
"}
(3,1,1) = {"
a
m
C
I
X
c
C
C
p
C
C
C
C
a
"}
(4,1,1) = {"
X
t
F
Q
X
c
C
X
X
X
X
C
C
a
"}
(5,1,1) = {"
X
X
X
X
X
c
C
X
Z
B
X
g
C
X
"}
(6,1,1) = {"
X
v
C
c
c
K
C
X
s
Y
l
C
Y
X
"}
(7,1,1) = {"
X
E
C
c
Y
p
W
X
h
o
X
C
C
a
"}
(8,1,1) = {"
X
L
C
c
C
X
X
X
X
X
X
n
C
a
"}
(9,1,1) = {"
X
a
X
c
x
X
W
u
N
X
C
C
C
X
"}
(10,1,1) = {"
P
i
b
j
S
X
f
z
Y
H
C
C
q
X
"}
(11,1,1) = {"
d
P
i
j
A
X
a
a
X
X
a
a
X
X
"}
(12,1,1) = {"
i
i
R
r
J
i
P
b
i
i
P
b
P
i
"}
