"a" = (/turf/open/space,/area/space)

(1,1,1) = {"
a
"}
