"a" = (/turf/space,/area/space)
"b" = (/turf/unsimulated/wall,/area/space)
"c" = (/obj/machinery/telecomms/relay/preset/station{explosion_resistance = 100; idle_power_usage = 0; listening_level = 1; unacidable = 1; use_power = 0},/turf/unsimulated/floor,/area/space)
"d" = (/obj/effect/step_trigger/teleporter/random{affect_ghosts = 1; name = "tele_ground1"; teleport_x = 180; teleport_x_offset = 200; teleport_y = 50; teleport_y_offset = 80; teleport_z = 1; teleport_z_offset = 1},/turf/space/transit/north/shuttlespace_ns2,/area/space)
"e" = (/obj/effect/step_trigger/teleporter/random{affect_ghosts = 1; name = "escapeshuttle_leave"; teleport_x = 25; teleport_x_offset = 245; teleport_y = 25; teleport_y_offset = 245; teleport_z = 1; teleport_z_offset = 1},/turf/space/transit/north/shuttlespace_ns2,/area/space)
"f" = (/turf/space/transit/north/shuttlespace_ns4,/area/space)
"g" = (/turf/space/transit/north/shuttlespace_ns2,/area/space)
"h" = (/turf/space/transit/north/shuttlespace_ns1,/area/space)
"i" = (/turf/space/transit/north/shuttlespace_ns14,/area/space)
"j" = (/turf/space/transit/north/shuttlespace_ns11,/area/space)
"k" = (/turf/space/transit/north/shuttlespace_ns7,/area/space)
"l" = (/turf/space/transit/north/shuttlespace_ns9,/area/space)
"m" = (/turf/space/transit/north/shuttlespace_ns3,/area/space)
"n" = (/turf/space/transit/north/shuttlespace_ns13,/area/space)
"o" = (/turf/space/transit/north/shuttlespace_ns15,/area/space)
"p" = (/turf/space/transit/north/shuttlespace_ns10,/area/space)
"q" = (/turf/space/transit/north/shuttlespace_ns12,/area/space)
"r" = (/turf/space/transit/north/shuttlespace_ns8,/area/space)
"s" = (/turf/space/transit/north/shuttlespace_ns5,/area/space)
"t" = (/obj/effect/step_trigger/teleporter/random{affect_ghosts = 1; name = "escapeshuttle_leave"; teleport_x = 25; teleport_x_offset = 245; teleport_y = 25; teleport_y_offset = 245; teleport_z = 1; teleport_z_offset = 1},/turf/space/transit/north/shuttlespace_ns4,/area/space)
"u" = (/turf/space/transit/north/shuttlespace_ns2,/area/shuttle/drop2/transit)
"v" = (/turf/space/transit/north/shuttlespace_ns2,/area/shuttle/drop1/transit)
"w" = (/obj/effect/step_trigger/teleporter/random{affect_ghosts = 1; name = "escapeshuttle_leave"; teleport_x = 25; teleport_x_offset = 245; teleport_y = 25; teleport_y_offset = 245; teleport_z = 1; teleport_z_offset = 1},/obj/effect/landmark/shuttle_loc/marine_int/dropship{name = "2"},/turf/space/transit/north/shuttlespace_ns4,/area/space)
"x" = (/obj/effect/step_trigger/teleporter/random{affect_ghosts = 1; name = "escapeshuttle_leave"; teleport_x = 25; teleport_x_offset = 245; teleport_y = 25; teleport_y_offset = 245; teleport_z = 1; teleport_z_offset = 1},/obj/effect/landmark/shuttle_loc/marine_int/dropship{name = "1"},/turf/space/transit/north/shuttlespace_ns4,/area/space)

(1,1,1) = {"
aaaaaaaaaaaaaaaaaaaaaaaaaaaaaaaaaaaaaaaaaaaaaaaaaaaaaaaaaaaaaaaaaaaaaaaaaaaaaaaaaaaaaaaaaaaaaaaaaaaa
aaaaaaaaaaaaaaaaaaaaaaaaaaaaaaaaaaaaaaaaaaaaaaaaaaaaaaaaaaaaaaaaaaaaaaaaaaaaaaaaaaaaaaaaaaaaaaaaaaaa
aaaaaaaaaaaaaaaaaaaaaaaaaaaaaaaaaaaaaaaaaaaaaaaaaaaaaaaaaaaaaaaaaaaaaaaaaaaaaaaaaaaaaaaaaaaaaaaaaaaa
aaaaaaaaaaaaaaaaaaaaaaaaaaaaaaaaaaaaaaaaaaaaaaaaaaaaaaaaaaaaaaaaaaaaaaaaaaaaaaaaaaaaaaaaaaaaaaaaaaaa
aaaaaaaaaaaaaaaaaaaaaaaaaaaaaaaaaaaaaaaaaaaaaaaaaaaaaaaaaaaaaaaaaaaaaaaaaaaaaaaaaaaaaaaaaaaaaaaaaaaa
aaaaaaaaaaaaaaaaaaaaaaaaaaaaaaaaaaaaaaaaaaaaaaaaaaaaaaaaaaaaaaaaaaaaaaaaaaaaaaaaaaaaaaaaaaaaaaaaaaaa
aaaaaaaaaaaaaaaaaaaaaaaaaaaaaaaaaaaaaaaaaaaaaaaaaaaaaaaaaaaaaaaaaaaaaaaaaaaaaaaaaaaaaaaaaaaaaaaaaaaa
aaaaaaaaaaaaaaaaaaaaaaaaaaaaaaaaaaaaaaaaaaaaaaaaaaaaaaaaaaaaaaaaaaaaaaaaaaaaaaaaaaaaaaaaaaaaaaaaaaaa
aaaaaaaaaaaaaaaaaaaaaaaaaaaaaaaaaaaaaaaaaaaaaaaaaaaaaaaaaaaaaaaaaaaaaaaaaaaaaaaaaaaaaaaaaaaaaaaaaaaa
aaaaaaaaaaaaaaaaaaaaaaaaaaaaaaaaaaaaaaaaaaaaaaaaaaaaaaaaaaaaaaaaaaaaaaaaaaaaaaaaaaaaaaaaaaaaaaaaaaaa
aaaaaaaaaaaaaaaaaaaaaaaaaaaaaaaaaaaaaaaaaaaaaaaaaaaaaaaaaaaaaaaaaaaaaaaaaaaaaaaaaaaaaaaaaaaaaaaaaaaa
aaaaaaaaaaaaaaaaaaaaaaaaaaaaaaaaaaaaaaaaaaaaaaaaaaaaaaaaaaaaaaaaaaaaaaaaaaaaaaaaaaaaaaaaaaaaaaaaaaaa
aaaaaaaaaaaaaaaaaaaaaaaaaaaaaaaaaaaaaaaaaaaaaaaaaaaaaaaaaaaaaaaaaaaaaaaaaaaaaaaaaaaaaaaaaaaaaaaaaaaa
aaaaaaaaaaaaaaaaaaaaaaaaaaaaaaaaaaaaaaaaaaaaaaaaaaaaaaaaaaaaaaaaaaaaaaaaaaaaaaaaaaaaaaaaaaaaaaaaaaaa
aaaaaaaaaaaaaaaaaaaaaaaaaaaaaaaaaaaaaaaaaaaaaaaaaaaaaaaaaaaaaaaaaaaaaaaaaaaaaaaaaaaaaaaaaaaaaaaaaaaa
aaaaaaaaaaaaaaaaaaaaaaaaaaaaaaaaaaaaaaaaaaaaaaaaaaaaaaaaaaaaaaaaaaaaaaaaaaaaaaaaaaaaaaaaaaaaaaaaaaaa
aaaaaaaaaaaaaaaaaaaaaaaaaaaaaaaaaaaaaaaaaaaaaaaaaaaaaaaaaaaaaaaaaaaaaaaaaaaaaaaaaaaaaaaaaaaaaaaaaaaa
aaaaaaaaaaaaaaaaaaaaaaaaaaaaaaaaaaaaaaaaaaaaaaaaaaaaaaaaaaaaaaaaaaaaaaaaaaaaaaaaaaaaaaaaaaaaaaaaaaaa
aaaaaaaaaaaaaaaaaaaaaaaaaaaaaaaaaaaaaaaaaaaaaaaaaaaaaaaaaaaaaaaaaaaaaaaaaaaaaaaaaaaaaaaaaaaaaaaaaaaa
aaaaaaaaaaaaaaaaaaaaaaaaaaaaaaaaaaaaaaaaaaaaaaaaaaaaaaaaaaaaaaaaaaaaaaaaaaaaaaaaaaaaaaaaaaaaaaaaaaaa
aaaaaaaaaaaaaaaaaaaaaaaaaaaaaaaaaaaaaaaaaaaaaaaaaaaaaaaaaaaaaaaaaaaaaaaaaaaaaaaaaaaaaaaaaaaaaaaaaaaa
aaaaaaaaaaaaaaaaaaaaaaaaaaaaaaaaaaaaaaaaaaaaaaaaaaaaaaaaaaaaaaaaaaaaaaaaaaaaaaaaaaaaaaaaaaaaaaaaaaaa
aaaaaaaaaaaaaaaaaaaaaaaaaaaaaaaaaaaaaaaaaaaaaaaaaaaaaaaaaaaaaaaaaaaaaaaaaaaaaaaaaaaaaaaaaaaaaaaaaaaa
aaaaaaaaaaaaaaaaaaaaaaaaaaaaaaaaaaaaaaaaaaaaaaaaaaaaaaaaaaaaaaaaaaaaaaaaaaaaaaaaaaaaaaaaaaaaaaaaaaaa
aaaaaaaaaaaaaaaaaaaaaaaaaaaaaaaaaaaaaaaaaaaaaaaaaaaaaaaaaaaaaaaaaaaaaaaaaaaaaaaaaaaaaaaaaaaaaaaaaaaa
aaaaaaaaaaaaaaaaaaaaaaaaaaaaaaaaaaaaaaaaaaaaaaaaaaaaaaaaaaaaaaaaaaaaaaaaaaaaaaaaaaaaaaaaaaaaaaaaaaaa
aaaaaaaaaaaaaaaaaaaaaaaaaaaaaaaaaaaaaaaaaaaaaaaaaaaaaaaaaaaaaaaaaaaaaaaaaaaaaaaaaaaaaaaaaaaaaaaaaaaa
aaaaaaaaaaaaaaaaaaaaaaaaaaaaaaaaaaaaaaaaaaaaaaaaaaaaaaaaaaaaaaaaaaaaaaaaaaaaaaaaaaaaaaaaaaaaaaaaaaaa
aaaaaaaaaaaaaaaaaaaaaaaaaaaaaaaaaaaaaaaaaaaaaaaaaaaaaaaaaaaaaaaaaaaaaaaaaaaaaaaaaaaaaaaaaaaaaaaaaaaa
aaaaaaaaaaaaaaaaaaaaaaaaaaaaaaaaaaaaaaaaaaaaaaaaaaaaaaaaaaaaaaaaaaaaaaaaaaaaaaaaaaaaaaaaaaaaaaaaaaaa
aaaaaaaaaaaaaaaaaaaaaaaaaaaaaaaaaaaaaaaaaaaaaaaaaaaaaaaaaaaaaaaaaaaaaaaaaaaaaaaaaaaaaaaaaaaaaaaaaaaa
aaaaaaaaaaaaaaaaaaaaaaaaaaaaaaaaaaaaaaaaaaaaaaaaaaaaaaaaaaaaaaaaaaaaaaaaaaaaaaaaaaaaaaaaaaaaaaaaaaaa
aaaaaaaaaaaaaaaaaaaaaaaaaaaaaaaaaaaaaaaaaaaaaaaaaaaaaaaaaaaaaaaaaaaaaaaaaaaaaaaaaaaaaaaaaaaaaaaaaaaa
aaaaaaaaaaaaaaaaaaaaaaaaaaaaaaaaaaaaaaaaaaaaaaaaaaaaaaaaaaaaaaaaaaaaaaaaaaaaaaaaaaaaaaaaaaaaaaaaaaaa
aaaaaaaaaaaaaaaaaaaaaaaaaaaaaaaaaaaaaaaaaaaaaaaaaaaaaaaaaaaaaaaaaaaaaaaaaaaaaaaaaaaaaaaaaaaaaaaaaaaa
aaaaaaaaaaaaaaaaaaaaaaaaaaaaaaaaaaaaaaaaaaaaaaaaaaaaaaaaaaaaaaaaaaaaaaaaaaaaaaaaaaaaaaaaaaaaaaaaaaaa
aaaaaaaaaaaaaaaaaaaaaaaaaaaaaaaaaaaaaaaaaaaaaabbbaaaaaaaaaaaaaaaaaaaaaaaaaaaaaaaaaaaaaaaaaaaaaaaaaaa
aaaaaaaaaaaaaaaaaaaaaaaaaaaaaaaaaaaaaaaaaaaaaabcbaaaaaaaaaaaaaaaaaaaaaaaaaaaaaaaaaaaaaaaaaaaaaaaaaaa
aaaaaaaaaaaaaaaaaaaaaaaaaaaaaaaaaaaaaaaaaaaaaabbbaaaaaaaaaaaaaaaaaaaaaaaaaaaaaaaaaaaaaaaaaaaaaaaaaaa
aaaaaaaaaaaaaaaaaaaaaaaaaaaaaaaaaaaaaaaaaaaaaaaaaaaaaaaaaaaaaaaaaaaaaaaaaaaaaaaaaaaaaaaaaaaaaaaaaaaa
aaaadddddddddddddddddddddddddddddddddddddddddddaeeeeeeeeeeeeeeeeeeeeeeeeeeeeeeeeeeeeeeeeeeeeeeeeeaaa
aaaadfghihjhihjhihjhihjhihjhihjhihjkilmkilmkigdaefgnopqnopqnopqnopqnopqnopqnopqropfropfropfropfgeaaa
aaaadfglnoplnoplnoplnoplnoplnoplnopogqiogqioggdaefghihjhihjhihjhihjhihjhihjhihjkilmkilmkilmkilmgeaaa
aaaadsoropfropfropfropfropfropfropfihjnihjnihgdaefglnoplnoplnoplnoplnoplnoplnopogqiogqiogqiogqigeaaa
aaaadsikilmkilmkilmkilmkilmkilmkilmnopqnopqnogdaesoropfropfropfropfropfropfropfihjnihjnihjnihjngeaaa
aaaadgkogqiogqiogqiogqiogqiogqiogqihkgghkfggggdaesikilmkilmkilmkilmkilmkilmkilmnopqnopqnopqnopqreaaa
aaaadngihjnihjnihjnihjnihjnihjnihjngrfgmgrfgggdaegkogqiogqiogqiogqiogqiogqiogqihkgghkfggghkfgghkeaaa
aaaadlhnopqnopqnopqnopqnopqnopqnopqhkfgghkfgggdaengihjnihjnihjnihjnihjnihjnihjngrfgmgrfggggfggggeaaa
aaaadninopqnopqnopqfgggkfgkfgggkilmfggggfgggigdaelhnopqnopqnopqnopqnopqnopqnopqhkfgghkfggggfggggeaaa
aaaadomhihjhihjhihjfimngfngfimnogqifgimgfgigmgdaeninopqnopqnopqfgggkfgkfgggkilmfggggfgggimgfgimgeaaa
aaaadhglnoplnoplnopfmglhflhfmglihjnfgmgrfgmgggdaeomhihjhihjhihjfimngfngfimnogqifgimgfgigmgrfgmgreaaa
aaaadshropfropfropffgonifnifgonnopqfgmgkfgghkidaehglnoplnoplnopfmglhflhfmglihjnfgmgrfgmgghkfgghkeaaa
aaaadomkilmkilmkilmfhsomfomfhsohihjhihjhihjhimdaeshropfropfropffgonifnifgonnopqfgmgkfgghkfggggggeaaa
aaaadggogqiogqiogqifgghgfhgfgghlnoplnoplnoplngdaeomkilmkilmkilmfhsomfomfhsohihjhihjhihjhihjhihjgeaaa
aaaadggihjnihjnihjnfghshfshfghsropfropfropfrogdaeggogqiogqiogqifgghgfhgfgghlnoplnoplnoplnoplnopgeaaa
aaaadfgnopqnopqnopqfglomfomfglokilmkilmkilmkigdaeggihjnihjnihjnfghshfshfghsropfropfropfropfropfgeaaa
aaaadfgnopqnopqnopqfgggmtttttttgmgiogqiogqioggdaefgnopqnopqnopqfglomfomfglokilmkilmkilmkilmkilmgeaaa
aaaadfgnopqnopqnopqfgffftuuuuutfffnihjnihjnihgdaefgnopqnopqnopqfggmgtttttttogqiogqiogqiogqiogqireaaa
aaaadfghihjhihjhihjkfffftuuuuutfffqnopqnopqnogdaefghihjhihjhihjkfffftvvvvvtihjnihjnihjnihjnihjnkeaaa
aaaadfglnoplnoplnopofftttuuuuutttfjhihjhihjhigdaefglnoplnoplnopofffftvvvvvtnopqnopqnopqnopqnopqoeaaa
aaaadfgropfropfropfifftuuuuuuuuutfplnoplnoplngdaefgropfropfropfifftttvvvvvtttfjhihjhihjhihjhihjieaaa
aaaadfgkilmkilmkilmofttuuuuuuuuuttfropfropfrogdaefgkilmkilmkilmofftvvvvvvvvvtfplnoplnoplnoplnopkeaaa
aaaadfgogqiogqiogqihftuuuuuuuuuuutmkilmkilmkigdaefgogqiogqiogqihfttvvvvvvvvvttfropfropfropfropfgeaaa
aaaadfgihjnihjnihjngftuuuuuuuuuuutiogqiogqioggdaefgihjnihjnihjngftvvvvvvvvvvvtmkilmkilmkilmkilmheaaa
aaaadfinopqnopqnopqhftuuuuuuuuuuutnihjnihjnihidaefinopqnopqnopqhftvvvvvvvvvvvtiogqiogqiogqiogqiieaaa
aaaadfmnopqnopqnopqffttuuuuuuuuuttqnopqnopqnomdaefmnopqnopqnopqfftvvvvvvvvvvvtnihjnihjnihjnihjnmeaaa
aaaadfghihjhihjhihjifftuuuuuuuuutfjhihjhihjhigdaefghihjhihjhihjifttvvvvvvvvvttqnopqnopqnopqnopqgeaaa
aaaadfhlnoplnoplnopgfftuuuuuuuuutfplnoplnoplnhdaefhlnoplnoplnopgfftvvvvvvvvvtfjhihjhihjhihjhihjheaaa
aaaadfgropfropfropfgfftuuuuuuuuutffropfropfrogdaefgropfropfropfgfftvvvvvvvvvtfplnoplnoplnoplnopmeaaa
aaaadggkilmkilmkilmffttuuuuuuuuuttmkilmkilmkigdaeggkilmkilmkilmffftvvvvvvvvvtffropfropfropfropfgeaaa
aaaadggogqiogqiogqifftuuuuuuuuuuutiogqiogqioggdaeggogqiogqiogqiffttvvvvvvvvvttmkilmkilmkilmkilmkeaaa
aaaadgfihjnihjnihjnfftuuuuuuuuuuutnihjnihjnihgdaegfihjnihjnihjnfftvvvvvvvvvvvtiogqiogqiogqiogqioeaaa
aaaadgfnopqnopqnopqfftuuuuuuuuuuutqnopqnopqnoidaegfnopqnopqnopqfftvvvvvvvvvvvtnihjnihjnihjnihjnieaaa
aaaadgfnopqnopqnopqfftuuuuuuuuuuutjhihjhihjhimdaegfnopqnopqnopqfftvvvvvvvvvvvtqnopqnopqnopqnopqkeaaa
aaaadrfhihjhihjhihjfftuuuuuuuuuuutplnoplnoplngdaerfhihjhihjhihjfftvvvvvvvvvvvtjhihjhihjhihjhihjgeaaa
aaaadkflnoplnoplnopfftttuuuuuuutttfropfropfroodaekflnoplnoplnopfftvvvvvvvvvvvtplnoplnoplnoplnopheaaa
aaaadofropfropfropfffftttutttutttfmkilmkilmkigdaeofropfropfropffftttvvvvvvvtttfropfropfropfropfieaaa
aaaadifkilmkilmkilmfffwuuutftuuutfiogqiogqioggdaeifkilmkilmkilmffftttvtttvtttfmkilmkilmkilmkilmmeaaa
aaaadkfogqiogqiogqiffftttttftttttfnihjnihjnihmdaekfogqiogqiogqifffxvvvtftvvvtfiogqiogqiogqiogqigeaaa
aaaadgfihjnihjnihjnffgggggggggggggggggjmglhfmgdaegfihjnihjnihjnffftttttftttttfnihjnihjnihjnihjnheaaa
aaaadhfnopqnopqnopqfffffffffffffffqnopqnopqngodaehfnopqnopqnopqfffffffffffffffqnopqnopqnopqnopqmeaaa
aaaadggnopqnopqnopqnopqnopqnopqnopqnopqnopqnggdaeggnopqnopqnopqnopqnopqnopqnopqnopqnopqnopqnopqgeaaa
aaaadgghihjhihjhihjhihjhihjhihjhihjhihjhihjhggdaegghihjhihjhihjhihjhihjhihjhihjhihjhihjhihjhihjgeaaa
aaaadfglnoplnoplnoplnoplnoplnoplnoplnoplnoplggdaefglnoplnoplnoplnoplnoplnoplnoplnoplnoplnoplnopgeaaa
aaaadfgropfropfropfropfropfropfropfropfropfrggdaefgropfropfropfropfropfropfropfropfropfropfropfgeaaa
aaaadfgkilmkilmkilmkilmkilmkilmkilmkilmkilmkmgdaefgkilmkilmkilmkilmkilmkilmkilmkilmkilmkilmkilmgeaaa
aaaadfgogqiogqiogqiogqiogqiogqiogqiogqiogqioggdaefgogqiogqiogqiogqiogqiogqiogqiogqiogqiogqiogqireaaa
aaaadfgihjnihjnihjnihjnihjnihjnihjnihjnihjnihgdaefgihjnihjnihjnihjnihjnihjnihjnihjnihjnihjnihjnkeaaa
aaaadfgnopqnopqnopqnopqnopqnopqnopqnopqnopqnsgdaefgnopqnopqnopqnopqnopqnopqnopqnopqnopqnopqnopqoeaaa
aaaadfggsiggsifggsiggsifggsifggsifggsiggsifgsgdaefggsiggsifggsiggsifggsifggsifggsiggsifggsifggsieaaa
aaaadfgggkgggkfgggkgggkfgggkfgggkfgggkgggkfgggdaefgggkgggkfgggkgggkfgggkfgggkfgggkgggkfgggkfgggkeaaa
aaaadfimngimngfimngimngfimngfimngfimngimngfinidaefimngimngfimngimngfimngfimngfimngimngfimngfimngeaaa
aaaadfmglhmglhfmglhmglhfmglhfmglhfmglhmglhfmlmdaefmglhmglhfmglhmglhfmglhfmglhfmglhmglhfmglhfmglheaaa
aaaadfgonigonifgonigonifgonifgonifgonigonifgngdaefgonigonifgonigonifgonifgonifgonigonifgonifgonieaaa
aaaadfhsomhsomfhsomhsomfhsomfhsomfhsomhsomfhohdaefhsomhsomfhsomhsomfhsomfhsomfhsomhsomfhsomfhsomeaaa
aaaadfgghggghgfgghggghgfgghgfgghgfgghggghgfghgdaefgghggghgfgghggghgfgghgfgghgfgghggghgfgghgfgghgeaaa
aaaadddddddddddddddddddddddddddddddddddddddddddaeeeeeeeeeeeeeeeeeeeeeeeeeeeeeeeeeeeeeeeeeeeeeeeeeaaa
aaaaaaaaaaaaaaaaaaaaaaaaaaaaaaaaaaaaaaaaaaaaaaaaaaaaaaaaaaaaaaaaaaaaaaaaaaaaaaaaaaaaaaaaaaaaaaaaaaaa
aaaaaaaaaaaaaaaaaaaaaaaaaaaaaaaaaaaaaaaaaaaaaaaaaaaaaaaaaaaaaaaaaaaaaaaaaaaaaaaaaaaaaaaaaaaaaaaaaaaa
aaaaaaaaaaaaaaaaaaaaaaaaaaaaaaaaaaaaaaaaaaaaaaaaaaaaaaaaaaaaaaaaaaaaaaaaaaaaaaaaaaaaaaaaaaaaaaaaaaaa
"}
