"a" = (/turf/closed/mineral/rogue/bedrock,/area/rogue/outdoors/mountains/decap)
"b" = (/turf/closed,/area/rogue/outdoors/mountains/decap)
"c" = (/turf/open/water/cleanshallow,/area/rogue/outdoors/mountains/decap)
"d" = (/turf/open/water/swamp,/area/rogue/outdoors/mountains/decap)
"j" = (/obj/structure/fluff/traveltile{aportalgoesto = "decapout"; aportalid = "decapin"; aallmig = "rwfielddecap"},/turf/open/floor/rogue/dirt/road,/area/rogue/outdoors/mountains/decap)
"k" = (/turf/closed/wall/mineral/rogue/craftstone,/area/rogue/outdoors/mountains/decap)
"o" = (/obj/effect/landmark/start/adventurerlate{icon_state = "arrow"; dir = 4},/turf/open/floor/rogue/dirt,/area/rogue/outdoors/mountains/decap)
"s" = (/obj/machinery/light/rogue/firebowl/standing,/obj/structure/bars,/turf/open/floor/rogue/dirt/road,/area/rogue/outdoors/mountains/decap)
"u" = (/turf/open/floor/rogue/hexstone,/area/rogue/outdoors/mountains/decap)
"z" = (/obj/structure/portal,/obj/structure/bars,/turf/open/floor/rogue/dirt/road,/area/rogue/outdoors/mountains/decap)
"B" = (/obj/effect/landmark/mapGenerator/rogue/decap{endTurfX = 128; endTurfY = 128},/turf/closed/mineral/rogue/bedrock,/area/rogue/outdoors/mountains/decap)
"D" = (/turf/open/lava,/area/rogue/outdoors/mountains/decap)
"E" = (/obj/structure/bars,/turf/open/floor/rogue/dirt/road,/area/rogue/outdoors/mountains/decap)
"F" = (/obj/effect/landmark/start/adventurerlate{icon_state = "arrow"; dir = 1},/turf/open/floor/rogue/dirt,/area/rogue/outdoors/mountains/decap)
"G" = (/obj/machinery/light/rogue/campfire,/turf/open/floor/rogue/dirt/road,/area/rogue/outdoors/mountains/decap)
"H" = (/obj/effect/landmark/start/adventurerlate{icon_state = "arrow"; dir = 8},/turf/open/floor/rogue/dirt,/area/rogue/outdoors/mountains/decap)
"I" = (/turf/closed/mineral/random/rogue/high,/area/rogue/outdoors/mountains/decap)
"J" = (/obj/effect/landmark/start/adventurerlate,/turf/open/floor/rogue/dirt,/area/rogue/outdoors/mountains/decap)
"M" = (/turf/open/floor/rogue/volcanic,/area/rogue/outdoors/mountains/decap)
"Q" = (/obj/effect/landmark/start/adventurerlate,/turf/open/floor/rogue/dirt/road,/area/rogue/outdoors/mountains/decap)
"S" = (/turf/open/floor/rogue/dirt/road,/area/rogue/outdoors/mountains/decap)
"T" = (/obj/effect/landmark/start/adventurerlate{icon_state = "arrow"; dir = 8},/turf/open/floor/rogue/dirt/road,/area/rogue/outdoors/mountains/decap)
"U" = (/turf/open/floor/rogue/dirt,/area/rogue/outdoors/mountains/decap)
"V" = (/obj/machinery/light/rogue/firebowl/standing,/turf/open/floor/rogue/hexstone,/area/rogue/outdoors/mountains/decap)
"Y" = (/obj/structure/fluff/traveltile{aportalgoesto = "forestdecapin"; aportalid = "forestdecapout"},/turf/open/floor/rogue/dirt/road,/area/rogue/outdoors/mountains/decap)
"Z" = (/obj/effect/landmark/start/adventurerlate{icon_state = "arrow"; dir = 4},/turf/open/floor/rogue/dirt/road,/area/rogue/outdoors/mountains/decap)

(1,1,1) = {"
bbbbbbbbbbbbbbbbbbbbbbbbbbbbbbbbbbbbbbbbbbbbbbbbbbbbbbbbbbbbbbbbbbbbbbbbbbbbbbbbbbbbbbbbbbbbbbbbbbbbbbbbbbbbbbbbbbbbbbbbbbbbbbbb
aaaaaaaaaaaaaaaaaaaaaaaaaaaaaaaaaaaaaaaaaaaaaaaaaaaaaaaaaaaaaaaaaaaaaaaaaaaaaaaaaaaaaaaaaaaaaaaaaaaaaaaaaaaaaaaaaaaaaaaaaaaaaaaa
aaIIIIIIIIIIIIIIIIIIIIIIIIIIIIIIIaaaaaaaaaaaaaaaaaaaaaaaaaaaaaaaaaaaaaaaaaaaaaaaaaaaaaaaaaaaaaaaaaaaaaaaaaaaaaaaaaaaaaaaaaaaaaaa
aaDDDDIIIIIIIIIIIIIIIIIIIIIIIIIaaaaaaaaaaaaaaaaaaaaaaaaaaaaaaaaaaaaaaaaaasEEsaaaaaaaIIIIIIIIIIIIIIIIIIIIIIIIIIIIIIIIIaaaaaaaaaaa
aaIIIDDDDDIIIIIIIIIIIIIIIIIIIIaaaaaaaaaaaaaaaaaaaaaaaaaaaaaaaaaaaaaaaaaaaEEEEaaaaaaaIIIIIIIIIIIIIIIIIIIIIIIIIIIIIIIIIaaaaaaaaaaa
aaaaaaaIIIDDDDIIIIIIIIIIIIIIIIaaaaaaaaaaaaaaaaaaSSaaaaaaaaaaaaaaaaaaaaaakzSSEkaaaIIIIIIIIIIIIIIIIIIIIIIIIIIIIIIIIIIIIaaaaaaaaaaa
aaaaaaaIIIIIIDDDDDDDDIIIIIIUUUaaIaaaaaaaaaaaaaaaaSSaaaaaaaaaaaaaaaSaaaaakVuuVkaaaIIIIIIIIIIIIIIIIIIIIIIIIIIIIIIIIIIIIaaaaaaaaaaa
aaaaSSSIIIIIIIIIIIUDDDDDDDDDUDDDDDDDDDDDDDDDDaaaSSSSaSaaaaaaSSSaaaSSaaaakuuuukaIIIIIIIIIIIIIIIIIIIIIIIIIIIIIIIIIIIIIIaaaaaaaaaaa
aaSSSGSIIIIIIIIIIUUUUUUUUUIDDDDDDDDDDDDDDDDDDaaaaaSSaSSaaSSSSSSSSSSSSSSSkuuuukaIIIIIIIIIIIIIIIIIIIIIIIIIIIIIIIIIIIIIIaaaaaaaaaaa
aaYSSSSIISSSSSSSSSSSSUUUUUUUUUaaaaaaaaUUUUUUDUUUUIIDDIIIDDDDDDDDDDDDDDDDMMMMMMDDDDDDDDDDIIDDDDDDDDDDDDIDIIaaaaIIIIIIIaaaaaaaaaaa
aaYSSSSSSSSSSSSSSSSSSSSSSSSSSSIIIIIIIaUUUUUUDUUUUIIIDIIIIIIDDDDDDDDDDDDMMMMMMMDDDDDDDDDDDDDDDDDDDDDDDDDDIIaaaaIIIIIIIaaaaaaaaaaa
aaSSSIIIIIIIIIIIIUUUSSSSSSSSSSIIIIIIIaUIUIUUDUUUIUIIDIIIIIIDDDDDDDDDDDDMMUUUMMDDDDDDDDDDDDDDDDDDDDDDDDDDDIaaaaIIIIIIIaaaaaaaaaaa
aaaaaaaIIIIIIIIIIUUUSUUUUUUIIIIIIIIIIIUIUUUUDUUUUUIIDIIIIIIDDDDDDDDDDDDDMMUUMMDDDDDDDDDDDDDDDDDDDDDDDDDDDDaaaaIIIIIIIaaaaaaaaaaa
aaaaaaaIIIIIIIIIIUUUSUUoUUUIIIIIIIIIIIUUUUUUDUUUUIIIDDIIIIIDDDDDDDDDDDDMMMUUMMMDDDDDDDDDDDDDDDDDDDDDDDDDIDaaaaIIIIIIIaaaaaaaaaaa
aaaaaaaIIIIIIIIIIUUUSUUUUUIIIIIIIIIIIIUUUUUUDDDDDDDDDDIIIIIDDDDDDDDDDDMMMUUUUUMMMDDDDDDDDDDDDDDDDDDDDDDDDDaaaaIIIIIIIaaaaaaaaaaa
aaaaaaaaIIIIIIIIIUUUSUUUUUIIIIaaaaaaIIUUUUUUIIIUUIUIDDIIIIIDDDDDDDDDDDMMUUUUUUUUMMMDDDDDDDDDDDDDDDDDDDDDDDaaaaIIIIIIIaaaaaaaaaaa
aaaaaaaaIIIIIIIIIUUUSUUUUUIIIaaaaaaaIIIIIIIIIIIIIUUIDDIIDIIDDDDDDDDDMMMUUUUUUUUUUMMMDDDDDDDDDDDDDDDDDDDDDDaaaaIIIIIIIaaaaaaaaaaa
aaaaIIIIIIIIIIIIIUUUSUUUUUIIIaaaaaaIIIIIIIIIIIIIIUUIIDDIDDDDDDDDDDDMMMUUUUUUUUUUUUMDDDDDDDDDDDDDDDDDDDDDDDaaaaIIIIIIIaaaaaaaaaaa
aaIIIIIIIIIIIIIIIUUUSUUUUUIIIaaIIIIIIIIIIIIIIIIIIIIIIIDDIDDDDDDDDDDMMUUUUUcUUUUUUUMMDDDDDDDDDDDDDDDDDDDDDDaaaaIIIIIIIaaaaaaaaaaa
aaIIIIIIIIIIIIIUUUUUSUUIIIIIIaaIIIIIaaIIIIIIIIIIIIIIIIDDIDDDDDDDDMDMUUUUUUUUUUUUUMMMDDDDDDDDDDDDDDDDDDDDDDaaaaIIIIIIIaaaaaaaaaaa
aaDDDDDDIIIIIIIUUUUUSUUUUIIIIaaIIIIIaaIIIIIIIIIIIIIIIIDDDIDDDDDDDMMMUUUUUUUUUUUUUMMDDDDDDDDDDDDDDDDDDDDDDDaaaaIIIIIIIaaaaaaaaaaa
aaIIIIIDDDDDDDDUUUUUSUUUUUUUIaaIIIIIaaIIIIIIIIIIIIIIIIIDDIDDDDDDDDMMMUUUUUUUUUUUMMDDDDDDDDDDDDDDDDDDDDDDDDaaaaIIIIIIIaaaaaaaaaaa
aaIIIIIIIIIIIIDDDDDDDDDDDDDDDDDDDDDDDDDDDDDDDDDDMIIIIIIDDDDDDDDDDDMMMUUUUUUUUUUMMDDDDDDDDDDDDDDDDDDDDDDDDDaaaaIIIIIIIaaaaaaaaaaa
aaIIIIIIIIIIIIIIIUUUSUUUUUUUaaaIIIIaaaMMMMMMMDDDMMIIIIIDDDDDDDDDDDDMMMUUUUUUUUMMMMDDDDDDDDDDDDDDDDDDDDDDDDaaaaIIIIIIIaaaaaaaaaaa
aaIIIIIIIIIIIIIIIIIISUUUUUUUaaaIIIIaaaIIIIIIMDDDDMIIIIIIDDDDDDDDDDDDDMMMUUUMMMMMDDDDDDDDDDDDDDDDDDDDDDDDDDaaaaIIIIIIIaaaaaaaaaaa
aaaaaaIIIIIIIIIIIIIISUUSUUUUaaaIIIIaaaIIIIIIMDDDMMIIIIIIDIDDDDDDDDDDDMDMMMMMMMMDDDDDDDDDDDDDDDDDDDDDDDDDDDaaaaIIIIIIIaaaaaaaaaaa
aaaaaaIIIIIIcIIIIIUUSSSSSSSSaaaIIIIaaSIIIIIIMMDMMMIIIIIIIDDDDDDDDDDDDDDDDMMDMDMDDDDDDDDDDDDDDDDDDDDDDDDDDDSaaaIIIIIIIaaaaaaaaaaa
aaaaaaIIIIcccccIUUUUUoUSIIIaaaaIIIIaSSIIIIIIMDDMMMIIIIIIIIDDDDDDDDDDDDDDDDDDDDDDDDDDDDDDDDDDDDDDDDDDDDDDDDSSSaIIIIIIIaaaaaaaaaaa
aaaaaaIIIIIccccIUUUUUUUSUUUaaaaIIIIIIaIIIIIIMDDDDDDDDDDDDDDDDDDDDDDDDDDDDDDDDDDDDDDDDDDDDDDDDDDDDDDDDDDDDDSSSaIIIIIIIaaaaaaaaaaa
aaaaaaIIIIIIcccUUUUUUUUSUUUaaaaIIIIIIIIIIIIIMDDMIIIIIIIIIIDDDDDDDDDDDDDDDDDDDDDDDDDDDDDDDDDDDDDDDDDDDIIIIIaaaaIIIIIIIaaaaaaaaaaa
aaaaIIIIIIIUccUUUUUUUUUSUUUaaaaaaaaaaIIIIIIIMDMMIIIIIIIIIIDDDDDDDDDDDDDDDDDDDDDDDDDDDDDDDDDDDDDDDDDIIIIIIIaaaaIIIIIIIaaaaaaaaaaa
aaaaIIIIIIUIUUUUUUUUUUUSUUUaaaaaaaaaaaIIIIIIMMMIIIIIIIIDIIDDDDDDDDDUUDDDDDDDDDDDDDDDDDDDDDDDDDDDDDDDIIDIIDaaaaIIIIIIIaaaaaaaaaaa
aaaaIIIIIUIIUUUUUUUUUUUSUUUaaaaaaaaaaaIIIIIIMMIIIIIIIIIDIIDDDUUUUUUUUUUUUDIDDIDDDDDDDDIDIDIDIIDIDIIIIIIIIIaaaaIIIIIIIaaaaaaaaaaa
aaIIIIIIIUIIUUUUUUUUUUUSUUUaaaaaaaaaaaIIIIIMMIIIIIIIIIDDIIDDUUIIUUUUUUUUUUUIIIDDDDDIIIIIIIIIIIIIIUUUUUIUIIIIIIIIIIIIIIaaaaaaaaaa
aaIIIIIIIUUIIIUUUUUUUUUSSSSIIIIIIIIIIIIIIIIMMIIIIIIIIIDDIIDDDUIIUUUUUUUUIIUUIIDDDDDDIIIIIIIIIIIIUUUUUUUUUUIIIIIIIIIIIIaaaaaaaaaa
aaIIIIIIUUIIIIUUUUIIIUUSSSSIIIIIIIIIIIIIIIIMMIIIIIIIIIDDIDDDIIIUUUUUUUUUUIUUIIIDDDDDIIIIIIIIIIIIUIUUUUUUUUIIIIIIIIIIIIaaaaaaaaaa
aaIIIIIUUUIIIIUUUUIIIUUSSSSIIIIIIIISSSIIIIIIMIIIIIIIIIDDDDIIIIIUUUUUUUUIIIIDIIIIDDDIDIIIIIIIIIIIIUUUUUUUUUIIIIIIIIIIIIaaaaaaaaaa
aaIIIIIIIIIIUUUUUUIIIUUSUUUIIaaaSSSSSSIIMMMMMIIIIIIIIIDDDDIIIIIUUUUUIUIIIIIDDIIIDDDDDDIIIIIIIIIIUUUUUUUUUUIIIIIIIIIIIIaaaaaaaaaa
aaDDDDDDDDDDUUUUUUIIIIISIIIIIaaaaaaaaaIIMMMMMIIIIIIIIDDDDIIIIIUUUIIIIUIIIIUIDIIIIDDIDDIIIIIIIIIUUUUUUUUUUUIIIIIIIIIIIIaaaaaaaaaa
aaIIIIIIIUUDDDDDDUIIIIISIIIIDDDDDDDDDDDDDDDMMIIIIIIIIIDDDIIIIUUUUIUUIUIIIIUUIIUDIDDDDDDIIIIIIIIUIUUUUUUUUUIIIIIIIIIIIIaaaaaaaaaa
aaaaaaIIIUUUUUUUDDDDDDDDDDDDDDDDDDDDDDDDDDDDMIIIIIIIIDDDDIUUIUUUUUUUUUIIIIUUUIUUIIDDDDDDIIIIIIIUUUUUUUUUUIIIIIIIIIIIIIaaaaaaaaaa
aaaaaaIIIUUUUUUUUUUIIIUSIIIIIaaaaaaaaaMMMMDDDDDDDDDDDDDDDIUUUUIUUUUUUUUUIIUUUUUUDDDDDDDDIIIIIIIIIIUUIUUUMMIIIIIIIIIIIIaaaaaaaaaa
aaaaaaIIIUUUUUUUUUUUUUUSUIIIIaaaaaaaaaMIMMDDMMIIIIIIIDDDUIUIUUUUUUUUUUUUUUUUUUUUUIDDDDDDDIIIIIIIIIIUUIMMMMIIIIIIIIIIIIaaaaaaaaaa
aaaaaaIIIUUUUUUHUUUUUUUSSSIIIIIIIIIIIIIIMMDMMMIIIIIDDDDDUUUUUUUUUUUUUUUUUIUUUUUUUUUIDDDDDIIIIIMMMMMMMMMIIIIIIIIIIIIIIIaaaaaaaaaa
aaaaaaIIIUUUUUUUUUUSSSSSSSIIIIIIIIIIIIIIMMMMMIIIIIIDDDDDUUUUUUUUUUUUUUUUUIUUUUUUUUUIDDDDDDIIIMMIIIIIIIIIIIIIIIIIIIIIIIaaaaaaaaaa
aaIIIIUUUUUUUUUUUUUUUUUSSSIIIaaaaaaaaaIIMMMMIIIIIIIDDDDDDUUUUUUUUUUUUUUIUUUUUUUUUUUUDDDDDDIIMMMMIIIIIIIIIIaaaaaaaaaaaaaaaaaaaaaa
aaIIIIUUUUUUUIIIUUUUUUUSUIIIIaaaaaaaaaDDDDDDDDDDDDDDDDDDDIUUIUUUUUUUUUUUUUUUUUUUUUUUDDDDDDDIMDIMIIIIIIIIIIaaaaaaaaaaaaaaaaaaaaaa
aaDDDDDDDDDDDDIIIUIIIIISIIIIDDDDDDDDDDDIIIMUIIIIIIIIIIDDIIUUUUUUUUUUUIUUUUUUUUUUUUUUDDDDDDDMMDDIIIIIIIIIIISaaaaaaaaaaaaaaaaaaaaa
aaIIIIUUUIIIIDDDDDDDDDDDDDDDDDDDDDDDDDDIIUUUIIIIIIUIUUDDDIUUUUUUUUUUIUIUIUUUUUUUUUUIDIDDDDDMDDDDIIIIIIIIDIaaaaaaaaaaaaaaaaaaaaaa
aaIIIIUUUIIIIIIIIUIIIIISIIIIIaaaaaaaaaIIIUUIUIIIIUUIUUDDDDUUUUUUUUUIIIIUIUUUUUUUUIIIDIIDDDDMDIDDIIIIIIIDDIaaaaaaaaaaaaaaaaaaaaaa
aaIIIIUUUIIIIIIIUUUIIIISIIIIIaaaaaaaaaUIUUUUUUUUUUUUUUDDDDIUUUUUUUIUIIUIIUUUUUUUUIIDDIIDDDDMDDIIDDIIIIIDDDaaaaaaaaaaaaaaaaaaaaaa
aaIIIIIUUIIIIIIIUUUIIIISIIIIIIaIIIIIIIIIaaaaaaaaaaaSSSSDDDaaaaaaSSSSSSaaIIIIaaSSaaaDDaaSSaIIIaaaaaaaaaaDDaaaaaaaaaaaaaaaaaaaaaaa
aaIIIIIUUIIIIIIIUUIIIIISIIIIIIIIIIIIIIIIaaaaaaaaaaaSSSaDDDaaaaaSSSSSaaaaIIIIaaaSSaaDDaaaaaIIIaaaaaaaaaaDDaaaaaaaaaaaaaaaaaaaaaaa
aaIIIIIUUIIIIIIIIUUIIIISIIIIIIIIIIIIIIIIaaaaaaDDDDDDDDDDDDaaaaaSSSSaaaaaIIIIaaaaaaaDDaaaaaIIIaaaaaaaaaaDDaaaaaaaaaaaaaaaaaaaaaaa
aaaIIIIUUIIIIUUUUUUUSSSSSSSIIIIIIIIIIIIIaaaaaaDDDDDDDDDDDDDDaaaSSSSaaaaaIIIIaaaaaaaDDaaaaaIIIaaaaaaaaaaDDaaaaaaaaaaaaaaaaaaaaaaa
aaaIIIIUUIIIIUUUUUUUSUUUUUUIIIIaaaaaaDDDDDDDDDDDDaaSIIIIaDDDaaaaSSaaaaaaIIIIaaaaaaaDDaaaaaIIIaaaaaaaaaaDDaaaaaaaaaaaaaaaaaaaaaaa
aaaIIIIUUIUUUUUUUUUUSUIIIIIIIIDDIaaaaDDDDDDDDDDDDaaIIIIIaDDDaaaaaaaaaaaIIIIIaaaaaaaDDaaaaaaIIaaaaaaaaaaDDaaaaaaaaaaaaaaaaaaaaaaa
aaaIIIIUUUUUUUUUUUUUQSSSUUIIIDDIIaaaaDDDDDDDDDDDDaaIIIIIaDDDDDaaaaaaaaaIIIIIaaaaaaaDDaaaaaaIIaaaaaaaaaaDDaaaaaaaaaaaaaaaaaaaaaaa
aaaIIIIUUUUIUUIIIIUUUUUSUUUDDDIIIaaaaaaDDDDaaaaaaaaIIIIIaaDDDDaaaaaaaaaIIIIIaaaaaaaDDaaaaaIIIaaaaaaaaaaDDaaaaaaaaaaaaaaaaaaaaaaa
aaaaaaIUUHUUUUIIIIUUUUUSUUDDIIIIIIIIaaDDDDDaaaaaaaIIIIIIaaaDDDUSIIaaaaaaIIIIaaaaaaaDDaaaaaIIIIIIaaaaaaaDDaaaaaaaaaaaaaaaaaaaaaaa
aaaaaaIIUUUUUUIIIIUUUUUSDDDUIIIIIIIIaaaDDDDaaaaaaaaIIIIIaaaUUDUSIaaaaaaaIIIIaaaaaaaDDaaaaaIIIIIIaaaaIIIDDaaaIIIaaaaaaaaaaaaaaaaa
aaaaaaIIUUUUUUIIIIIIIDDDDUUUIIIIIIIIIIIDIaaaaaaaaaaaIIIIaaaUUDUSaaaaUUUUUUUUUUIaaaaaDaIIIaaIIIIIaaaaIIIIDIIIaaIIIIIIIaaaaaIIIIIa
aaaaaaUUUUUUUUUIIIIDDDUSUUUUIIIIIIIIIIDIIaaaaaaaaaIIIIIIIIIUUDDSUUUIUUUUUUUUUUIIIIIIDIIIIaaaaIIIIIIIIIIUDDUUUUUUUUUUUUIIIIIIIIIa
aaaaaaUUUUUIIIUIIDDDIIUSUUUUUIIIIIIIIDDIIIIIIIIIIIIIIIIIIIIUUUDSUUUIUUUUUJSSSSSSSSSDDSSSSUUUUUUIIUUUUUIUUDUUUUUUUUUUUUIIIIIIIIIa
aaaaaaUUUUUIIIIDDDIIIIUSUHUUUUIIIIIIIDIIIIIIIIIIIIIIIIIIIIIUUUDSUUUUUUUUUUSSUUUUUUUDUUUUSUUUUUUIIUUUUUUUUDUUUUUUUUUUUUIIIIIIIIIa
aaaaaaUUUUUUIDDDIIUIIIISUUUUUUUIIIIIDDIIIIIIIIIIIIIIIIIIIUIUUUDSUUUUUUUUUUSSUUUUUUUDUUUUSUUUUUUUUUUUUUUUUDUUUUUUUUUUUcUUUIIIIIIa
aaaaaaUUUUUDDDIIIIUIIIISUUUUIIUIIIIDDIIIUUIIIIIIIIIIIIIUUUUUUUDSUUUUUUUUUUSUUUUUUUDDUUUUSUUUUUUUUUUUUUUUUDUUUHUUUUUUUcUUUUUUIIIa
aaaaaaUUUDDDUIIIIUUIIIISUIIIIIIIIIIDIIUUIIUUSIUUIIIIIUIUUUUUUUDSUUUUUUUUUUSIUUUUUUDUUUUUSUUUUUUUUoUUUUUUUDUUUUUUUUUccccccUUUIIIa
aaIIIIUUDDUUUIIIIIUUUSSSIIIIIIIIIIDDIUUUUUUISUIIIUIIUIIUUUIUUUDSSSSSSSSSSSSIUUIIIUDUUUUUSUUUUUUUUUUUUUUUUDUUUUUUUUUUUccccUUUIIIa
aaIIIIUDDUUUIIIUUIIIISUUUIIIIIIIIDDIUUIUUUUUSUUIIUIIUUUUIIIUUUDUUUSSUUUUUUUUUIIIIUDUUUUUSUUUUUUUUUUUUUUUUDUUUIUUUUUUUccUUUIIIIIa
aaIIIDDDUUUUIIUIIIIIISUUIIIIIIIIDDIUUUUUUUUISUUIUIIIIIIIIIIUUUDUUUSTUUUUUUUUUIIIIDDIIUUUSUUUUUUUUUIIIIIUUDUUUIUUUUUUUUcUUIIIIIIa
aaIIDDIUUUUUUUUIIIIIUSUUIIIIIIIIDIIUUUUUUUIISUUUUIIIIIIIIIIUUUDUIISSUUUUUUIIIIIIIDIIIIIISIIIIIIIIIIIUUUUUDUUUIUUUUUUUUUUUIIIIIIa
aaIDDIIUUUUUUUUIIIIIISUUIIIIIIIIDIIUUUUUUUIISUUUUIIIIIIIIIIUUUDUIISSIIIUIIIIIIIIIDIIIIUUSIIIIIIIIIIIUUUUUDUUUIIUUUUUIIIIIIIIIIIa
aaDDIIIIIUUUUUUIIIIIISUIIIIIIIIDDUUUUUUUUUUUSUUUUIIIIIIIIIIUUUDUIISSIIIUUIIUUIIIIDIIIIUUSIUIIIIIIIIIUUUUUDUUUIIUUUUUUUIIIIIIIIIa
aaIIIIIIIUUUUUUUUUSSSSUIIIIIIUUDUUUIIIIUIUSSSUIIIIIIIIIIIIIIIIDIIISSIIIIUUIUIIIIIDIIIIUUSIIIIIIIIIIIUUUUUDIIIIIUUUUUIIIIIIIIIIIa
aaIIIIIIIUUUUUUUHUSUIIUIUUUUUIIDIUIIIIIUUUSUIIIIIIIIIIIIIIIIIUDIIISSIIIIIUUUIIIIDDIIIISSSIIIIIIIIIIIUUUUUDIIIIIUUUIIIIIIIIIIIIIa
aaIIIIIIIUUddUUUUUSUIIIIIIUUIIIDUUUIIIIIUUSUIIIIIIIIIIIIIIIIIUDIIISSIIIIIIIUIIIIDIIIIISUIIIIIIIIIIIIIUIIIDDIIIIIIUIIIIIIIIIIIIIa
aaIIIIIIIIUddUdUUUSUIIIIIIIIIIDDUUIIIIIIUUSUUIIIIIIIIIIIIIIIIUDIIISSIIIIIIIIIIIIDIIUUUSSIUUUIIIIIIIIIUIIIIDIIIIIIUIIIIIIIIIIIIIa
aaIIIIIIIIUdUUdUUUSUUUUIIIIIIUDUUIIIIIIIIUSIIIUUUUUUUUUUUIIIIIDIIISSIIIIIIIIIIIIDIUUUUISUUUUUIIIIIIIIUIIIIDUUIIIIUIIIIIIIIIIIIIa
aaIIIIIIIIUdUUUUUUSUUUUIIUUUUUDIIIIIIIIUUUSUUUUUHUUUUUUUUUUUUUDUUUSSUUUUIIIIIIIIDIUUUIUSUUUUUIIIIIIIIUIIIIDDUIIIIUIIIIIIIIIIIIIa
aaaaIIIIUUddUUddUUSUUUUUUUIUIIDIIIIIIIIUUUSUUUUUUUUUUUUUUUSSSSDSSSSSHUUUIIIIIIIIDIIUUUUSUUUUUUIIIIIIIUIIIIUDDUUIIUIIIIIIIIIIIIIa
aaaaIIddddddUUddUUSUUUUIIIIIIDDIIIIIIUUUUUSUUUUUUUUUIIIUUUSUUUDUUUUUUUUUIIIIIIIIDIIIUUUSUUUUUUIIIIIIIUIIIIUUDUUIIUIIIIIIIIIIIIIa
aaaadIdddUUUUdddUUSUUUUIIIIIIDIIIIIIIUUUUUSUUIIIIIIIIIIIIISUUIDDIIIIIIIIIIIIIIIIDIIIIIISUUUUUUUUUUIIIUUUUUUUDDUUIUIIIIIIIIIIIIIa
aaaaIIdIIUUUUdddUUSUUUUUUUUUUDUUUUUSSSSSSSSUUIIIIIIIIIIIIISUUIDDIIIIIIIIIIIIIIIDDIIIIIISUUUUUUUUIIIIIUUUUUUUUDUUUUUIIIIIIIIIIIIa
aaaaIddIIIUUUUUUUUSSSSSSSSSSDDSSSSSSSSIIIIIIUIIIIIIIIIIIIISUUIDDIIIIIIIIIIIIIIIDIIIIIIUSSUUUUUIUUUUIIUUUUUUUUDDUIIIIIIIIIIIIIIIa
aaIIIdddIIISSSZSSSSSUUIIIIIIDIUUUUUUUSUIIIIIUIIIIIIIIIIIIISUUIIDIIIIIIUIUIIIIIIDIIIIIUUISIUUUIIIIIIIIIIIUUUUUUDUIIIIIIIIIIIIIIIa
aaIIIIIIIIISUUUUUUUUUIUIIUUUDIIIIIIIISUIIIIIUIUUIIIIIIIIIISUUIIDIIIIIUUIIIIIIIIDIIIIUIIUSUIIUUIIIIIIIIIUUUUUUUDDIIIIIIIIIIIIIIIa
aaIIIIIIIUISUIIIIIIIUIUIUUUUDIUUIIIIISUIIIIIUIUUIIIIIIIIUUSUUIIDIIIIIUUIIIIIIIIDIIIUUUUUSUIIIIIIIIIIIIIUUUUUUUUDIIIIIIIIIIIIIIIa
aaaaaIIIIIISUIIIIIUIIUUUUIUIDUUIIIIIISUIIIIIUUUUIIIIIIIUUUSUUUUDUIIUUUUUUIUIIUIDIIUUSSSSSUIIIIIIIIIIIIIUUUUUUUUDDIIIIIIIIIIIIIIa
aaaaaIIIIUISIIIIIIUUUUUUIUUIDIIIIIIIISUIIIIUUUUUIIIIIIIUUUSUUUDDUIIUIIIIIIUUUIIDIIUUSIUIUIIIIIIIIIIIIUUUUUUUUUUUDIIIIIIIIIIIIIIa
aaaaaIIIIIUSIUIIIIIIIIUUIIIDDIIIIIIIISUIIIIUIUUUIIIIIIIUUUSUUUDUUIIUUIIIIUIIIIIDIIIISUUUUIIIIIIUUUIIIUUUUUHUUUUUDDIIIIIIIIIIIIIa
aaaaaIIIIIUSSSSIIIIIIIUUIIIDUIIIIIIIISUIIIIUUIUUIIIIIIIUUUSUUUDUUIIIUIUUUUUIIIIDIIUUSUIUIIIIIIIIIIUUUUUUUUUUUUUIIDDIIIIIIIIIIIIa
aaaaaIIIIIUUIISIIIIIUIUIIIIDUIIIIIUIISUIIIIIUIIUUUIIIIIUUUSSSUDUUIIIUUUIUUUUIIIDIUUISUUIIIIIIIIIIIUUUUUUUUUUUUUIIIDIIIIIIIIIIIIa
aaaaaIIIIIUUIISIIIUUUIIUIIIDUIIIIIUUISUIUUUUUUUUUUIIIIIIUUUUSUDUUUUUUIIIIUUUUIIDIUUUSIIIIIIIIUIIIIUUUUUUUUUUUUUIIIDDIIIIIIIIIIIa
aaaaaIIIIIIUIISIIIIUUIIIIIIDUIIIUIIUUSUUUIUUUUUUUUIIIIIIIUUUSUDUUUHUUUUIIUUUIIIDUUIISIIUIIIIISSSSSSSSSSSSSSSSSUUIIIDIIIIIUUIIIIa
aaaaaIIIIIIUUUSIIIIIIIUIUIDDUIIIUIIIISSSUUUUUUUUcUIIIIIIIIIISUDUUUUUUIUIUIIUIIIDUIIISUIIIIIIISIIIIUUUUUUUIIIUSUUIIIDDIIIIUUIIIIa
aaaaaIIIIIIUUUSIIIIIIIIUIUDIUIIIUIIIIIUSUUUUUccccUIIIIIIIIIISIDIIIIIIIIIIIIUUIIDSSSSSUIIIIIIISIIIIUUUUUUUIIIUSUUIIIIDDUUUUUIIIIa
aaaaaIIIIIIIUUSIIIIIIUUUUUDSSSSSSSSSSSSSUHUUUccccUIIIIIIIIIISIDIIIIIIIIIIIIUSSSDSUUIIIUIIIIIISIIIIIIIUIIIIIIUSUUIIIIIDUUUUUIIIIa
aaaaaIIIIIIIUUSUUUIUIUUUUDDSUUUUIIIIUUUUUUUUUccccUIIIUUIUIIISIDDIIIIIIIIIIUUSUIDIIUUUUIIIIIIISIIIIIIIUIIIIIIUSUUIIIIIDUUUUUIIIIa
aaaaaIIIIIIIIUSUUUIUIUUUUDUSUUUIIIIIIIUUUUUUUUccUUIIIUIIUUIUSUIDIIIIIIIIIUUUSUIDIIIIIIIIIIIIISIIIIIIIUUIIIIIUSUUIIIIIDUUUUUUUIIa
aaaaaIIIIIIIIUSUUUIUUUUUUDUSSSSSSIIIIIIIIIIUUUccUUIIIUIIUUSSSUUDIIIIIIIIIIUUSUUDUUUIIIIIIIIIISIIIIIIIUUIIIIIUSUUIIIIIDDUUUUUUIIa
aaaaaIIIIIIIIISIIIIUUUUUUDUUUUUUSSSSSIIIIIIIIUUUUUIIIUUIUISUUIIDIIIIIIIIIIUUSSSDUUUIIIIIIIIIISIIIIIUUUUIIIIIUSSSSSSSSSDDUUUUUIIa
aaaaaIIIIIIIIISSSIIIUUUUUDUUUUUUUUUUSIIIIIIIIUIIUUIIIIUUUUSIIIIDIIIIIIIUUUUUUUUDDUUIIIIIIIIIISIIUUUUUUUIIIIIUUUUUUUIIUUDUUUUUIIa
aaaaaIIIIIIIIIIISSSSSSSUUDUUUUUUUUUUSIIIIIIIIUIIIIIIIIIIUUSUUIIDIIIIIUUUUUUUUUUSDUUIIIIIIIIUUSUUUIIUUIIIIIIIUUUUIIIIIIUDUUUUUIIa
aaaaaIIIIIIIIIIIUUUUUUSUUDUUUUUUUUUUSSSSSSSSSSUIIIIIIIIIUISUIIIDIIIIIUUUUUUUUUUSDUUIIIIIUUUUUSUUUIIIIIIIIIIIUUUUIIIIIUUDUFUUUIIa
aaaaaIIIIIIIIIIUUUUUUUSUDDIUUUUFUUUUUUUUUUUUUSUUUUIIIIIIIISUUIUDUIIIIUUUUFUUUUUSDUUIIIIIUUUUUSSSSSSSSSSSSSSSSSUUIIIIIUUDUUUUUIIa
aaaaaIIIIIIIIUUIIIIUUUSUDUUUUUUUUUUUUIIIIIIIISUUUUIIIIIIIISUUUUDUIIIIUUUUUUUUUUSDUUIIIIIIUUUHSUUUIIIIIIIIIIIUSUUIIIIIUUDUUUUUIIa
aaaaaIIIIIIIIUIIIIIUUUSUDUUUUUUUUUUUUIIIIIIUUSUUUUUIIIUUUUSUUUUDUUUIIUUUUUUUUUUSDUUUUUUUUUUUUSUUUIIIIIIIIIIIUSSSSSSSSSSDUUUIIIIa
aaaaaIIIIIIUUIIIIIIUUUSUDUUUUUUUUUUUUIUUIIIUUSSSSSSSSIUUUUSUUUUDDUUIIUUUUUUUUUUSDSSSSSSSSSSSSSUUUIIIIIIIIIIIUSUUUUUUUUIDIUUUIIIa
aaaaaIIIIIIUIIIIIIIUUUSUDUUUUUUUUUUUUIIUUIIIUIIUUUUUSIUUUUSUUUUUDUUIIIIIIUUUUUUUDUUUIIIIIIIUSIIIIIIIIIIIIIIIUSUUIIIIIIIDIUUUIIIa
aaIIIIIIIIIUIIIIIIIUUUSUDUUUUUUUUUUUUIIIUUIIUUUUUUUISSSSSZSUUUUUDUUIIIIIIIIUUUUUDUUUIIIIIIUUSUUIIIIIIIIIIIIIISUIIIIIIIIDIUUUIIIa
aaIIIIIIIIIUUIIIIIIUUUSUDUUUUUUUUUUUUIIUUIUUUUIUUUUIUIUUUUUUUUUUDUUIIIIIIIIUUUUUDUUUIIIIIUUISSSUIIIIIUUUUIIIUSUIIIIIIIIDIIIIIIIa
aaIIIIIIIIUUUIIIIIIUUUSUDUUUUUUIUUUUUUUIUIUUIUIUUIIIIIUUUUUUUUUUDUUIIIIIIIIUUUUUDUIIIIIIUUIUUUSUIIIISSSSSSSSSSUUUIIIIIDDIIIIIIIa
aaIIIIIcccUIIIIIIaaUUUSUDUUUUUUIIUUUUUUUUUUIIUIUUIIIIIIUUUUUUUUUDUUUUIIIIIIUUIUUDUIIIIIIUUUUUISSSSSSSUUUUUUUIUUIIIIIIIDIIIIIIIIa
aaIIIcccccUIIIIIIaaUUUSUDIIIIIIIIUUUUUUIIIIIIUIUUUIIIIIUUUUUUUUUDUUUUIIIIIIUUIIIDUUUUUUUUIIIIIIIIIIIUUIIIIIIIIIIIIIIIIDIIIIIIIIa
aaIIIIcIcUUIIaaaaaaUUUSUDIIUUIIIIUUUUUUIIIIUIUIIUUIIIIIIIIUUUUIIDIIIIIIIIIIUUIIIDUUUIUUUIIIIIIIIIIIIIIIIIIIIIIIIIIIIIIDIIIIIIIIa
aaIIIIIIcUUIIaaaaaaaaaSUDIIIUUUUUUUUUUUUIIIUUUUIUUIIIIIIIIUUUUIIDDIIIIIIIIIUUIIDDIIUUUUUUIIIIIIIIIIIIIIIIIIIIIIIIIIIIDDIIIIIIIIa
aaIIIIIIIIIUUaaaaaaaaUSUDDIIIIIUUIIIIUUUUIIUIUUIUUUUUUIIIIUUUUIIIDIIIIIIIIIUUIIDIIIIIIIUUIIIIIIIIIIIIIIIIIIIIIIIIIIIDDIIIIIIIIIa
aaIIIIIIIIIIUaaaaaaSSUSUUDDDIIIUUIIIIIUUUIIUUUUUUUUUUUUUUUUUUUUUUDUUUUUUUUUUUIIDIIIIIIIIIIIIIIIIIIIIIIIIIIIIIIIIIIIIDIIIIIIIIIIa
aaaaIIIIIIIIIUUUUaaSSUSUUUUDDIIUUUUIUUIUUIIUUUUUUUIIIIIIIIIIIIIIIDIIIIIIIIIUUIIDIIIIIIIIIIIIIIIIIIIIIIIIIIIIIIIIIIIDDIIIIIIIIIIa
aaaaaaaaIIIIIIUUUUUSSUSUUUUUDDIIIIUUUUIIUIIUUUUUUUIIIIIUUUUUUUIIIDIIIIIIIIIIIIIDIIIIIIIIIIIIIIIIIIIIIIIIIIIIIIIIIIIDIIIIIIIIIIIa
aaaaaaaaaaaaaaaaaaSSSSSSSSSUIDIIIIUUUUUUUUIUUUUUUUIIIIIUUUUUUUIIIDIIIIIIIIIIIIIDIIIIIIIIIIIIIIIIIIIIIIIIIIIIIIIIIIDDIIIIIIIIIIIa
aaaaaaaaaaaaaaaaaaSSSSSGSSSSSDDIIIIUUIIIIIIUUUUUIIIUUUUUUUUUUUIIIDIIIIIIIIIIIIIDIIIIIIIIIIIIIIIIIIIIIIIIIIIIIIIIIIDIIIIIIIIIIIIa
aaaaaaaaaaaaaaaaaaSSSSSSSSSSaaDDIIIIIIIIIIIIIIIIUUUUUUUUUUUUUUIIIDIIIIIIIIIIIIIDIIIIIIIIIIIIIIIIIIIIIIIIIIIIIIIIIDDIIIIIIIIIIIIa
aaaaaaaaaaaaaaaaaaaaSSSSSSSSaaaDDIIIIIIIIIIIIIIIIIIIIIIIIIIIIIIIIDIIIIIIIIIIIIIDIIIIIIIIIIIIIIIIIIIIIIIIIIIIIIIIIDIIIIIIIIIIIIIa
aaBaaaaaaaaaaaaaaaaaSSjjjjSSaaaaDIIIIIIIIIIIIIIIIIIIIIIIIIIIIIIIIDIIIIIIIIIIIIIDIIIIIIIIIIIIIIIIIIIIIIIIIIIIIIIIIDIIIIIIIIIIIIIa
aaaaaaaaaaaaaaaaaaaaaaaaaaaaaaaaaaaaaaaaaaaaaaaaaaaaaaaaaaaaaaaaaaaaaaaaaaaaaaaaaaaaaaaaaaaaaaaaaaaaaaaaaaaaaaaaaaaaaaaaaaaaaaaa
aaaaaaaaaaaaaaaaaaaaaaaaaaaaaaaaaaaaaaaaaaaaaaaaaaaaaaaaaaaaaaaaaaaaaaaaaaaaaaaaaaaaaaaaaaaaaaaaaaaaaaaaaaaaaaaaaaaaaaaaaaaaaaaa
"}
