//MAP CONVERTED BY dmm2tgm.py THIS HEADER COMMENT PREVENTS RECONVERSION, DO NOT REMOVE
"a" = (
/turf/closed/wall/r_wall/prison,
/area/fiorina/station/security)
"b" = (
/obj/effect/decal/cleanable/blood,
/turf/open/floor/prison,
/area/fiorina/station/security)
"d" = (
/obj/structure/closet/secure_closet/guncabinet,
/obj/item/clothing/under/color/orange,
/turf/open/floor/prison/red/full,
/area/fiorina/station/security)
"e" = (
/turf/closed/wall/prison,
/area/fiorina/station/security)
"f" = (
/obj/machinery/atmospherics/pipe/simple/supply/hidden/layer1,
/turf/open/floor/prison/plate,
/area/fiorina/station/security)
"g" = (
/obj/machinery/atmospherics/pipe/simple/supply/hidden/layer1{
	dir = 4
	},
/turf/open/floor/prison,
/area/fiorina/station/security)
"i" = (
/obj/machinery/door/airlock/mainship/maint{
	dir = 1;
	req_one_access = null
	},
/turf/open/floor/plating/kutjevo,
/area/fiorina/station/security)
"k" = (
/obj/structure/closet/secure_closet/guncabinet,
/obj/item/clothing/shoes/galoshes{
	pixel_y = -6
	},
/turf/open/floor/prison/red/full,
/area/fiorina/station/security)
"l" = (
/obj/structure/closet/secure_closet/guncabinet,
/turf/open/floor/prison/red/full,
/area/fiorina/station/security)
"m" = (
/obj/structure/closet/secure_closet/security_empty,
/obj/structure/window/reinforced{
	dir = 8
	},
/obj/item/storage/box/flashbangs,
/turf/open/floor/prison/red/full,
/area/fiorina/station/security)
"n" = (
/obj/structure/inflatable/wall,
/obj/machinery/atmospherics/pipe/simple/supply/hidden/layer1{
	dir = 6
	},
/turf/open/floor/prison/plate,
/area/fiorina/station/security)
"r" = (
/obj/structure/reagent_dispensers/water_cooler,
/obj/machinery/atmospherics/pipe/simple/supply/hidden/layer1{
	dir = 10
	},
/turf/open/floor/prison/red/full,
/area/fiorina/station/security)
"t" = (
/obj/structure/window/reinforced,
/turf/open/floor/prison,
/area/fiorina/station/security)
"u" = (
/obj/structure/closet/secure_closet/security_empty,
/obj/structure/window/reinforced{
	dir = 4
	},
/turf/open/floor/prison/red/full,
/area/fiorina/station/security)
"v" = (
/obj/item/clothing/under/color/orange,
/turf/open/floor/prison,
/area/fiorina/station/security)
"w" = (
/obj/structure/bed/chair{
	dir = 1
	},
/obj/effect/decal/cleanable/blood,
/turf/open/floor/prison/plate,
/area/fiorina/station/security)
"x" = (
/obj/effect/decal/cleanable/blood/oil,
/turf/open/floor/prison,
/area/fiorina/station/security)
"z" = (
/obj/item/clothing/shoes/black{
	pixel_x = -1;
	pixel_y = -17
	},
/obj/effect/decal/cleanable/blood/oil/streak,
/turf/open/floor/prison,
/area/fiorina/station/security)
"B" = (
/obj/item/tool/kitchen/knife{
	pixel_x = -7;
	pixel_y = -15
	},
/obj/machinery/atmospherics/pipe/simple/supply/hidden/layer1,
/turf/open/floor/prison/plate,
/area/fiorina/station/security)
"C" = (
/obj/machinery/light{
	dir = 1;
	pixel_y = 21
	},
/turf/open/floor/prison,
/area/fiorina/station/security)
"D" = (
/obj/effect/decal/cleanable/blood/oil/streak,
/obj/machinery/atmospherics/pipe/simple/supply/hidden/layer1{
	dir = 9
	},
/turf/open/floor/prison,
/area/fiorina/station/security)
"E" = (
/obj/structure/window/reinforced{
	dir = 8
	},
/obj/structure/window/reinforced,
/turf/open/floor/prison,
/area/fiorina/station/security)
"F" = (
/obj/effect/decal/cleanable/blood,
/turf/open/floor/prison/plate,
/area/fiorina/station/security)
"G" = (
/obj/machinery/atmospherics/pipe/manifold/supply/hidden/layer1,
/turf/open/floor/prison,
/area/fiorina/station/security)
"I" = (
/obj/structure/closet/secure_closet/guncabinet,
/obj/effect/spawner/random/weaponry/gun/sidearms,
/turf/open/floor/prison/red/full,
/area/fiorina/station/security)
"J" = (
/obj/structure/window/reinforced{
	dir = 8
	},
/turf/open/floor/prison,
/area/fiorina/station/security)
"K" = (
/obj/item/clothing/under/color/orange,
/obj/machinery/atmospherics/pipe/simple/supply/hidden/layer1,
/turf/open/floor/prison/plate,
/area/fiorina/station/security)
"L" = (
/obj/structure/window/framed/prison/reinforced,
/turf/open/floor/prison,
/area/fiorina/station/security)
"P" = (
/obj/item/clothing/under/color/orange,
/obj/machinery/atmospherics/pipe/simple/supply/hidden/layer1{
	dir = 4
	},
/turf/open/floor/prison,
/area/fiorina/station/security)
"Q" = (
/obj/item/clothing/under/color/orange,
/obj/machinery/atmospherics/pipe/simple/supply/hidden/layer1{
	dir = 10
	},
/turf/open/floor/prison,
/area/fiorina/station/security)
"R" = (
/obj/structure/extinguisher_cabinet,
/turf/closed/wall/r_wall/prison,
/area/fiorina/station/security)
"S" = (
/obj/structure/table/reinforced/prison,
/obj/structure/flora/pottedplant{
	pixel_y = 9
	},
/obj/machinery/light,
/turf/open/floor/prison,
/area/fiorina/station/security)
"T" = (
/obj/machinery/atmospherics/pipe/simple/supply/hidden/layer1{
	dir = 5
	},
/turf/open/floor/prison/plate,
/area/fiorina/station/security)
"U" = (
/turf/open/floor/prison/plate,
/area/fiorina/station/security)
"W" = (
/obj/structure/closet/secure_closet/guncabinet,
/obj/item/clothing/shoes/black{
	pixel_x = 2;
	pixel_y = -9
	},
/turf/open/floor/prison/red/full,
/area/fiorina/station/security)
"X" = (
/obj/item/frame/rack,
/turf/open/floor/prison/red/full,
/area/fiorina/station/security)
"Y" = (
/obj/machinery/door/airlock/mainship/maint{
	dir = 1;
	req_one_access = null
	},
/obj/machinery/atmospherics/pipe/simple/supply/hidden/layer1,
/turf/open/floor/plating/kutjevo,
/area/fiorina/station/security)
"Z" = (
/turf/open/floor/prison,
/area/fiorina/station/security)

(1,1,1) = {"
Z
S
a
a
R
a
a
C
"}
(2,1,1) = {"
a
a
a
I
d
k
a
a
"}
(3,1,1) = {"
n
K
f
B
T
U
X
a
"}
(4,1,1) = {"
D
z
I
d
r
G
X
a
"}
(5,1,1) = {"
Z
b
J
E
I
P
X
a
"}
(6,1,1) = {"
L
L
a
t
l
g
a
e
"}
(7,1,1) = {"
w
U
i
v
x
Q
Y
f
"}
(8,1,1) = {"
U
F
a
d
W
I
a
u
"}
(9,1,1) = {"
a
a
a
a
a
a
a
m
"}
