"aa" = (/turf/closed/wall/mainship/outer,/area/deathmatch)
"ab" = (/turf/open/space/basic,/area/space)
"ac" = (/turf/closed/wall/mainship,/area/deathmatch)
"ad" = (/obj/effect/decal/warning_stripes/nscenter,/turf/open/floor/wood,/area/deathmatch)
"ae" = (/obj/structure/platform{dir = 1},/turf/open/floor/mainship/green{dir = 1},/area/deathmatch)
"af" = (/obj/effect/decal/warning_stripes/thin{dir = 8},/obj/effect/decal/warning_stripes/thin{dir = 1},/obj/effect/landmark/weapon_spawn/tier4_weapon_spawn,/turf/open/floor/wood,/area/deathmatch)
"ag" = (/obj/effect/decal/warning_stripes/thin{dir = 4},/obj/effect/decal/warning_stripes/thin{dir = 1},/obj/effect/landmark/deathmatch,/turf/open/floor/wood,/area/deathmatch)
"ah" = (/obj/effect/decal/warning_stripes/thin{dir = 8},/obj/effect/decal/warning_stripes/thin{dir = 1},/obj/effect/landmark/deathmatch,/turf/open/floor/wood,/area/deathmatch)
"ai" = (/obj/effect/decal/warning_stripes/thin{dir = 1},/turf/open/floor/wood,/area/deathmatch)
"aj" = (/obj/effect/decal/warning_stripes/thin{dir = 1},/obj/effect/landmark/weapon_spawn/tier4_weapon_spawn,/turf/open/floor/wood,/area/deathmatch)
"ak" = (/obj/effect/decal/warning_stripes/thin{dir = 4},/turf/open/floor/wood,/area/deathmatch)
"al" = (/obj/effect/landmark/deathmatch,/turf/open/floor/wood,/area/deathmatch)
"am" = (/obj/effect/decal/warning_stripes/thin{dir = 1},/obj/effect/decal/warning_stripes/thin{dir = 4},/turf/open/floor/wood,/area/deathmatch)
"an" = (/obj/effect/decal/warning_stripes/nscenter,/obj/effect/decal/warning_stripes/thin{dir = 1},/turf/open/floor/wood,/area/deathmatch)
"ao" = (/obj/effect/decal/warning_stripes/thin{dir = 1},/obj/effect/decal/warning_stripes/thin{dir = 8},/turf/open/floor/wood,/area/deathmatch)
"ap" = (/obj/effect/decal/warning_stripes/thin{dir = 8},/turf/open/floor/wood,/area/deathmatch)
"aq" = (/obj/effect/decal/warning_stripes/thin{dir = 5},/turf/open/floor/wood,/area/deathmatch)
"ar" = (/obj/effect/decal/warning_stripes/thin{dir = 9},/turf/open/floor/wood,/area/deathmatch)
"as" = (/obj/effect/decal/warning_stripes/thin{dir = 8},/obj/effect/decal/warning_stripes,/obj/structure/hoop{dir = 4; id = "basketball"; side = "left"},/obj/effect/decal/warning_stripes/thin{dir = 8},/turf/open/floor/wood,/area/deathmatch)
"at" = (/obj/effect/decal/warning_stripes/thin{dir = 4},/obj/effect/decal/warning_stripes,/obj/structure/hoop{dir = 8; id = "basketball"; side = "right"},/obj/effect/decal/warning_stripes/thin{dir = 4},/turf/open/floor/wood,/area/deathmatch)
"au" = (/obj/effect/decal/warning_stripes/thin{dir = 6},/turf/open/floor/wood,/area/deathmatch)
"av" = (/obj/effect/decal/warning_stripes/thin,/turf/open/floor/wood,/area/deathmatch)
"aw" = (/obj/effect/decal/warning_stripes/thin{dir = 4},/obj/effect/decal/warning_stripes/thin{dir = 1},/obj/effect/landmark/weapon_spawn/tier4_weapon_spawn,/turf/open/floor/wood,/area/deathmatch)
"ax" = (/obj/effect/decal/warning_stripes/thin{dir = 10},/turf/open/floor/wood,/area/deathmatch)
"ay" = (/obj/effect/decal/warning_stripes/thin{dir = 4},/obj/effect/decal/warning_stripes/thin,/turf/open/floor/wood,/area/deathmatch)
"az" = (/obj/effect/decal/warning_stripes/nscenter,/obj/effect/decal/warning_stripes/thin,/turf/open/floor/wood,/area/deathmatch)
"aA" = (/obj/effect/decal/warning_stripes/thin,/obj/effect/decal/warning_stripes/thin{dir = 8},/turf/open/floor/wood,/area/deathmatch)
"aB" = (/obj/structure/platform,/turf/open/floor/mainship/green,/area/deathmatch)
"aC" = (/turf/open/floor/stairs/rampbottom{dir = 1},/area/deathmatch)
"aD" = (/obj/structure/platform,/obj/machinery/scoreboard{id = "basketball"; pixel_y = 30},/turf/open/floor/mainship/green,/area/deathmatch)
"aE" = (/turf/open/floor/stairs/rampbottom,/area/deathmatch)
"aF" = (/obj/structure/bed/chair{dir = 1},/turf/open/floor/wood,/area/deathmatch)
"aG" = (/obj/structure/bed/chair,/turf/open/floor/wood,/area/deathmatch)
"aH" = (/obj/structure/window/framed/mainship/requisitions,/turf/open/floor/wood,/area/deathmatch)
"aI" = (/obj/structure/platform,/turf/open/floor/mainship/red,/area/deathmatch)
"aJ" = (/obj/structure/platform,/turf/open/floor/mainship/blue,/area/deathmatch)
"aK" = (/obj/structure/platform{dir = 1},/turf/open/floor/mainship/red{dir = 1},/area/deathmatch)
"aL" = (/obj/structure/platform{dir = 1},/turf/open/floor/mainship/blue{dir = 1},/area/deathmatch)
"aM" = (/obj/effect/decal/warning_stripes/nscenter,/obj/effect/decal/warning_stripes,/obj/effect/landmark/deathmatch,/turf/open/floor/wood,/area/deathmatch)
"aN" = (/obj/effect/decal/warning_stripes/nscenter,/obj/effect/decal/warning_stripes,/obj/item/toy/beach_ball/basketball,/obj/effect/landmark/weapon_spawn/tier5_weapon_spawn,/turf/open/floor/wood,/area/deathmatch)
"aO" = (/obj/effect/decal/warning_stripes/thin,/obj/effect/decal/warning_stripes/thin,/obj/effect/decal/warning_stripes/thin{dir = 4; step_x = 0; step_y = 0},/obj/effect/landmark/deathmatch,/turf/open/floor/wood,/area/deathmatch)
"aP" = (/obj/effect/decal/warning_stripes/thin{dir = 8},/obj/effect/decal/warning_stripes/thin,/obj/effect/landmark/deathmatch,/turf/open/floor/wood,/area/deathmatch)
"aQ" = (/obj/structure/bed/chair,/obj/effect/landmark/deathmatch,/turf/open/floor/wood,/area/deathmatch)
"aR" = (/obj/structure/bed/chair{dir = 1},/obj/effect/landmark/deathmatch,/turf/open/floor/wood,/area/deathmatch)
"aS" = (/obj/effect/decal/warning_stripes/thin{dir = 8},/obj/effect/decal/warning_stripes/thin,/obj/effect/landmark/weapon_spawn/tier4_weapon_spawn,/turf/open/floor/wood,/area/deathmatch)
"aT" = (/obj/effect/decal/warning_stripes/thin,/obj/effect/landmark/weapon_spawn/tier4_weapon_spawn,/turf/open/floor/wood,/area/deathmatch)
"aU" = (/obj/effect/decal/warning_stripes/thin{dir = 4},/obj/effect/decal/warning_stripes/thin,/obj/effect/landmark/weapon_spawn/tier4_weapon_spawn,/turf/open/floor/wood,/area/deathmatch)
"aV" = (/obj/effect/landmark/weapon_spawn/tier3_weapon_spawn,/turf/open/floor/wood,/area/deathmatch)
"aW" = (/obj/structure/bed/chair,/obj/effect/landmark/weapon_spawn/tier3_weapon_spawn,/turf/open/floor/wood,/area/deathmatch)
"aX" = (/obj/structure/bed/chair{dir = 1},/obj/effect/landmark/weapon_spawn/tier3_weapon_spawn,/turf/open/floor/wood,/area/deathmatch)
"aY" = (/obj/effect/landmark/weapon_spawn/tier2_weapon_spawn,/turf/open/floor/wood,/area/deathmatch)
"aZ" = (/obj/structure/window/reinforced/tinted/frosted{dir = 1},/obj/machinery/door/window{dir = 8},/turf/open/floor/mainship/mono,/area/deathmatch)
"ba" = (/obj/structure/window/reinforced/tinted/frosted{dir = 1},/turf/open/floor/mainship/mono,/area/deathmatch)
"bb" = (/turf/open/floor/mainship/mono,/area/deathmatch)
"bc" = (/turf/open/floor/plating/plating_catwalk,/area/deathmatch)
"bd" = (/obj/effect/landmark/deathmatch,/turf/open/floor/mainship/sterile/plain,/area/deathmatch)
"be" = (/obj/structure/toilet{dir = 1},/obj/effect/landmark/deathmatch,/turf/open/floor/mainship/mono,/area/deathmatch)
"bf" = (/obj/structure/sink,/turf/open/floor/mainship/mono,/area/deathmatch)
"bg" = (/turf/open/floor/mainship/sterile/plain,/area/deathmatch)
"bh" = (/obj/structure/toilet{dir = 1},/obj/effect/landmark/weapon_spawn/tier4_weapon_spawn,/turf/open/floor/mainship/mono,/area/deathmatch)
"bi" = (/obj/machinery/shower{dir = 1},/obj/effect/landmark/weapon_spawn/tier3_weapon_spawn,/turf/open/floor/plating/plating_catwalk,/area/deathmatch)
"bj" = (/obj/machinery/door/airlock/mainship/generic{name = "\improper Bathroom"},/turf/open/floor/mainship/sterile/plain,/area/deathmatch)
"bk" = (/obj/machinery/door/airlock/mainship/generic{dir = 1; name = "Bathroom"},/turf/open/floor/mainship/sterile/plain,/area/deathmatch)
"bl" = (/obj/effect/landmark/weapon_spawn/tier2_weapon_spawn,/turf/open/floor/mainship/sterile/plain,/area/deathmatch)
"bm" = (/obj/machinery/shower{dir = 1},/obj/effect/landmark/deathmatch,/turf/open/floor/plating/plating_catwalk,/area/deathmatch)
"eo" = (/turf/open/floor/wood,/area/deathmatch)

(1,1,1) = {"
aaaaaaaaaaaaaaaaaaaaaaaaaaaaaaaaaaaaaaaaaaaaaaaaaaaaaaaaaaaaaaaaaaaaaaaaaaaaaaaaaaaaaaaaaaab
aaeoeoeoeoeoeoeoeoeoeoeoeoeoeoeoeoeoeoeoeoeoeoeoeoeoeoeoeoeoeoeoeoeoeoeoeoeoeoeoeoeoeoeoaaab
aaeoeoeoeoeoeoeoeoeoeoeoeoeoeoeoeoeoeoeoeoeoeoeoeoeoeoeoeoeoeoeoeoeoeoeoeoeoeoeoeoeoeoeoaaab
aaeoeoeoeoeoeoeoeoeoeoeoeoeoeoeoeoeoeoeoeoeoeoeoeoeoeoeoeoeoeoeoeoeoeoeoeoeoeoeoeoeoeoeoaaab
aaeoeoeoeoeoeoeoeoeoeoeoeoeoeoeoeoeoeoeoeoeoeoeoeoeoeoeoeoeoeoeoeoeoeoeoeoeoeoeoeoeoeoeoaaab
aaeoeoeoeoeoeoeoeoeoeoeoeoeoeoeoeoeoeoeoeoeoeoeoeoeoeoeoeoeoeoeoeoeoeoeoeoeoeoeoeoeoeoeoaaab
aaaGaGaGaGaGaGaGaGaGaGaGaGaGaGaGeoeoeoeoeoeoeoeoeoeoeoeoeoeoeoeoeoeoeoeoeoeoeoeoeoeoeoeoaaab
aaaGaGaGaGaGaGaGaGaGaGaGaGaGaGaGeoeoeoeoeoeoeoeoeoeoeoeoeoaGaGaGaGaGaGaGaGaGaGaGaGaGaGaGaaab
aaaGaGaGaGaGaGaGaGaGaGaGaGaGaGaGeoeoeoeoeoeoeoeoeoeoeoeoeoaGaGaGaGaGaGaGaGaGaGaGaGaGaGaGaaab
aaaleoeoeoeoaYeoeoaYeoeoaYeoeoaleoeoeoeoeoeoaVeoeoeoeoeoeoaleoeoaYeoeoaYeoeoaYeoeoeoeoalaaab
aaaHaHaHaHaHaHaHaHaHaHaHaHaHaHaaeoeoaYaHaHaHaHaHaHaHaYeoeoaaaHaHaHaHaHaHaHaHaHaHaHaHaHaHaaab
aaaWaGaQaGaGaGaGaGaGaGaGaGaGaGaGeoeoeoeoeoeoeoeoeoeoeoeoeoaGaGaGaGaGaGaGaGaGaGaGaGaQaGaWaaab
aaeoeoeoeoeoaYeoeoaYeoeoaYeoeoeoeoeoeoaQaGaGeoaGaGaQeoeoeoeoeoeoaYeoeoaYeoeoaYeoeoeoeoeoaaab
aaaWaGaQaGaGaGaGaGaGaGaGaGaGaGaQeoaYeoeoeoeoaceoeoeoeoaYeoaQaGaGaGaGaGaGaGaGaGaGaGaQaGaWaaab
aaaIaIaIaIaIaIaIaIaIaIaIaIaIaIaIaCaCaCaBaBaBaDaBaBaBaCaCaCaJaJaJaJaJaJaJaJaJaJaJaJaJaJaJaaab
aaafaiamaiaiaiaiaiaiaiaiaiaiaiaiaiajaiaiaiaianaiaiaiaiajaiaiaiaiaiaiaiaiaiaiaiaiaiaoaiawaaab
aaapeoakeoaleoeoeoaVeoeoeoeoeoeoeoeoeoeoeoeoadeoeoeoeoeoeoeoeoeoeoeoeoaVeoeoeoaleoapeoakaaab
aaapeoakeoeoeoeoeoeoeoeoeoeoeoeoeoeoeoeoeoeoadeoeoeoeoeoeoeoeoeoeoeoeoeoeoeoeoeoeoapeoakaaab
aaapeoaqaiaiaiageoeoaVeoeoeoeoeoeoeoeoaVeoeoadeoeoaVeoeoeoeoeoeoeoeoaVeoeoahaiaiaiareoakaaab
aaapeoeoeoeoeoakeoeoeoeoeoeoeoeoeoeoeoeoeoeoadeoeoeoeoeoeoeoeoeoeoeoeoeoeoapeoeoeoeoeoakaaab
aaapeoeoeoaleoakeoeoeoeoeoeoeoeoeoeoeoeoeoeoadeoeoeoeoeoeoeoeoeoeoeoeoeoeoapeoaleoeoeoakaaab
aaapeoeoeoeoeoakeoeoeoeoeoeoeoeoeoeoaleoeoeoadeoeoeoaleoeoeoeoeoeoeoeoeoeoapeoeoeoeoeoakaaab
aaasaleoeoeoeoaMeoeoaleoeoeoeoaVeoeoeoeoeoalaNaleoeoeoeoeoaVeoeoeoeoaleoeoaMeoeoeoeoalataaab
aaapeoeoeoeoeoakeoeoeoeoeoeoeoeoeoeoaleoeoeoadeoeoeoaleoeoeoeoeoeoeoeoeoeoapeoeoeoeoeoakaaab
aaapeoeoeoaleoakeoeoeoeoeoeoeoeoeoeoeoeoeoeoadeoeoeoeoeoeoeoeoeoeoeoeoeoeoapeoaleoeoeoakaaab
aaapeoeoeoeoeoakeoeoeoeoeoeoeoeoeoeoeoeoeoeoadeoeoeoeoeoeoeoeoeoeoeoeoeoeoapeoeoeoeoeoakaaab
aaapeoauavavavaOeoeoaVeoeoeoeoeoeoeoeoaVeoeoadeoeoaVeoeoeoeoeoeoeoeoaVeoeoaPavavavaxeoakaaab
aaapeoakeoeoeoeoeoeoeoeoeoeoeoeoeoeoeoeoeoeoadeoeoeoeoeoeoeoeoeoeoeoeoeoeoeoeoeoeoapeoakaaab
aaapeoakeoaleoeoeoaVeoeoeoeoeoeoeoeoeoeoeoeoadeoeoeoeoeoeoeoeoeoeoeoeoaVeoeoeoaleoapeoakaaab
aaaSavayavavavavavavavavavavavavavaTavavavavazavavavavaTavavavavavavavavavavavavavaAavaUaaab
aaaKaKaKaKaKaKaKaKaKaKaKaKaKaKaKaEaEaEaeaeaeaeaeaeaeaEaEaEaLaLaLaLaLaLaLaLaLaLaLaLaLaLaLaaab
aaaXaFaRaFaFaFaFaFaFaFaFaFaFaFaReoaYeoeoeoeoeoeoeoeoeoaYeoaRaFaFaFaFaFaFaFaFaFaFaFaRaFaXaaab
aaeoeoeoeoeoaYeoeoaYeoeoaYeoeoeoeoeoeoeoaFaFaRaFaFeoeoeoeoeoeoeoaYeoeoaYeoeoaYeoeoeoeoeoaaab
aaaXaFaRaFaFaFaFaFaFaFaFaFaFaFaFeoeoeoeoeoeoeoeoeoeoeoeoeoaFaFaFaFaFaFaFaFaFaFaFaFaRaFaXaaab
aaaHaHaHaHaHaHaHaHaHaHaHaHaHaHaaeoeoaYaHaHaHaHaHaHaHaYeoeoaaaHaHaHaHaHaHaHaHaHaHaHaHaHaHaaab
aaaleoeoeoeoaYeoeoaYeoeoaYeoeoaleoeoeoeoeoeoaVeoeoeoeoeoeoaleoeoaYeoeoaYeoeoaYeoeoeoeoalaaab
aaaFaFaFaFaFaFaFaFaFaFaFaFaFaFaFeoeoeoeoeoeoeoeoeoeoeoeoeoaFaFaFaFaFaFaFaFaFaFaFaFaFaFaFaaab
aaaFaFaFaFaFaFaFaFaFaFaFaFaFaFaFeoeoeoeoeoeoeoeoeoeoeoeoeoaFaFaFaFaFaFaFaFaFaFaFaFaFaFaFaaab
aaaaaaaaaaaaaaaaaaaaaaaaaaaaaaaaeoeoeoeoeoeoeoeoeoeoeoeoeoaFaFaFaFaFaFaFaFaFaFaFaFaFaFaFaaab
aabfbbbfbbbfbbbfbbbfbbbfbbbfbbaaeoeoeoeoeoeoeoeoeoeoeoeoeoeoeoeoeoeoeoeoeoeoeoeoeoeoeoeoaaab
aablbgbdbgbgbgbdbgbgbgbdbgbgbgbjaleoeoeoeoeoeoeoeoeoeoeoeoeoeoeoeoeoeoeoeoeoeoeoeoeoeoeoaaab
aabgbgbgbgbgbgaZbababaaabbbgbbaaeoeoeoeoeoeoeoeoeoeoeoeoeoeoeoeoeoeoeoeoeoeoeoeoeoeoeoeoaaab
aabkaabkaabkaabcbcbcbcaabbbgbbaaeoeoeoeoeoeoeoeoeoeoeoeoeoeoeoeoeoeoeoeoeoeoeoeoeoeoeoeoaaab
aabeaabhaabeaabibmbmbiaabbbbbbaaeoeoeoeoeoeoeoeoeoeoeoeoeoeoeoeoeoeoeoeoeoeoeoeoeoeoeoeoaaab
aaaaaaaaaaaaaaaaaaaaaaaaaaaaaaaaaaaaaaaaaaaaaaaaaaaaaaaaaaaaaaaaaaaaaaaaaaaaaaaaaaaaaaaaaaab
abababababababababababababababababababababababababababababababababababababababababababababab
"}
