//MAP CONVERTED BY dmm2tgm.py THIS HEADER COMMENT PREVENTS RECONVERSION, DO NOT REMOVE
"aa" = (
/turf/closed/wall/mainship/outer,
/area/deathmatch)
"ab" = (
/turf/open/space/basic,
/area/space)
"ac" = (
/turf/closed/wall/mainship,
/area/deathmatch)
"ad" = (
/obj/effect/turf_decal/warning_stripes/nscenter,
/turf/open/floor/wood,
/area/deathmatch)
"ae" = (
/turf/open/floor/mainship/green{
	dir = 1
	},
/area/deathmatch)
"af" = (
/obj/effect/turf_decal/warning_stripes/thin{
	dir = 8
	},
/obj/effect/turf_decal/warning_stripes/thin{
	dir = 1
	},
/obj/effect/landmark/weapon_spawn/tier4_weapon_spawn,
/obj/structure/window/reinforced{
	dir = 1
	},
/obj/structure/platform{
	dir = 1
	},
/turf/open/floor/wood,
/area/deathmatch)
"ag" = (
/obj/effect/turf_decal/warning_stripes/thin{
	dir = 4
	},
/obj/effect/turf_decal/warning_stripes/thin{
	dir = 1
	},
/obj/effect/landmark/deathmatch,
/turf/open/floor/wood,
/area/deathmatch)
"ah" = (
/obj/effect/turf_decal/warning_stripes/thin{
	dir = 8
	},
/obj/effect/turf_decal/warning_stripes/thin{
	dir = 1
	},
/obj/effect/landmark/deathmatch,
/turf/open/floor/wood,
/area/deathmatch)
"ai" = (
/obj/effect/turf_decal/warning_stripes/thin{
	dir = 1
	},
/turf/open/floor/wood,
/area/deathmatch)
"aj" = (
/obj/effect/turf_decal/warning_stripes/thin{
	dir = 1
	},
/obj/effect/landmark/weapon_spawn/tier4_weapon_spawn,
/turf/open/floor/wood,
/area/deathmatch)
"ak" = (
/obj/effect/turf_decal/warning_stripes/thin{
	dir = 4
	},
/turf/open/floor/wood,
/area/deathmatch)
"al" = (
/obj/effect/landmark/deathmatch,
/turf/open/floor/wood,
/area/deathmatch)
"am" = (
/obj/effect/turf_decal/warning_stripes/thin{
	dir = 1
	},
/obj/effect/turf_decal/warning_stripes/thin{
	dir = 4
	},
/obj/structure/window/reinforced{
	dir = 1
	},
/obj/structure/platform{
	dir = 1
	},
/turf/open/floor/wood,
/area/deathmatch)
"an" = (
/obj/effect/turf_decal/warning_stripes/nscenter,
/obj/effect/turf_decal/warning_stripes/thin{
	dir = 1
	},
/obj/structure/window/reinforced{
	dir = 1
	},
/obj/structure/platform{
	dir = 1
	},
/turf/open/floor/wood,
/area/deathmatch)
"ao" = (
/obj/effect/turf_decal/warning_stripes/thin{
	dir = 1
	},
/obj/effect/turf_decal/warning_stripes/thin{
	dir = 8
	},
/obj/structure/window/reinforced{
	dir = 1
	},
/obj/structure/platform{
	dir = 1
	},
/turf/open/floor/wood,
/area/deathmatch)
"ap" = (
/obj/effect/turf_decal/warning_stripes/thin{
	dir = 8
	},
/turf/open/floor/wood,
/area/deathmatch)
"aq" = (
/obj/effect/turf_decal/warning_stripes/thin{
	dir = 5
	},
/turf/open/floor/wood,
/area/deathmatch)
"ar" = (
/obj/effect/turf_decal/warning_stripes/thin{
	dir = 9
	},
/turf/open/floor/wood,
/area/deathmatch)
"as" = (
/obj/effect/turf_decal/warning_stripes/thin{
	dir = 8
	},
/obj/effect/turf_decal/warning_stripes,
/obj/structure/hoop{
	dir = 4;
	id = "basketball";
	side = "left"
	},
/obj/effect/turf_decal/warning_stripes/thin{
	dir = 8
	},
/obj/machinery/light{
	dir = 8
	},
/obj/machinery/floodlight/landing/testroom,
/turf/open/floor/wood,
/area/deathmatch)
"at" = (
/obj/effect/turf_decal/warning_stripes/thin{
	dir = 4
	},
/obj/effect/turf_decal/warning_stripes,
/obj/structure/hoop{
	dir = 8;
	id = "basketball";
	side = "right"
	},
/obj/effect/turf_decal/warning_stripes/thin{
	dir = 4
	},
/obj/machinery/light{
	dir = 4
	},
/obj/machinery/floodlight/landing/testroom,
/turf/open/floor/wood,
/area/deathmatch)
"au" = (
/obj/effect/turf_decal/warning_stripes/thin{
	dir = 6
	},
/turf/open/floor/wood,
/area/deathmatch)
"av" = (
/obj/effect/turf_decal/warning_stripes/thin,
/turf/open/floor/wood,
/area/deathmatch)
"aw" = (
/obj/effect/turf_decal/warning_stripes/thin{
	dir = 4
	},
/obj/effect/turf_decal/warning_stripes/thin{
	dir = 1
	},
/obj/effect/landmark/weapon_spawn/tier4_weapon_spawn,
/obj/structure/window/reinforced{
	dir = 1
	},
/obj/structure/platform{
	dir = 1
	},
/turf/open/floor/wood,
/area/deathmatch)
"ax" = (
/obj/effect/turf_decal/warning_stripes/thin{
	dir = 10
	},
/turf/open/floor/wood,
/area/deathmatch)
"ay" = (
/obj/effect/turf_decal/warning_stripes/thin{
	dir = 4
	},
/obj/effect/turf_decal/warning_stripes/thin,
/obj/structure/window/reinforced,
/obj/structure/platform,
/turf/open/floor/wood,
/area/deathmatch)
"az" = (
/obj/effect/turf_decal/warning_stripes/nscenter,
/obj/effect/turf_decal/warning_stripes/thin,
/obj/structure/window/reinforced,
/obj/structure/platform,
/turf/open/floor/wood,
/area/deathmatch)
"aA" = (
/obj/effect/turf_decal/warning_stripes/thin,
/obj/effect/turf_decal/warning_stripes/thin{
	dir = 8
	},
/obj/structure/window/reinforced,
/obj/structure/platform,
/turf/open/floor/wood,
/area/deathmatch)
"aB" = (
/turf/open/floor/mainship/green,
/area/deathmatch)
"aC" = (
/obj/structure/stairs/edge{
	dir = 1
	},
/turf/open/floor/tile/dark,
/area/deathmatch)
"aD" = (
/obj/machinery/scoreboard{
	id = "basketball";
	pixel_y = 30
	},
/obj/machinery/floodlight/landing/hq,
/turf/open/floor/mainship/green,
/area/deathmatch)
"aE" = (
/obj/structure/stairs/edge,
/turf/open/floor/tile/dark,
/area/deathmatch)
"aF" = (
/obj/effect/ai_node,
/turf/open/floor/plating/mainship,
/area/deathmatch)
"aG" = (
/obj/effect/ai_node,
/turf/open/floor/wood,
/area/deathmatch)
"aH" = (
/obj/structure/window/framed/mainship/requisitions,
/turf/open/floor/wood,
/area/deathmatch)
"aI" = (
/turf/open/floor/mainship/red,
/area/deathmatch)
"aL" = (
/turf/open/floor/mainship/blue{
	dir = 1
	},
/area/deathmatch)
"aM" = (
/obj/effect/turf_decal/warning_stripes/nscenter,
/obj/effect/turf_decal/warning_stripes,
/obj/effect/landmark/deathmatch,
/turf/open/floor/wood,
/area/deathmatch)
"aN" = (
/obj/effect/turf_decal/warning_stripes/nscenter,
/obj/effect/turf_decal/warning_stripes,
/obj/item/toy/beach_ball/basketball,
/obj/effect/landmark/weapon_spawn/tier5_weapon_spawn,
/obj/machinery/floodlight/landing/testroom,
/turf/open/floor/wood,
/area/deathmatch)
"aO" = (
/obj/effect/turf_decal/warning_stripes/thin,
/obj/effect/turf_decal/warning_stripes/thin,
/obj/effect/turf_decal/warning_stripes/thin{
	dir = 4
	},
/obj/effect/landmark/deathmatch,
/turf/open/floor/wood,
/area/deathmatch)
"aP" = (
/obj/effect/turf_decal/warning_stripes/thin{
	dir = 8
	},
/obj/effect/turf_decal/warning_stripes/thin,
/obj/effect/landmark/deathmatch,
/turf/open/floor/wood,
/area/deathmatch)
"aQ" = (
/obj/structure/bed/chair,
/obj/effect/landmark/deathmatch,
/turf/open/floor/mainship,
/area/deathmatch)
"aR" = (
/obj/structure/bed/chair{
	dir = 1
	},
/obj/effect/landmark/deathmatch,
/turf/open/floor/mainship,
/area/deathmatch)
"aS" = (
/obj/effect/turf_decal/warning_stripes/thin{
	dir = 8
	},
/obj/effect/turf_decal/warning_stripes/thin,
/obj/effect/landmark/weapon_spawn/tier4_weapon_spawn,
/obj/structure/window/reinforced,
/obj/structure/platform,
/turf/open/floor/wood,
/area/deathmatch)
"aT" = (
/obj/effect/turf_decal/warning_stripes/thin,
/obj/effect/landmark/weapon_spawn/tier4_weapon_spawn,
/turf/open/floor/wood,
/area/deathmatch)
"aU" = (
/obj/effect/turf_decal/warning_stripes/thin{
	dir = 4
	},
/obj/effect/turf_decal/warning_stripes/thin,
/obj/effect/landmark/weapon_spawn/tier4_weapon_spawn,
/obj/structure/window/reinforced,
/obj/structure/platform,
/turf/open/floor/wood,
/area/deathmatch)
"aV" = (
/obj/effect/landmark/weapon_spawn/tier3_weapon_spawn,
/turf/open/floor/wood,
/area/deathmatch)
"aW" = (
/obj/structure/bed/chair,
/obj/effect/landmark/weapon_spawn/tier3_weapon_spawn,
/turf/open/floor/mainship,
/area/deathmatch)
"aX" = (
/obj/structure/bed/chair{
	dir = 1
	},
/obj/effect/landmark/weapon_spawn/tier3_weapon_spawn,
/turf/open/floor/mainship,
/area/deathmatch)
"aY" = (
/obj/effect/landmark/weapon_spawn/tier2_weapon_spawn,
/turf/open/floor/wood,
/area/deathmatch)
"aZ" = (
/obj/structure/window/reinforced/tinted/frosted{
	dir = 1
	},
/obj/structure/window/reinforced/tinted/frosted{
	dir = 8
	},
/turf/open/floor/mainship/mono,
/area/deathmatch)
"ba" = (
/obj/structure/window/reinforced/tinted/frosted{
	dir = 1
	},
/turf/open/floor/mainship/mono,
/area/deathmatch)
"bb" = (
/turf/open/floor/mainship/mono,
/area/deathmatch)
"bc" = (
/turf/open/floor/plating/plating_catwalk,
/area/deathmatch)
"bd" = (
/obj/effect/landmark/deathmatch,
/turf/open/floor/mainship/sterile/plain,
/area/deathmatch)
"be" = (
/obj/structure/toilet{
	dir = 1
	},
/obj/effect/landmark/deathmatch,
/obj/machinery/light/small,
/turf/open/floor/mainship/mono,
/area/deathmatch)
"bf" = (
/obj/structure/sink,
/turf/open/floor/mainship/mono,
/area/deathmatch)
"bg" = (
/turf/open/floor/mainship/sterile/plain,
/area/deathmatch)
"bh" = (
/obj/structure/toilet{
	dir = 1
	},
/obj/effect/landmark/weapon_spawn/tier4_weapon_spawn,
/obj/machinery/light/small,
/turf/open/floor/mainship/mono,
/area/deathmatch)
"bi" = (
/obj/machinery/shower{
	dir = 1
	},
/obj/effect/landmark/weapon_spawn/tier3_weapon_spawn,
/turf/open/floor/plating/plating_catwalk,
/area/deathmatch)
"bj" = (
/obj/machinery/door/airlock/mainship/generic{
	name = "\improper Bathroom"
	},
/turf/open/floor/mainship/sterile/plain,
/area/deathmatch)
"bk" = (
/obj/machinery/door/airlock/mainship/generic{
	dir = 1;
	name = "Bathroom"
	},
/turf/open/floor/mainship/sterile/plain,
/area/deathmatch)
"bl" = (
/obj/effect/landmark/weapon_spawn/tier2_weapon_spawn,
/turf/open/floor/mainship/sterile/plain,
/area/deathmatch)
"bm" = (
/obj/machinery/shower{
	dir = 1
	},
/obj/effect/landmark/deathmatch,
/turf/open/floor/plating/plating_catwalk,
/area/deathmatch)
"bI" = (
/obj/structure/bed/chair{
	dir = 1
	},
/turf/open/floor/wood,
/area/deathmatch)
"ca" = (
/obj/effect/turf_decal/warning_stripes/thin{
	dir = 1
	},
/obj/structure/window/reinforced{
	dir = 1
	},
/obj/structure/platform{
	dir = 1
	},
/turf/open/floor/wood,
/area/deathmatch)
"cd" = (
/obj/machinery/door/window/right,
/turf/open/floor/mainship/mono,
/area/deathmatch)
"cK" = (
/obj/effect/ai_node,
/turf/open/floor/mainship/mono,
/area/deathmatch)
"cP" = (
/obj/structure/window/framed/mainship/requisitions,
/turf/open/floor/mainship/mono,
/area/deathmatch)
"dt" = (
/obj/effect/turf_decal/warning_stripes/nscenter,
/obj/effect/spawner/random/misc/gnome/fiftyfifty,
/turf/open/floor/wood,
/area/deathmatch)
"dH" = (
/obj/effect/ai_node,
/turf/open/floor/mainship/sterile/plain,
/area/deathmatch)
"eb" = (
/obj/structure/bed/chair{
	dir = 8
	},
/obj/structure/window/reinforced/tinted/frosted{
	dir = 1
	},
/turf/open/floor/wood,
/area/deathmatch)
"eo" = (
/obj/effect/ai_node,
/turf/open/liquid/water/river,
/area/deathmatch)
"et" = (
/obj/item/storage/belt/champion,
/turf/open/floor/mainship/sterile/plain,
/area/deathmatch)
"ey" = (
/obj/effect/turf_decal/warning_stripes/thin,
/turf/open/floor/mainship/red,
/area/deathmatch)
"fe" = (
/turf/open/floor/mainship/emerald{
	dir = 4
	},
/area/deathmatch)
"fM" = (
/turf/open/floor/mainship/silver/corner{
	dir = 8
	},
/area/deathmatch)
"gd" = (
/obj/structure/prop/mainship/ship_memorial{
	desc = "A ship memorial dedicated to the triumphs of the TGMC and the fallen marines of this ship. On the left there are grand tales of victory etched into the slab. On the right there is a list of famous marines who have fallen in combat serving the TGMC. There seems to be an etch of three spikes on the free space below."
	},
/turf/open/floor/plating/mainship,
/area/deathmatch)
"gE" = (
/obj/structure/table/reinforced/prison,
/obj/effect/spawner/random/misc/plushie/nospawnninetyfive,
/turf/open/floor/mainship/mono,
/area/deathmatch)
"hr" = (
/obj/structure/bed/chair,
/turf/open/floor/wood,
/area/deathmatch)
"it" = (
/obj/machinery/light,
/turf/open/floor/mainship,
/area/deathmatch)
"jf" = (
/obj/structure/bed/chair,
/obj/effect/ai_node,
/turf/open/floor/wood,
/area/deathmatch)
"jl" = (
/obj/structure/closet/swimsuit,
/obj/effect/landmark/weapon_spawn/tier3_weapon_spawn,
/turf/open/floor/mainship/mono,
/area/deathmatch)
"ki" = (
/obj/structure/flora/ausbushes/fullgrass,
/turf/open/floor/grass,
/area/deathmatch)
"kQ" = (
/obj/machinery/floodlight/landing/testroom,
/turf/open/floor/wood,
/area/deathmatch)
"me" = (
/turf/open/floor/mainship/red{
	dir = 8
	},
/area/deathmatch)
"mJ" = (
/obj/structure/table/reinforced/prison,
/turf/open/floor/wood,
/area/deathmatch)
"mT" = (
/obj/effect/turf_decal/warning_stripes/thin,
/obj/machinery/light{
	dir = 1
	},
/turf/open/floor/mainship/red,
/area/deathmatch)
"nh" = (
/obj/structure/table/reinforced/prison,
/obj/effect/landmark/weapon_spawn/tier3_weapon_spawn,
/obj/structure/window/reinforced/toughened{
	dir = 1
	},
/turf/open/floor/wood,
/area/deathmatch)
"nl" = (
/obj/structure/closet/lasertag/blue,
/turf/open/floor/wood,
/area/deathmatch)
"nu" = (
/obj/structure/prop/mainship/valmoric,
/turf/open/floor/grass,
/area/deathmatch)
"nQ" = (
/obj/effect/landmark/deathmatch,
/obj/structure/window/reinforced/toughened{
	dir = 1
	},
/turf/open/floor/wood,
/area/deathmatch)
"pV" = (
/obj/effect/landmark/deathmatch,
/turf/open/floor/mainship/blue{
	dir = 10
	},
/area/deathmatch)
"qx" = (
/obj/machinery/light,
/turf/open/floor/wood,
/area/deathmatch)
"ri" = (
/obj/structure/bed/chair{
	dir = 1
	},
/obj/effect/ai_node,
/turf/open/floor/wood,
/area/deathmatch)
"rl" = (
/obj/effect/landmark/weapon_spawn/tier2_weapon_spawn,
/obj/effect/ai_node,
/turf/open/floor/plating/plating_catwalk,
/area/deathmatch)
"rr" = (
/obj/effect/landmark/eord_roomba,
/turf/open/floor/mainship/mono,
/area/deathmatch)
"rF" = (
/obj/machinery/light{
	dir = 4
	},
/turf/open/floor/mainship/mono,
/area/deathmatch)
"rM" = (
/obj/machinery/disposal,
/turf/open/floor/mainship/mono,
/area/deathmatch)
"rX" = (
/obj/structure/bed/chair{
	dir = 1
	},
/obj/effect/ai_node,
/turf/open/floor/mainship,
/area/deathmatch)
"sa" = (
/obj/effect/landmark/weapon_spawn/tier3_weapon_spawn,
/obj/machinery/light{
	dir = 1
	},
/turf/open/floor/mainship/mono,
/area/deathmatch)
"sm" = (
/obj/effect/landmark/weapon_spawn/tier4_weapon_spawn,
/obj/machinery/light{
	dir = 8
	},
/turf/open/floor/plating/mainship,
/area/deathmatch)
"tG" = (
/obj/effect/landmark/weapon_spawn/tier2_weapon_spawn,
/obj/machinery/door/airlock/multi_tile/mainship/generic,
/turf/open/floor/wood,
/area/deathmatch)
"ue" = (
/obj/structure/bed/chair,
/turf/open/floor/mainship,
/area/deathmatch)
"uB" = (
/obj/effect/landmark/weapon_spawn/tier2_weapon_spawn,
/turf/open/floor/plating/plating_catwalk,
/area/deathmatch)
"vK" = (
/obj/effect/landmark/eord_roomba,
/turf/open/floor/wood,
/area/deathmatch)
"wK" = (
/obj/machinery/disposal,
/turf/open/floor/mainship/sterile/plain,
/area/deathmatch)
"wY" = (
/obj/machinery/light{
	dir = 4
	},
/turf/open/floor/plating/plating_catwalk,
/area/deathmatch)
"xx" = (
/obj/effect/ai_node,
/turf/open/floor/plating/plating_catwalk,
/area/deathmatch)
"xH" = (
/obj/structure/bed/chair{
	dir = 4
	},
/obj/effect/landmark/deathmatch,
/obj/structure/window/reinforced/tinted/frosted{
	dir = 1
	},
/turf/open/floor/wood,
/area/deathmatch)
"yi" = (
/obj/machinery/light{
	dir = 1
	},
/obj/effect/landmark/eord_roomba,
/turf/open/floor/mainship,
/area/deathmatch)
"yq" = (
/obj/structure/bed/chair{
	dir = 8
	},
/turf/open/floor/wood,
/area/deathmatch)
"yt" = (
/obj/machinery/door/window{
	dir = 8
	},
/turf/open/floor/wood,
/area/deathmatch)
"zl" = (
/obj/structure/bed/chair{
	dir = 8
	},
/obj/effect/landmark/deathmatch,
/obj/structure/window/reinforced/tinted/frosted,
/turf/open/floor/wood,
/area/deathmatch)
"Al" = (
/obj/effect/landmark/weapon_spawn/tier4_weapon_spawn,
/turf/open/floor/mainship,
/area/deathmatch)
"Bd" = (
/obj/structure/bed/chair{
	dir = 1
	},
/obj/machinery/light,
/turf/open/floor/mainship,
/area/deathmatch)
"Bi" = (
/obj/effect/landmark/deathmatch,
/turf/open/floor/mainship/silver/corner{
	dir = 8
	},
/area/deathmatch)
"Bw" = (
/obj/structure/bed/chair{
	dir = 4
	},
/obj/structure/window/reinforced/tinted/frosted,
/turf/open/floor/wood,
/area/deathmatch)
"BC" = (
/obj/structure/prop/mainship/ship_memorial,
/turf/open/floor/plating/mainship,
/area/deathmatch)
"Cq" = (
/obj/machinery/door/window{
	dir = 1
	},
/turf/open/floor/mainship/mono,
/area/deathmatch)
"CW" = (
/obj/effect/landmark/eord_roomba,
/turf/open/liquid/water/river,
/area/deathmatch)
"Di" = (
/obj/structure/target_stake,
/obj/item/target,
/obj/item/clothing/suit/storage/faction/militia,
/turf/open/floor/plating/mainship,
/area/deathmatch)
"Dn" = (
/turf/open/floor/grass,
/area/deathmatch)
"DC" = (
/obj/structure/bed/chair{
	dir = 4
	},
/obj/effect/landmark/weapon_spawn/tier2_weapon_spawn,
/turf/open/floor/wood,
/area/deathmatch)
"Ec" = (
/obj/structure/closet/swimsuit,
/turf/open/floor/mainship/mono,
/area/deathmatch)
"Eh" = (
/obj/structure/bed/chair{
	dir = 4
	},
/obj/machinery/light,
/turf/open/floor/wood,
/area/deathmatch)
"FT" = (
/obj/structure/table/reinforced/prison,
/obj/effect/landmark/weapon_spawn/tier1_weapon_spawn,
/obj/machinery/light,
/turf/open/floor/mainship/mono,
/area/deathmatch)
"GD" = (
/obj/item/toy/beach_ball,
/turf/open/liquid/water/river,
/area/deathmatch)
"Hf" = (
/turf/open/floor/mainship/blue{
	dir = 8
	},
/area/deathmatch)
"HC" = (
/obj/effect/turf_decal/warning_stripes/thin{
	dir = 8
	},
/obj/machinery/light{
	dir = 8
	},
/turf/open/floor/wood,
/area/deathmatch)
"HL" = (
/turf/open/floor/wood,
/area/deathmatch)
"In" = (
/obj/structure/sink,
/obj/effect/landmark/eord_roomba,
/turf/open/floor/mainship/mono,
/area/deathmatch)
"IC" = (
/turf/closed/wall/mainship/outer,
/area/space)
"IS" = (
/turf/open/floor/plating/mainship,
/area/deathmatch)
"JI" = (
/obj/structure/table/reinforced/prison,
/obj/effect/landmark/weapon_spawn/tier3_weapon_spawn,
/turf/open/floor/wood,
/area/deathmatch)
"JU" = (
/obj/machinery/floodlight/landing/hq,
/turf/open/floor/mainship/green{
	dir = 1
	},
/area/deathmatch)
"JV" = (
/obj/machinery/floodlight/landing/hq,
/turf/open/floor/mainship/blue,
/area/deathmatch)
"Kh" = (
/turf/open/liquid/water/river,
/area/deathmatch)
"Kr" = (
/obj/item/toy/inflatable_duck,
/turf/open/liquid/water/river,
/area/deathmatch)
"KK" = (
/obj/structure/closet/lasertag/red,
/turf/open/floor/wood,
/area/deathmatch)
"Mn" = (
/obj/machinery/door/airlock/multi_tile/mainship/generic,
/turf/open/floor/wood,
/area/deathmatch)
"Ms" = (
/obj/machinery/floodlight/landing/hq,
/turf/open/floor/mainship/blue{
	dir = 1
	},
/area/deathmatch)
"MX" = (
/obj/machinery/floodlight/landing/hq,
/turf/open/floor/mainship/red{
	dir = 1
	},
/area/deathmatch)
"NH" = (
/obj/effect/forcefield{
	desc = "You can't get in. Heh.";
	name = "Blocker"
	},
/turf/open/floor/mainship/mono,
/area/deathmatch)
"NP" = (
/obj/machinery/light{
	dir = 1
	},
/turf/open/floor/mainship/mono,
/area/deathmatch)
"OO" = (
/obj/effect/landmark/deathmatch,
/obj/effect/ai_node,
/turf/open/floor/wood,
/area/deathmatch)
"OY" = (
/obj/machinery/light,
/turf/open/liquid/water/river,
/area/deathmatch)
"PK" = (
/obj/machinery/disposal,
/turf/open/floor/plating/plating_catwalk,
/area/deathmatch)
"Qz" = (
/obj/machinery/door/airlock/multi_tile/mainship/generic{
	name = "\improper Recreation Area"
	},
/obj/effect/forcefield{
	desc = "You can't get in. Heh.";
	name = "Blocker"
	},
/turf/open/floor/mainship/mono,
/area/deathmatch)
"QG" = (
/turf/open/floor/mainship/blue,
/area/deathmatch)
"Rd" = (
/turf/open/floor/mainship/orange{
	dir = 4
	},
/area/deathmatch)
"Sb" = (
/turf/open/floor/mainship/silver/corner,
/area/deathmatch)
"Sj" = (
/turf/open/floor/mainship/emerald,
/area/deathmatch)
"SK" = (
/obj/structure/bed/chair,
/obj/machinery/light{
	dir = 1
	},
/turf/open/floor/mainship,
/area/deathmatch)
"SS" = (
/obj/effect/turf_decal/warning_stripes/thin,
/obj/structure/window/reinforced,
/obj/structure/platform,
/turf/open/floor/wood,
/area/deathmatch)
"Tn" = (
/turf/open/floor/mainship/orange{
	dir = 1
	},
/area/deathmatch)
"Tt" = (
/obj/effect/turf_decal/warning_stripes/thin{
	dir = 4
	},
/obj/machinery/light{
	dir = 4
	},
/turf/open/floor/wood,
/area/deathmatch)
"Tx" = (
/obj/effect/landmark/weapon_spawn/tier1_weapon_spawn,
/turf/open/floor/wood,
/area/deathmatch)
"TC" = (
/obj/structure/bed/chair{
	dir = 8
	},
/obj/effect/landmark/weapon_spawn/tier2_weapon_spawn,
/turf/open/floor/wood,
/area/deathmatch)
"TL" = (
/obj/structure/bed/chair{
	dir = 4
	},
/obj/effect/landmark/deathmatch,
/turf/open/floor/wood,
/area/deathmatch)
"Uc" = (
/obj/structure/flora/ausbushes/ppflowers,
/turf/open/floor/grass,
/area/deathmatch)
"Ud" = (
/obj/machinery/disposal,
/turf/open/floor/wood,
/area/deathmatch)
"Uo" = (
/obj/machinery/floodlight/landing/hq,
/turf/open/floor/mainship/red,
/area/deathmatch)
"Uu" = (
/obj/structure/bed/chair{
	dir = 8
	},
/obj/effect/landmark/deathmatch,
/obj/machinery/light,
/turf/open/floor/wood,
/area/deathmatch)
"Vg" = (
/obj/structure/bed/chair{
	dir = 4
	},
/turf/open/floor/wood,
/area/deathmatch)
"Vy" = (
/obj/effect/landmark/deathmatch,
/turf/open/floor/mainship/emerald{
	dir = 6
	},
/area/deathmatch)
"VL" = (
/obj/effect/landmark/deathmatch,
/turf/open/floor/mainship/orange{
	dir = 5
	},
/area/deathmatch)
"VY" = (
/obj/effect/forcefield{
	desc = "You can't get in. Heh.";
	name = "Blocker"
	},
/turf/open/floor/mainship/mono,
/area/space)
"Wi" = (
/obj/effect/landmark/deathmatch,
/turf/open/floor/mainship/silver/corner,
/area/deathmatch)
"WF" = (
/obj/structure/window/framed/mainship/hull,
/turf/open/floor/mainship/mono,
/area/deathmatch)
"WU" = (
/obj/effect/landmark/eord_roomba,
/turf/open/floor/plating/mainship,
/area/deathmatch)
"Xi" = (
/obj/effect/landmark/deathmatch,
/turf/open/floor/mainship/red{
	dir = 9
	},
/area/deathmatch)
"Xu" = (
/obj/item/reagent_containers/food/snacks/grown/poppy{
	pixel_x = 4;
	pixel_y = 4
	},
/obj/effect/spawner/random/misc/plushie/fiftyfifty,
/turf/open/floor/grass,
/area/deathmatch)
"Xx" = (
/obj/machinery/door/window{
	dir = 8
	},
/obj/effect/ai_node,
/turf/open/floor/mainship/mono,
/area/deathmatch)
"Yy" = (
/obj/structure/table/reinforced/prison,
/turf/open/floor/mainship/mono,
/area/deathmatch)
"YI" = (
/turf/open/floor/mainship/red{
	dir = 1
	},
/area/deathmatch)
"Zc" = (
/obj/machinery/light{
	dir = 1
	},
/turf/open/floor/wood,
/area/deathmatch)
"Zn" = (
/obj/structure/bed/chair{
	dir = 1
	},
/turf/open/floor/mainship,
/area/deathmatch)
"Zu" = (
/turf/open/floor/mainship,
/area/deathmatch)

(1,1,1) = {"
aa
aa
aa
aa
aa
aa
aa
aa
aa
aa
aa
aa
aa
aa
aa
aa
aa
aa
aa
aa
aa
aa
aa
aa
aa
aa
aa
aa
aa
aa
aa
aa
aa
aa
aa
aa
aa
aa
aa
aa
aa
aa
aa
aa
aa
ab
"}
(2,1,1) = {"
aa
ey
IS
sm
IS
aa
hr
hr
hr
al
aH
aW
bc
aW
aI
af
HC
ap
ap
HC
ap
ap
as
ap
ap
HC
ap
ap
HC
aS
YI
aX
bc
aX
aH
al
bI
bI
aa
bf
bl
bg
bk
be
aa
ab
"}
(3,1,1) = {"
aa
mT
IS
IS
IS
cP
hr
hr
hr
HL
aH
ue
bc
ue
aI
ca
HL
HL
HL
HL
HL
HL
al
HL
HL
HL
HL
HL
HL
SS
YI
Zn
bc
Zn
aH
HL
bI
bI
aa
NP
bg
wK
aa
aa
aa
ab
"}
(4,1,1) = {"
aa
ey
IS
IS
Di
cP
hr
jf
hr
HL
aH
aQ
bc
aQ
aI
am
ak
ak
aq
HL
HL
HL
HL
HL
HL
HL
au
ak
ak
ay
YI
aR
bc
aR
aH
HL
bI
bI
aa
bf
bd
bg
bk
bh
aa
ab
"}
(5,1,1) = {"
aa
ey
IS
IS
IS
cP
hr
hr
hr
HL
aH
ue
bc
ue
aI
ca
HL
HL
ai
HL
HL
HL
HL
HL
HL
HL
av
HL
HL
SS
YI
Zn
bc
Zn
aH
HL
bI
bI
aa
bb
bg
wK
aa
aa
aa
ab
"}
(6,1,1) = {"
aa
mT
IS
IS
IS
cP
hr
hr
hr
HL
aH
ue
bc
ue
aI
ca
OO
HL
ai
HL
al
HL
HL
HL
OO
HL
av
HL
OO
SS
YI
Zn
bc
Zn
aH
HL
bI
bI
aa
bf
bg
bg
bk
be
aa
ab
"}
(7,1,1) = {"
aa
ey
IS
IS
WU
cP
hr
hr
hr
aY
aH
ue
uB
ue
aI
ca
HL
HL
ai
HL
HL
HL
HL
HL
HL
HL
av
HL
HL
SS
YI
Zn
uB
rX
aH
aY
bI
bI
aa
NP
bg
wK
aa
aa
aa
ab
"}
(8,1,1) = {"
aa
ey
IS
Di
IS
cP
hr
hr
hr
HL
aH
ue
bc
ue
aI
ca
HL
HL
ag
ak
ak
ak
aM
ak
ak
ak
aO
HL
HL
SS
YI
Zn
bc
Zn
aH
HL
bI
bI
aa
In
bd
aZ
bc
bi
aa
ab
"}
(9,1,1) = {"
aa
mT
IS
IS
IS
cP
hr
hr
hr
HL
aH
ue
PK
ue
Uo
ca
HL
HL
HL
HL
HL
HL
vK
HL
HL
HL
HL
HL
HL
SS
MX
Zn
PK
Zn
aH
HL
ri
bI
aa
bb
dH
Cq
bc
bm
aa
ab
"}
(10,1,1) = {"
aa
ey
IS
aF
IS
cP
hr
hr
hr
aY
aH
ue
rl
ue
aI
ca
aV
HL
HL
HL
HL
HL
HL
HL
HL
HL
HL
HL
aV
SS
YI
Zn
uB
Zn
aH
aY
bI
bI
aa
bf
bg
ba
bc
bm
aa
ab
"}
(11,1,1) = {"
aa
ey
Di
IS
IS
cP
hr
jf
hr
HL
aH
ue
bc
ue
aI
ca
HL
HL
aV
HL
HL
HL
al
HL
HL
HL
aV
HL
HL
SS
YI
Zn
bc
Zn
aH
HL
bI
bI
aa
NP
bg
ba
wY
bi
aa
ab
"}
(12,1,1) = {"
aa
mT
IS
IS
IS
cP
hr
hr
hr
HL
aH
ue
bc
ue
aI
ca
HL
HL
HL
HL
HL
HL
HL
HL
HL
HL
HL
HL
HL
SS
YI
Zn
bc
Zn
aH
HL
bI
bI
aa
bf
bd
aa
aa
aa
aa
ab
"}
(13,1,1) = {"
aa
ey
IS
IS
IS
cP
hr
hr
hr
aY
aH
ue
uB
ue
aI
ca
aG
HL
HL
HL
HL
HL
Tx
HL
aG
HL
HL
HL
aG
SS
YI
Zn
uB
Zn
aH
aY
bI
bI
aa
bb
bg
bb
bb
Yy
aa
ab
"}
(14,1,1) = {"
aa
yt
nh
nh
nh
cP
hr
hr
hr
HL
aH
ue
bc
ue
aI
ca
HL
HL
HL
HL
HL
HL
HL
HL
HL
HL
HL
HL
HL
SS
YI
Zn
bc
rX
aH
HL
bI
bI
aa
bf
bg
bg
bg
FT
aa
ab
"}
(15,1,1) = {"
aa
HL
nQ
nQ
nQ
cP
hr
hr
hr
HL
aH
ue
bc
ue
aI
ca
HL
HL
HL
HL
HL
HL
HL
HL
HL
HL
HL
HL
HL
SS
YI
Zn
xx
Zn
aH
HL
bI
bI
aa
NP
bg
bb
bb
rM
aa
ab
"}
(16,1,1) = {"
aa
HL
HL
HL
qx
aa
hr
hr
hr
al
aa
SK
bc
aQ
aI
ca
HL
HL
HL
HL
HL
HL
aV
HL
HL
HL
HL
HL
HL
SS
YI
aR
bc
Bd
aa
al
bI
bI
aa
aa
bj
aa
aa
aa
aa
ab
"}
(17,1,1) = {"
aa
aa
HL
HL
HL
HL
HL
HL
HL
qx
aa
Zu
bc
bb
aC
ai
HL
HL
HL
HL
HL
HL
HL
HL
HL
HL
HL
HL
HL
av
aE
bb
bc
Zu
aa
Zc
HL
HL
HL
HL
al
HL
HL
HL
aa
IC
"}
(18,1,1) = {"
NH
Qz
al
HL
HL
HL
HL
HL
HL
HL
Mn
Zu
bc
uB
aC
aj
HL
HL
HL
HL
HL
HL
HL
HL
HL
HL
HL
HL
HL
aT
aE
uB
bc
Zu
Mn
HL
HL
HL
HL
HL
HL
HL
HL
HL
Qz
VY
"}
(19,1,1) = {"
NH
NH
HL
aG
HL
Tx
HL
aG
HL
HL
aY
Zu
cK
bb
aC
ai
aG
HL
HL
HL
HL
al
HL
al
aG
HL
HL
HL
HL
av
aE
bb
cK
Zu
aY
HL
aG
Tx
HL
HL
aG
HL
HL
aG
NH
VY
"}
(20,1,1) = {"
aa
aa
Zc
HL
HL
HL
HL
HL
HL
HL
aH
Zu
aQ
Yy
aB
ca
HL
HL
aV
HL
HL
HL
HL
HL
HL
HL
aV
HL
HL
SS
ae
Zu
Zu
Zu
aH
HL
HL
HL
aa
WF
WF
aa
al
qx
aa
IC
"}
(21,1,1) = {"
NH
Qz
al
HL
HL
HL
HL
HL
HL
HL
aH
Zu
ue
gE
aB
ca
HL
HL
HL
HL
HL
HL
HL
HL
HL
HL
HL
HL
HL
SS
ae
Yy
Zn
Zu
aH
HL
HL
HL
WF
gd
Uc
WF
HL
HL
Qz
VY
"}
(22,1,1) = {"
NH
NH
HL
HL
HL
HL
HL
HL
mJ
Ud
aH
Zu
ue
Yy
aB
ca
HL
HL
HL
HL
HL
HL
al
HL
HL
HL
HL
HL
HL
SS
ae
Yy
Zn
Zu
aH
Ud
mJ
HL
WF
IS
ki
WF
HL
HL
NH
VY
"}
(23,1,1) = {"
aa
aa
Zc
HL
kQ
HL
HL
HL
JI
qx
aa
yi
Al
ac
aD
an
ad
ad
ad
ad
ad
dt
aN
ad
ad
ad
ad
ad
ad
az
JU
Yy
aR
it
aa
Zc
JI
vK
WF
nu
Xu
WF
kQ
qx
aa
IC
"}
(24,1,1) = {"
NH
Qz
HL
HL
HL
HL
HL
HL
mJ
Ud
aH
Zu
ue
Yy
aB
ca
HL
HL
HL
HL
HL
HL
al
HL
HL
HL
HL
HL
HL
SS
ae
Yy
Zn
Zu
aH
Ud
mJ
HL
WF
BC
ki
WF
HL
HL
Qz
VY
"}
(25,1,1) = {"
NH
NH
al
HL
HL
HL
HL
HL
HL
HL
aH
Zu
ue
Yy
aB
ca
HL
HL
HL
HL
HL
HL
HL
HL
HL
HL
HL
HL
HL
SS
ae
Yy
Zn
Zu
aH
HL
HL
HL
WF
IS
Dn
WF
HL
HL
NH
VY
"}
(26,1,1) = {"
aa
aa
Zc
HL
HL
HL
HL
HL
HL
HL
aH
Zu
aQ
Yy
aB
ca
HL
HL
aV
HL
HL
HL
HL
HL
HL
HL
aV
HL
HL
SS
ae
Zu
Zu
Zu
aH
HL
HL
HL
aa
WF
WF
aa
al
qx
aa
IC
"}
(27,1,1) = {"
NH
Qz
HL
aG
HL
Tx
HL
aG
HL
HL
tG
Zu
cK
bb
aC
ai
aG
HL
HL
HL
HL
al
HL
al
aG
HL
HL
HL
HL
av
aE
bb
cK
Zu
tG
HL
aG
Tx
HL
HL
HL
aG
HL
aG
Qz
VY
"}
(28,1,1) = {"
NH
NH
al
HL
HL
HL
HL
HL
HL
HL
HL
Zu
bc
uB
aC
aj
HL
HL
HL
HL
HL
HL
HL
HL
HL
HL
HL
HL
HL
aT
aE
uB
bc
Zu
HL
HL
HL
HL
HL
HL
HL
HL
HL
HL
NH
VY
"}
(29,1,1) = {"
aa
aa
bb
bb
bb
bb
HL
HL
HL
qx
aa
Zu
bc
bb
aC
ai
HL
HL
HL
HL
HL
HL
HL
HL
HL
HL
HL
HL
HL
av
aE
bb
bc
Zu
aa
Zc
HL
HL
HL
HL
HL
HL
HL
HL
aa
IC
"}
(30,1,1) = {"
aa
bb
Wi
Sb
Wi
Ec
aa
hr
hr
al
aa
SK
bc
aQ
QG
ca
HL
HL
HL
HL
HL
HL
aV
HL
HL
HL
HL
HL
HL
SS
aL
aR
bc
Bd
aa
al
bI
bI
bI
HL
HL
HL
HL
nl
aa
ab
"}
(31,1,1) = {"
aa
NP
Kh
Kh
Kh
OY
aa
hr
hr
HL
aH
ue
bc
ue
QG
ca
HL
HL
HL
HL
HL
HL
HL
HL
HL
HL
HL
HL
HL
SS
aL
Zn
bc
Zn
aH
HL
bI
bI
bI
HL
HL
HL
HL
nl
aa
ab
"}
(32,1,1) = {"
aa
bb
Kh
Kh
Kh
Kh
aa
hr
hr
HL
aH
ue
bc
ue
QG
ca
HL
HL
HL
HL
HL
HL
HL
HL
HL
HL
HL
HL
HL
SS
aL
Zn
bc
Zn
aH
HL
bI
bI
bI
Vg
DC
HL
Vg
DC
aa
ab
"}
(33,1,1) = {"
aa
bb
Kh
Kh
GD
Kh
aa
hr
hr
aY
aH
ue
uB
ue
QG
ca
HL
HL
HL
HL
HL
HL
Tx
HL
HL
HL
HL
HL
HL
SS
aL
Zn
uB
Zn
aH
aY
bI
bI
bI
TL
Bw
HL
xH
Eh
aa
aa
"}
(34,1,1) = {"
aa
NP
Kh
Kh
Kh
OY
aa
hr
hr
HL
aH
ue
xx
ue
QG
ca
HL
HL
HL
HL
HL
HL
HL
HL
HL
HL
HL
HL
HL
SS
aL
Zn
bc
Zn
aH
HL
ri
bI
aa
cP
cP
Xx
WF
WF
aa
HL
"}
(35,1,1) = {"
aa
bb
Kh
Kh
Kh
Kh
aa
hr
hr
HL
aH
ue
bc
ue
QG
ca
HL
HL
aV
HL
HL
HL
al
HL
HL
HL
aV
HL
HL
SS
aL
Zn
bc
Zn
aH
HL
bI
bI
cP
Xi
me
bb
Hf
pV
WF
HL
"}
(36,1,1) = {"
aa
bb
Kh
Kh
CW
Kh
aa
hr
hr
aY
aH
ue
uB
ue
QG
ca
aV
HL
HL
HL
HL
HL
HL
HL
HL
HL
HL
HL
aV
SS
aL
Zn
uB
Zn
aH
aY
bI
bI
cP
YI
bg
bg
bg
QG
WF
HL
"}
(37,1,1) = {"
aa
sa
Kh
eo
Kh
OY
aa
hr
hr
HL
aH
ue
PK
ue
JV
ca
aG
HL
HL
HL
HL
HL
vK
HL
aG
HL
HL
HL
HL
SS
Ms
Zn
PK
Zn
aH
HL
bI
bI
cP
rr
bg
et
bg
bb
WF
HL
"}
(38,1,1) = {"
aa
bb
Kh
Kr
Kh
Kh
aa
jf
hr
HL
aH
ue
bc
ue
QG
ca
HL
HL
ah
ap
ap
ap
aM
ap
ap
ap
aP
HL
HL
SS
aL
Zn
bc
Zn
aH
HL
bI
bI
cP
Tn
bg
bg
bg
Sj
WF
HL
"}
(39,1,1) = {"
aa
bb
Kh
Kh
Kh
Kh
aa
hr
hr
aY
aH
ue
uB
ue
QG
ca
HL
HL
ai
HL
HL
HL
HL
HL
HL
HL
av
HL
HL
SS
aL
Zn
uB
Zn
aH
aY
bI
bI
cP
VL
Rd
bb
fe
Vy
WF
HL
"}
(40,1,1) = {"
aa
NP
Kh
Kh
Kh
OY
aa
hr
hr
HL
aH
ue
bc
ue
QG
ca
al
HL
ai
HL
al
HL
HL
HL
al
HL
av
HL
al
SS
aL
Zn
bc
Zn
aH
HL
bI
bI
aa
cP
cP
cd
WF
WF
aa
HL
"}
(41,1,1) = {"
aa
bb
Kh
Kh
Kh
Kh
aa
hr
hr
HL
aH
ue
bc
ue
QG
ca
HL
HL
ai
HL
HL
HL
HL
HL
HL
HL
av
HL
HL
SS
aL
Zn
bc
Zn
aH
HL
bI
bI
bI
yq
zl
HL
eb
Uu
aa
aa
"}
(42,1,1) = {"
aa
bb
Kh
Kh
Kh
Kh
aa
hr
hr
HL
aH
aQ
bc
aQ
QG
ao
ap
ap
ar
HL
HL
HL
HL
HL
HL
HL
ax
ap
ap
aA
aL
aR
bc
aR
aH
HL
bI
bI
bI
TC
yq
HL
TC
yq
aa
ab
"}
(43,1,1) = {"
aa
NP
Kh
Kh
Kh
OY
aa
hr
hr
HL
aH
ue
bc
ue
QG
ca
HL
HL
HL
HL
HL
HL
al
HL
HL
HL
HL
HL
HL
SS
aL
Zn
bc
Zn
aH
HL
ri
bI
bI
HL
HL
aG
HL
KK
aa
ab
"}
(44,1,1) = {"
aa
bb
fM
Bi
fM
jl
aa
hr
hr
al
aH
aW
bc
aW
QG
aw
Tt
ak
ak
Tt
ak
ak
at
ak
ak
Tt
ak
ak
Tt
aU
aL
aX
bc
aX
aH
al
bI
bI
bI
HL
HL
HL
HL
KK
aa
ab
"}
(45,1,1) = {"
aa
bb
bb
rF
bb
jl
aa
aa
aa
aa
aa
aa
aa
aa
aa
aa
aa
aa
aa
aa
aa
aa
aa
aa
aa
aa
aa
aa
aa
aa
aa
aa
aa
aa
aa
aa
aa
aa
aa
aa
aa
aa
aa
aa
aa
ab
"}
(46,1,1) = {"
aa
aa
aa
aa
aa
aa
aa
ab
ab
ab
ab
ab
ab
ab
ab
ab
ab
ab
ab
ab
ab
ab
ab
ab
ab
ab
ab
ab
ab
ab
ab
ab
ab
ab
ab
ab
ab
ab
ab
ab
ab
ab
ab
ab
ab
ab
"}
