//MAP CONVERTED BY dmm2tgm.py THIS HEADER COMMENT PREVENTS RECONVERSION, DO NOT REMOVE
"as" = (
/obj/effect/landmark/eord_roomba,
/turf/open/floor/wood,
/area/deathmatch)
"aB" = (
/turf/open/floor/plating/ground/mars/random/dirt,
/area/deathmatch)
"bl" = (
/obj/effect/landmark/weapon_spawn/tier1_weapon_spawn,
/obj/structure/flora/desert/grass,
/turf/open/floor/plating/ground/mars/random/sand,
/area/deathmatch)
"bE" = (
/obj/effect/decal/cleanable/dirt,
/obj/effect/landmark/weapon_spawn/tier2_weapon_spawn,
/turf/open/floor/plating/ground/mars/random/sand,
/area/deathmatch)
"bP" = (
/turf/open/floor/plating/ground/mars/dirttosand{
	dir = 10
	},
/area/deathmatch)
"bQ" = (
/obj/structure/table/wood/gambling,
/turf/open/floor/wood,
/area/deathmatch)
"bZ" = (
/obj/structure/bed/chair/wood/wings{
	dir = 8
	},
/turf/open/floor/plating/ground/mars/random/sand,
/area/deathmatch)
"cR" = (
/obj/effect/landmark/weapon_spawn/tier2_weapon_spawn,
/obj/effect/landmark/eord_roomba,
/turf/open/floor/plating/asteroidplating{
	color = "#888888"
	},
/area/deathmatch)
"dg" = (
/obj/effect/spawner/random/engineering/ore_box,
/turf/open/floor/plating/ground/mars/random/sand,
/area/deathmatch)
"ds" = (
/obj/machinery/door/airlock/mainship/medical/glass/free_access{
	dir = 2;
	name = "\improper Civilian Housing"
	},
/turf/open/floor/wood,
/area/deathmatch)
"eN" = (
/obj/structure/largecrate/random/barrel/blue,
/turf/open/floor/wood,
/area/deathmatch)
"gb" = (
/obj/effect/decal/cleanable/dirt,
/obj/effect/landmark/weapon_spawn/tier3_weapon_spawn,
/obj/structure/bed/chair/wood/wings,
/turf/open/floor/plating/ground/mars/random/sand,
/area/deathmatch)
"gi" = (
/obj/effect/landmark/deathmatch,
/turf/open/floor/plating/ground/mars/dirttosand{
	dir = 8
	},
/area/deathmatch)
"gK" = (
/obj/structure/window/framed/mainship/requisitions,
/obj/structure/window/framed/wood,
/turf/open/floor/wood,
/area/deathmatch)
"hw" = (
/obj/effect/landmark/weapon_spawn/tier2_weapon_spawn,
/turf/open/floor/plating/asteroidplating{
	color = "#888888"
	},
/area/deathmatch)
"hy" = (
/obj/structure/table/mainship,
/obj/effect/spawner/random/misc/plushie/nospawnninetyfive,
/turf/open/floor/wood,
/area/deathmatch)
"iq" = (
/obj/structure/closet/secure_closet/freezer,
/turf/open/floor/wood,
/area/deathmatch)
"kv" = (
/turf/open/floor/plating/ground/mars/dirttosand{
	dir = 6
	},
/area/deathmatch)
"lX" = (
/obj/effect/decal/cleanable/cobweb{
	dir = 4
	},
/turf/open/floor/wood,
/area/deathmatch)
"mY" = (
/turf/open/floor/plating/ground/mars/dirttosand,
/area/deathmatch)
"no" = (
/obj/item/frame/rack,
/turf/open/floor/wood,
/area/deathmatch)
"os" = (
/obj/structure/bed,
/obj/item/bedsheet/brown,
/turf/open/floor/wood,
/area/deathmatch)
"oE" = (
/obj/structure/flora/desert/cactus/multiple,
/turf/open/floor/plating/ground/mars/random/sand,
/area/deathmatch)
"pl" = (
/turf/open/floor/plating/ground/mars/dirttosand{
	dir = 4
	},
/area/deathmatch)
"pC" = (
/obj/structure/table/mainship,
/obj/effect/landmark/weapon_spawn/tier1_weapon_spawn,
/turf/open/floor/wood,
/area/deathmatch)
"qR" = (
/obj/structure/bed/chair/wood/wings{
	dir = 4
	},
/turf/open/floor/wood,
/area/deathmatch)
"qU" = (
/obj/structure/ladder/id_linked{
	height = 1;
	id = "cs_militia_2";
	pixel_y = 8
	},
/turf/open/floor/plating/asteroidplating{
	color = "#888888"
	},
/area/deathmatch)
"rf" = (
/obj/effect/landmark/weapon_spawn/tier1_weapon_spawn,
/turf/open/floor/plating/ground/mars/random/sand,
/area/deathmatch)
"rj" = (
/obj/effect/landmark/deathmatch,
/obj/structure/toilet{
	dir = 4
	},
/obj/effect/landmark/weapon_spawn/tier1_weapon_spawn,
/turf/open/floor/wood,
/area/deathmatch)
"rn" = (
/obj/effect/landmark/deathmatch,
/turf/open/floor/plating/ground/mars/random/dirt,
/area/deathmatch)
"rs" = (
/obj/effect/decal/cleanable/dirt,
/turf/open/floor/plating/ground/mars/random/sand,
/area/deathmatch)
"rx" = (
/turf/closed/mineral/smooth/desertdamrockwall/indestructible,
/area/deathmatch)
"rK" = (
/obj/machinery/door/window/right,
/turf/open/floor/wood,
/area/deathmatch)
"sv" = (
/obj/structure/ladder/id_linked{
	height = 1;
	id = "cs_militia_1";
	pixel_y = 8
	},
/turf/open/floor/plating/asteroidplating{
	color = "#888888"
	},
/area/deathmatch)
"sM" = (
/obj/structure/desertdam/decals/road/edge{
	pixel_x = -16;
	pixel_y = 16
	},
/obj/structure/desertdam/decals/road/edge{
	dir = 1;
	pixel_x = 16;
	pixel_y = -16
	},
/obj/structure/desertdam/decals/road/edge{
	dir = 4;
	pixel_x = 16;
	pixel_y = 16
	},
/obj/structure/desertdam/decals/road/edge{
	dir = 8;
	pixel_x = -16;
	pixel_y = -16
	},
/obj/structure/ladder/id_linked{
	height = 2;
	id = "cs_militia_4";
	pixel_y = 8
	},
/turf/open/floor/plating/ground/mars/dirttosand{
	dir = 4
	},
/area/deathmatch)
"uN" = (
/obj/structure/closet/cabinet,
/turf/open/floor/wood,
/area/deathmatch)
"uR" = (
/turf/open/floor/plating/ground/mars/random/sand,
/area/deathmatch)
"uT" = (
/obj/structure/flora/tree/joshua,
/turf/open/floor/plating/ground/mars/random/sand,
/area/deathmatch)
"vb" = (
/turf/open/floor/plating/ground/mars/dirttosand{
	dir = 1
	},
/area/deathmatch)
"xg" = (
/obj/structure/flora/desert/grass,
/turf/open/floor/plating/ground/mars/random/sand,
/area/deathmatch)
"xp" = (
/obj/structure/flora/desert/grass,
/turf/open/floor/plating/ground/mars/random/dirt,
/area/deathmatch)
"xA" = (
/obj/structure/desertdam/decals/road/edge{
	pixel_x = -16;
	pixel_y = 16
	},
/obj/structure/desertdam/decals/road/edge{
	dir = 1;
	pixel_x = 16;
	pixel_y = -16
	},
/obj/structure/desertdam/decals/road/edge{
	dir = 4;
	pixel_x = 16;
	pixel_y = 16
	},
/obj/structure/desertdam/decals/road/edge{
	dir = 8;
	pixel_x = -16;
	pixel_y = -16
	},
/obj/structure/ladder/id_linked{
	height = 2;
	id = "cs_militia_3";
	pixel_y = 8
	},
/turf/open/floor/plating/ground/mars/random/sand,
/area/deathmatch)
"xF" = (
/obj/structure/table/wood/gambling,
/obj/effect/landmark/weapon_spawn/tier1_weapon_spawn,
/turf/open/floor/wood,
/area/deathmatch)
"Bm" = (
/obj/structure/table/mainship,
/obj/machinery/microwave,
/turf/open/floor/wood,
/area/deathmatch)
"Bs" = (
/obj/structure/fence,
/turf/open/floor/plating/ground/mars/dirttosand{
	dir = 5
	},
/area/deathmatch)
"BJ" = (
/obj/effect/decal/cleanable/dirt,
/obj/effect/landmark/weapon_spawn/tier1_weapon_spawn,
/obj/structure/bed/chair/wood/wings{
	dir = 4
	},
/turf/open/floor/plating/ground/mars/random/sand,
/area/deathmatch)
"BL" = (
/obj/structure/table/mainship,
/obj/effect/landmark/weapon_spawn/tier5_weapon_spawn,
/turf/open/floor/wood,
/area/deathmatch)
"BN" = (
/obj/effect/landmark/deathmatch,
/turf/open/floor/plating/ground/mars/dirttosand{
	dir = 9
	},
/area/deathmatch)
"CC" = (
/obj/structure/fence,
/turf/open/floor/plating/ground/mars/dirttosand{
	dir = 10
	},
/area/deathmatch)
"CF" = (
/obj/effect/landmark/eord_roomba,
/turf/open/floor/plating/asteroidplating{
	color = "#888888"
	},
/area/deathmatch)
"Dq" = (
/obj/structure/platform{
	dir = 4
	},
/turf/open/floor/plating/asteroidplating{
	color = "#888888"
	},
/area/deathmatch)
"DH" = (
/obj/effect/decal/cleanable/dirt,
/obj/effect/landmark/weapon_spawn/tier3_weapon_spawn,
/turf/open/floor/plating/ground/mars/random/sand,
/area/deathmatch)
"EP" = (
/turf/closed/wall/wood,
/area/deathmatch)
"EV" = (
/obj/effect/spawner/random/misc/plushie/nospawnninetynine,
/turf/open/floor/plating/asteroidplating{
	color = "#888888"
	},
/area/deathmatch)
"Gk" = (
/obj/effect/landmark/deathmatch,
/turf/open/floor/plating/ground/mars/random/sand,
/area/deathmatch)
"Gx" = (
/turf/open/floor/plating/ground/mars/dirttosand{
	dir = 9
	},
/area/deathmatch)
"GB" = (
/obj/structure/platform{
	dir = 8
	},
/turf/open/floor/plating/asteroidplating{
	color = "#888888"
	},
/area/deathmatch)
"GH" = (
/obj/structure/ladder/id_linked{
	height = 1;
	id = "cs_militia_4";
	pixel_y = 8
	},
/turf/open/floor/plating/asteroidplating{
	color = "#888888"
	},
/area/deathmatch)
"Ih" = (
/obj/structure/rack,
/turf/open/floor/wood,
/area/deathmatch)
"Is" = (
/obj/effect/landmark/weapon_spawn/tier1_weapon_spawn,
/turf/open/floor/plating/ground/mars/dirttosand{
	dir = 4
	},
/area/deathmatch)
"IB" = (
/obj/structure/barricade/wooden{
	dir = 4
	},
/turf/open/floor/plating/ground/mars/random/sand,
/area/deathmatch)
"Jj" = (
/obj/structure/window/framed/wood,
/turf/open/floor/wood,
/area/deathmatch)
"Kl" = (
/obj/structure/ladder/id_linked{
	height = 1;
	id = "cs_militia_3";
	pixel_y = 8
	},
/turf/open/floor/plating/asteroidplating{
	color = "#888888"
	},
/area/deathmatch)
"LK" = (
/obj/effect/landmark/deathmatch,
/turf/open/floor/wood,
/area/deathmatch)
"LT" = (
/turf/open/floor/wood,
/area/deathmatch)
"ML" = (
/obj/structure/bed/chair/wood/wings{
	dir = 8
	},
/turf/open/floor/wood,
/area/deathmatch)
"MN" = (
/obj/machinery/door/airlock/mainship/medical/glass/free_access{
	name = "\improper Civilian Housing"
	},
/turf/open/floor/wood,
/area/deathmatch)
"NB" = (
/obj/effect/landmark/deathmatch,
/turf/open/floor/plating/asteroidplating{
	color = "#888888"
	},
/area/deathmatch)
"Od" = (
/obj/structure/largecrate/random/barrel/white,
/turf/open/floor/wood,
/area/deathmatch)
"Or" = (
/obj/structure/bookcase/manuals,
/obj/item/book/manual/ripley_build_and_repair,
/turf/open/floor/wood,
/area/deathmatch)
"Pa" = (
/obj/structure/table/mainship,
/turf/open/floor/wood,
/area/deathmatch)
"Po" = (
/obj/structure/window/framed/mainship/hull,
/obj/structure/window/framed/wood,
/turf/open/floor/wood,
/area/deathmatch)
"PH" = (
/obj/effect/decal/cleanable/cobweb,
/turf/open/floor/wood,
/area/deathmatch)
"Qa" = (
/turf/open/floor/wood/broken,
/area/deathmatch)
"Qf" = (
/obj/structure/window/framed/mainship/hull,
/obj/structure/window/framed/wood,
/turf/open/floor/mainship/mono,
/area/deathmatch)
"QI" = (
/turf/closed/wall,
/area/deathmatch)
"RD" = (
/turf/open/floor/plating/ground/mars/dirttosand{
	dir = 8
	},
/area/deathmatch)
"RZ" = (
/obj/item/storage/belt/champion,
/turf/open/floor/wood,
/area/deathmatch)
"Tb" = (
/obj/structure/bed/chair/wood/wings,
/turf/open/floor/plating/ground/mars/random/sand,
/area/deathmatch)
"TA" = (
/obj/machinery/vending/boozeomat,
/turf/open/floor/wood,
/area/deathmatch)
"TC" = (
/obj/effect/landmark/weapon_spawn/tier1_weapon_spawn,
/turf/open/floor/plating/ground/mars/dirttosand{
	dir = 5
	},
/area/deathmatch)
"Uv" = (
/turf/closed/mineral/smooth/desertdamrockwall,
/area/deathmatch)
"US" = (
/obj/structure/bed/chair/wood/wings{
	dir = 4
	},
/turf/open/floor/plating/ground/mars/random/sand,
/area/deathmatch)
"Vo" = (
/obj/effect/landmark/deathmatch,
/obj/structure/flora/desert/grass,
/turf/open/floor/plating/ground/mars/random/sand,
/area/deathmatch)
"Vu" = (
/obj/structure/ladder/id_linked{
	height = 2;
	id = "cs_militia_1";
	pixel_y = 8
	},
/obj/structure/desertdam/decals/road/edge{
	pixel_x = -16;
	pixel_y = 16
	},
/obj/structure/desertdam/decals/road/edge{
	dir = 1;
	pixel_x = 16;
	pixel_y = -16
	},
/obj/structure/desertdam/decals/road/edge{
	dir = 4;
	pixel_x = 16;
	pixel_y = 16
	},
/obj/structure/desertdam/decals/road/edge{
	dir = 8;
	pixel_x = -16;
	pixel_y = -16
	},
/turf/open/floor/plating/ground/mars/random/sand,
/area/deathmatch)
"WC" = (
/turf/closed/wall{
	color = "#888888"
	},
/area/deathmatch)
"WV" = (
/turf/open/floor/plating/asteroidplating{
	color = "#888888"
	},
/area/deathmatch)
"XA" = (
/obj/effect/decal/cleanable/dirt,
/obj/effect/landmark/weapon_spawn/tier1_weapon_spawn,
/turf/open/floor/plating/ground/mars/random/sand,
/area/deathmatch)
"XG" = (
/obj/effect/landmark/eord_roomba,
/turf/open/floor/plating/ground/mars/random/sand,
/area/deathmatch)
"Yq" = (
/turf/open/floor/plating/ground/mars/dirttosand{
	dir = 5
	},
/area/deathmatch)
"Yw" = (
/obj/effect/landmark/weapon_spawn/tier1_weapon_spawn,
/turf/open/floor/plating/ground/mars/random/dirt,
/area/deathmatch)
"YH" = (
/obj/effect/landmark/weapon_spawn/tier1_weapon_spawn,
/turf/open/floor/wood,
/area/deathmatch)
"YW" = (
/obj/effect/decal/cleanable/dirt,
/obj/structure/bed/chair/wood/wings,
/turf/open/floor/plating/ground/mars/random/sand,
/area/deathmatch)
"Zh" = (
/obj/structure/fence,
/turf/open/floor/plating/ground/mars/random/dirt,
/area/deathmatch)
"ZK" = (
/obj/machinery/door/window{
	dir = 8
	},
/obj/effect/ai_node,
/turf/open/floor/wood,
/area/deathmatch)

(1,1,1) = {"
rx
rx
rx
rx
rx
rx
rx
rx
rx
rx
rx
rx
rx
rx
rx
rx
rx
rx
rx
rx
rx
rx
rx
rx
rx
rx
rx
rx
rx
rx
rx
rx
rx
rx
rx
rx
rx
rx
rx
rx
rx
rx
rx
rx
rx
rx
"}
(2,1,1) = {"
rx
Uv
Uv
Uv
Uv
Uv
Uv
Uv
Uv
Uv
Uv
Uv
Uv
Uv
Uv
Uv
Uv
Uv
Uv
Uv
Uv
pl
Is
kv
uR
Yq
sM
Uv
Uv
Uv
Uv
Uv
Uv
Uv
Uv
Uv
Uv
Uv
Uv
Uv
WC
WC
WC
WC
WC
rx
"}
(3,1,1) = {"
rx
Uv
Uv
Uv
Uv
Uv
Uv
Uv
Uv
Uv
Uv
Uv
Uv
Uv
pl
pl
pl
kv
uR
uR
uR
xg
uR
Gk
uR
uR
Uv
Uv
Uv
Uv
Uv
Uv
Uv
Uv
Uv
Uv
Uv
Uv
Uv
Uv
WC
WV
GH
WV
WC
rx
"}
(4,1,1) = {"
rx
Uv
Uv
Uv
Uv
Uv
Uv
Uv
Uv
Uv
Uv
Uv
Uv
kv
uR
uR
Gk
uR
rf
uR
oE
uR
uR
uR
uR
Uv
Uv
Uv
Uv
Uv
Uv
Uv
Uv
Uv
Uv
Uv
Uv
Uv
WC
WC
WC
WV
NB
WV
WC
rx
"}
(5,1,1) = {"
rx
Uv
Uv
Uv
Uv
Uv
Uv
Uv
Uv
Uv
Uv
Uv
mY
uR
uR
Uv
uR
uR
Gk
XG
uR
rf
Gx
bP
uR
Uv
Uv
Uv
Uv
Uv
Uv
Uv
Uv
Uv
Uv
Uv
Uv
Uv
WC
WV
WV
GB
GB
WV
WC
rx
"}
(6,1,1) = {"
rx
Uv
Uv
Uv
Uv
Uv
Uv
Uv
Uv
Uv
Uv
aB
kv
uR
xg
uR
rf
uR
uR
Gx
RD
QI
QI
QI
MN
QI
QI
QI
QI
Uv
Uv
Uv
Uv
Uv
Uv
Uv
Uv
Uv
WC
WV
WC
WC
WC
WC
WC
rx
"}
(7,1,1) = {"
rx
Uv
Uv
Uv
Uv
Uv
Uv
Uv
Uv
Uv
aB
kv
uR
uR
uR
QI
QI
QI
QI
QI
QI
QI
rj
QI
LT
QI
os
os
QI
Uv
Uv
Uv
Uv
Uv
Uv
Uv
Uv
Uv
WC
hw
WC
Uv
Uv
Uv
Uv
rx
"}
(8,1,1) = {"
rx
Uv
Uv
Uv
Uv
Uv
Uv
Uv
Uv
aB
kv
uR
uR
Uv
uR
QI
PH
LT
LT
LT
QI
QI
MN
QI
LT
ds
LT
LT
QI
Uv
Uv
Uv
Uv
Uv
Uv
Uv
Uv
Uv
WC
WV
WC
Uv
Uv
Uv
Uv
rx
"}
(9,1,1) = {"
rx
Uv
Uv
Uv
Uv
Uv
Uv
Uv
aB
kv
uR
oE
uR
xg
uR
QI
Or
LT
LT
Qa
ds
LT
LT
LT
LT
QI
os
os
QI
Uv
Uv
Uv
Uv
Uv
Uv
Uv
Uv
Uv
WC
CF
WC
Uv
Uv
Uv
Uv
rx
"}
(10,1,1) = {"
rx
Uv
Uv
Uv
Uv
Uv
Uv
Uv
mY
uR
uR
rf
uR
uR
dg
QI
hy
YH
LT
LT
QI
LT
xF
bQ
LT
QI
QI
QI
QI
Uv
Uv
Uv
Uv
Uv
Uv
Uv
Uv
Uv
WC
WV
WC
Uv
Uv
Uv
Uv
rx
"}
(11,1,1) = {"
rx
Uv
Uv
Uv
Uv
Uv
Uv
Uv
mY
uR
uR
uR
Gk
rf
uR
QI
pC
LT
Qa
LK
QI
LT
LT
LT
LT
YH
LT
LT
QI
Uv
Uv
Uv
Uv
Uv
Uv
Uv
Uv
Uv
WC
WV
WC
Uv
Uv
Uv
Uv
rx
"}
(12,1,1) = {"
rx
Uv
Uv
Uv
Uv
Uv
Uv
Uv
mY
uR
uR
uR
uR
uR
uR
QI
lX
LT
eN
Od
QI
LT
LT
LT
as
LT
LT
LT
QI
Uv
Uv
Uv
Uv
Uv
Uv
Uv
Uv
Uv
WC
WV
WC
Uv
Uv
Uv
Uv
rx
"}
(13,1,1) = {"
rx
Uv
Uv
Uv
Uv
Uv
Uv
Uv
Uv
xA
uR
IB
IB
uR
IB
QI
QI
QI
QI
QI
QI
QI
QI
MN
QI
qR
qR
LT
QI
Uv
Uv
Uv
Uv
Uv
WC
WC
WC
WC
WC
WV
WC
WC
WC
Uv
Uv
rx
"}
(14,1,1) = {"
rx
Uv
Uv
Uv
Uv
Uv
Uv
Uv
Uv
Uv
Uv
Uv
uR
uR
uR
xg
uR
Yq
pl
pl
aB
QI
Ih
LT
QI
BL
Pa
LT
QI
Uv
Uv
Uv
Uv
Uv
WC
WV
WV
hw
WV
EV
WV
WV
WC
Uv
Uv
rx
"}
(15,1,1) = {"
rx
Uv
Uv
Uv
Uv
Uv
Uv
Uv
Uv
Uv
Uv
Uv
bP
uR
uR
rf
uR
uR
uR
uR
Yq
QI
no
LT
QI
ML
ML
LT
QI
Uv
Uv
Uv
Uv
Uv
WC
WV
WC
WC
WC
WC
WC
hw
WC
Uv
Uv
rx
"}
(16,1,1) = {"
rx
Uv
Uv
Uv
Uv
Uv
Uv
Uv
Uv
Uv
Uv
Uv
Uv
bP
uR
uR
uR
uR
uR
rf
uR
ds
LT
Qa
QI
LT
LK
TA
QI
Uv
WC
WC
WC
WC
WC
WV
WC
Uv
Uv
Uv
WC
WV
WC
Uv
Uv
rx
"}
(17,1,1) = {"
rx
Uv
Uv
Uv
Uv
Uv
Uv
Uv
Uv
Uv
Uv
Uv
Uv
Uv
bP
xg
oE
Gk
uR
uR
xg
QI
uN
uN
QI
Bm
iq
QI
QI
Uv
WC
Dq
Dq
WV
WV
WV
WC
Uv
Uv
Uv
WC
WV
WC
Uv
Uv
rx
"}
(18,1,1) = {"
rx
Uv
Uv
Uv
Uv
Uv
Uv
Uv
Uv
Uv
Uv
Uv
Uv
Uv
Uv
bP
uR
uR
uR
rf
uR
QI
QI
QI
QI
QI
QI
QI
QI
Uv
WC
WV
NB
hw
WC
WC
WC
Uv
Uv
Uv
WC
WV
WC
Uv
Uv
rx
"}
(19,1,1) = {"
rx
Uv
Uv
Uv
Uv
Uv
Uv
Uv
Uv
Uv
Uv
Uv
Uv
Uv
Uv
Uv
xg
uR
uR
uR
uR
uR
uR
rf
Yq
aB
Uv
Uv
Uv
Uv
WC
WV
Kl
WV
WC
Uv
Uv
Uv
Uv
Uv
WC
WV
WC
Uv
Uv
rx
"}
(20,1,1) = {"
rx
Uv
Uv
Uv
Uv
Uv
Uv
Uv
Uv
Uv
aB
rn
aB
pl
kv
uR
uR
uR
Gk
uR
uR
oE
uR
uR
uR
Yq
Uv
Uv
Uv
Uv
WC
WC
WC
WC
WC
Uv
Uv
Uv
Uv
Uv
WC
WV
WC
Uv
Uv
rx
"}
(21,1,1) = {"
rx
Uv
Uv
Uv
Uv
Uv
Uv
Uv
Uv
aB
aB
pl
kv
rf
rs
DH
BJ
US
uR
US
US
rs
rs
uR
Gk
uR
Uv
Uv
Uv
Uv
Uv
Uv
Uv
Uv
Uv
Uv
Uv
Uv
Uv
Uv
WC
cR
WC
Uv
Uv
rx
"}
(22,1,1) = {"
rx
Uv
Uv
Uv
Uv
Uv
Uv
Uv
Uv
aB
kv
uT
uR
uR
bE
EP
Jj
Jj
ZK
Qf
Qf
EP
XA
uR
uR
uT
Uv
Uv
Uv
Uv
Uv
Uv
Uv
Uv
Uv
Uv
Uv
Uv
Uv
Uv
WC
WV
WC
Uv
Uv
rx
"}
(23,1,1) = {"
rx
Uv
Uv
Uv
Uv
Uv
aB
Uv
aB
mY
uR
uR
uR
uR
YW
gK
LK
LT
LT
LT
LK
Po
YW
uR
uR
uR
Uv
Uv
Uv
Uv
Uv
Uv
Uv
WC
WC
WC
WC
WC
WC
WC
WC
WV
WC
Uv
Uv
rx
"}
(24,1,1) = {"
rx
Uv
Uv
Uv
Uv
Uv
aB
pl
kv
uR
Gk
uR
uR
XG
YW
gK
LT
LT
LT
LT
LT
Po
YW
uR
uR
Gx
Uv
Uv
Uv
Uv
Uv
Uv
Uv
WC
WV
WV
WV
WV
Dq
Dq
WV
hw
WC
Uv
Uv
rx
"}
(25,1,1) = {"
rx
Uv
Uv
Uv
Uv
aB
kv
uR
uR
uR
bl
uR
uR
uR
Tb
gK
LT
LT
RZ
LT
LT
Po
gb
rf
Gx
Uv
Uv
Uv
Uv
Uv
Uv
Uv
Uv
WC
hw
WC
WC
WV
WV
WV
WC
WC
WC
Uv
Uv
rx
"}
(26,1,1) = {"
rx
Uv
Uv
Uv
aB
kv
uR
uR
uR
uR
uR
uR
uR
oE
Tb
gK
LT
LT
LT
LT
LT
Po
YW
uR
Uv
Uv
Uv
Uv
Uv
Uv
Uv
Uv
Uv
WC
WV
WC
WC
WV
qU
NB
WC
Uv
Uv
Uv
Uv
rx
"}
(27,1,1) = {"
rx
Uv
Uv
Uv
kv
rf
uR
uR
uR
Gx
Uv
bP
uR
uR
YW
gK
LK
LT
LT
LT
LK
Po
Tb
Gx
Uv
Uv
Uv
Uv
Uv
Uv
Uv
Uv
Uv
WC
WV
WC
WC
WC
WC
WC
WC
Uv
Uv
Uv
Uv
rx
"}
(28,1,1) = {"
rx
Uv
Uv
mY
oE
uR
uR
uR
Gx
Uv
Uv
Uv
Uv
gi
XA
EP
gK
gK
rK
Po
Po
EP
rf
vb
Uv
Uv
Uv
Uv
Uv
Uv
Uv
Uv
Uv
WC
WV
WC
Uv
Uv
Uv
Uv
Uv
Uv
Uv
Uv
Uv
rx
"}
(29,1,1) = {"
rx
Uv
Uv
mY
uR
uR
xg
Gk
Yq
Uv
Uv
Uv
Uv
aB
uR
uR
bZ
bZ
uR
bZ
bZ
rs
rs
pl
pl
pl
aB
aB
aB
Uv
Uv
Uv
Uv
WC
WV
WC
Uv
Uv
Uv
Uv
Uv
Uv
Uv
Uv
Uv
rx
"}
(30,1,1) = {"
rx
Uv
aB
kv
uR
uR
uR
uR
uR
uR
uR
oE
Yq
aB
Yw
aB
aB
aB
pl
kv
uR
uR
uR
uR
oE
uR
Yq
Yw
aB
Uv
Uv
Uv
Uv
WC
WV
WC
Uv
Uv
Uv
Uv
Uv
Uv
Uv
Uv
Uv
rx
"}
(31,1,1) = {"
rx
Uv
mY
uR
uR
xg
uR
uR
uR
uR
uR
uR
uR
Yq
pl
pl
pl
kv
Gk
uR
xg
uR
Vu
uR
rf
uR
uR
vb
xp
aB
Uv
Uv
Uv
WC
WV
WC
Uv
Uv
Uv
Uv
Uv
Uv
Uv
Uv
Uv
rx
"}
(32,1,1) = {"
rx
Uv
mY
uR
Gk
uT
Uv
Uv
Uv
bP
uR
uR
uR
uR
uR
rf
uR
uR
uR
uR
uR
uR
uR
uR
uR
uR
uR
vb
aB
aB
Uv
Uv
Uv
WC
WV
WC
Uv
Uv
Uv
Uv
WC
WC
WC
WC
WC
rx
"}
(33,1,1) = {"
rx
Uv
mY
uR
xg
Gx
Uv
Uv
Uv
Yw
bP
uR
uR
xg
uR
oE
uR
uR
uR
Gx
Uv
Uv
Uv
Uv
uR
uR
Uv
aB
rn
Uv
Uv
Uv
Uv
WC
hw
WC
WC
WC
WC
WC
WC
WV
sv
NB
WC
rx
"}
(34,1,1) = {"
rx
aB
kv
rf
uR
vb
Uv
Uv
Uv
aB
aB
bP
Gk
uR
uR
uR
uR
Gx
Uv
Uv
Uv
Uv
Uv
Uv
Gk
uR
Uv
aB
aB
Uv
Uv
Uv
Uv
WC
WV
WV
WV
WV
CF
WV
hw
WV
GB
GB
WC
rx
"}
(35,1,1) = {"
rx
kv
uR
uR
uR
Uv
Uv
Uv
Uv
Uv
aB
aB
RD
RD
RD
RD
Uv
Uv
Uv
Uv
Uv
uR
uR
uR
xg
uR
Uv
Uv
Uv
Uv
Uv
Uv
Uv
WC
WC
WC
WC
WC
WC
WC
WC
WC
WC
WC
WC
rx
"}
(36,1,1) = {"
rx
uR
uR
uR
Gx
Uv
Uv
Uv
Uv
Uv
Uv
Uv
Uv
Uv
Uv
Uv
Uv
Uv
Uv
Uv
Uv
uR
rf
uR
uR
uR
Uv
Uv
Uv
Uv
Uv
Uv
Uv
Uv
Uv
Uv
Uv
Uv
Uv
Uv
Uv
Uv
Uv
Uv
Uv
rx
"}
(37,1,1) = {"
rx
uR
uR
Gx
Uv
Uv
Uv
Uv
Uv
Uv
Uv
Uv
Uv
Uv
Uv
Uv
Uv
Uv
Uv
Uv
Uv
uR
uR
Uv
Uv
Uv
Uv
Uv
Uv
Uv
Uv
Uv
Uv
Uv
Uv
Uv
Uv
Uv
Uv
Uv
Uv
Uv
Uv
Uv
Uv
rx
"}
(38,1,1) = {"
rx
uR
uR
vb
Uv
Uv
Uv
Uv
Uv
Uv
Uv
Uv
Uv
Uv
Uv
Uv
Uv
Uv
Uv
Uv
Uv
uR
uR
Uv
Uv
Uv
Uv
Uv
Uv
Uv
Uv
Uv
Uv
Uv
Uv
Uv
Uv
Uv
Uv
Uv
Uv
Uv
Uv
Uv
Uv
rx
"}
(39,1,1) = {"
rx
bP
Vo
Yq
Uv
Uv
Uv
Uv
Uv
kv
uR
uR
uR
uR
Yq
aB
Zh
aB
aB
aB
mY
uR
uR
uR
uR
uR
xg
uR
uR
uR
Uv
Uv
Uv
Uv
Uv
Uv
Uv
Uv
Uv
Uv
Uv
Uv
Uv
Uv
Uv
rx
"}
(40,1,1) = {"
rx
mY
uR
uR
Yq
Uv
Uv
Uv
kv
uR
uR
uR
Uv
uR
uR
TC
Zh
aB
aB
rn
kv
uR
oE
uR
rf
uR
uR
Gk
xg
uR
Uv
Uv
Uv
Uv
Uv
Uv
Uv
Uv
Uv
Uv
Uv
Uv
Uv
Uv
Uv
rx
"}
(41,1,1) = {"
rx
Uv
bP
uR
uR
uR
Yq
Uv
uR
uR
rf
Uv
Uv
uR
xg
uR
Bs
pl
pl
kv
XG
uR
xg
uR
uR
uR
uR
uR
uR
uR
Uv
Uv
Uv
Uv
Uv
Uv
Uv
Uv
Uv
Uv
Uv
Uv
Uv
Uv
Uv
rx
"}
(42,1,1) = {"
rx
Uv
Uv
bP
rf
uR
uR
xg
uR
uR
uR
uR
uR
uR
uR
uR
uR
uR
uR
uR
uR
uR
uR
uR
uR
uR
uT
Gx
RD
RD
Uv
Uv
Uv
Uv
Uv
Uv
Uv
Uv
Uv
Uv
Uv
Uv
Uv
Uv
Uv
rx
"}
(43,1,1) = {"
rx
Uv
Uv
Uv
Uv
bP
uR
uR
uR
rf
uR
uR
xg
uR
uR
uR
uR
uR
xg
uR
rf
uR
uR
uR
xg
uR
Gx
aB
aB
Uv
Uv
Uv
Uv
Uv
Uv
Uv
Uv
Uv
Uv
Uv
Uv
Uv
Uv
Uv
Uv
rx
"}
(44,1,1) = {"
rx
Uv
Uv
Uv
Uv
Uv
Uv
Uv
RD
bP
uR
oE
Gk
Gx
RD
RD
CC
uR
uR
uR
uR
xg
uR
rf
uR
BN
aB
aB
Uv
Uv
Uv
Uv
Uv
Uv
Uv
Uv
Uv
Uv
Uv
Uv
Uv
Uv
Uv
Uv
Uv
rx
"}
(45,1,1) = {"
rx
Uv
Uv
Uv
Uv
Uv
Uv
Uv
aB
aB
RD
RD
RD
aB
aB
aB
Zh
RD
bP
uR
uR
uR
uR
uR
Gx
aB
aB
Uv
Uv
Uv
Uv
Uv
Uv
Uv
Uv
Uv
Uv
Uv
Uv
Uv
Uv
Uv
Uv
Uv
Uv
rx
"}
(46,1,1) = {"
rx
rx
rx
rx
rx
rx
rx
rx
rx
rx
rx
rx
rx
rx
rx
rx
rx
rx
rx
rx
rx
rx
rx
rx
rx
rx
rx
rx
rx
rx
rx
rx
rx
rx
rx
rx
rx
rx
rx
rx
rx
rx
rx
rx
rx
rx
"}
