//MAP CONVERTED BY dmm2tgm.py THIS HEADER COMMENT PREVENTS RECONVERSION, DO NOT REMOVE
"aa" = (
/turf/closed/wall/desert/invincible,
/area/deathmatch)
"aL" = (
/obj/structure/cargo_container/green,
/turf/open/floor/plating/ground/dirt,
/area/deathmatch)
"ch" = (
/obj/structure/cargo_container/horizontal,
/turf/open/floor/industrial,
/area/deathmatch)
"cm" = (
/obj/structure/desertdam/decals/loose_sand_overlay/alt,
/turf/open/floor/tile/dark,
/area/deathmatch)
"de" = (
/obj/effect/landmark/weapon_spawn/tier3_weapon_spawn,
/turf/open/floor/industrial,
/area/deathmatch)
"ez" = (
/turf/closed/desertdamrockwall,
/area/deathmatch)
"eB" = (
/obj/effect/landmark/deathmatch,
/turf/open/floor/tile/dark,
/area/deathmatch)
"eX" = (
/obj/effect/landmark/weapon_spawn/tier4_weapon_spawn,
/turf/open/floor/plating/ground/dirt,
/area/deathmatch)
"gA" = (
/obj/structure/inflatable,
/turf/open/floor/tile,
/area/deathmatch)
"gC" = (
/obj/structure/largecrate/guns/merc,
/turf/open/floor/tile/yellow/full,
/area/deathmatch)
"ht" = (
/obj/effect/landmark/weapon_spawn/tier4_weapon_spawn,
/turf/open/floor/tile,
/area/deathmatch)
"hO" = (
/turf/open/floor/plating/ground/dirt,
/area/deathmatch)
"if" = (
/obj/effect/landmark/deathmatch,
/turf/open/floor/industrial,
/area/deathmatch)
"ir" = (
/obj/structure/desertdam/decals/loose_sand_overlay,
/turf/open/floor/tile/yellow/full,
/area/deathmatch)
"iE" = (
/obj/structure/platform_decoration{
	dir = 4
	},
/turf/open/floor/plating/ground/dirt,
/area/deathmatch)
"jk" = (
/obj/effect/landmark/weapon_spawn/tier2_weapon_spawn,
/turf/open/floor/tile,
/area/deathmatch)
"kz" = (
/obj/structure/desertdam/decals/loose_sand_overlay/alt,
/turf/open/floor/industrial,
/area/deathmatch)
"kE" = (
/turf/open/floor/industrial,
/area/deathmatch)
"lK" = (
/obj/structure/stairs{
	dir = 1
	},
/turf/open/floor/industrial,
/area/deathmatch)
"md" = (
/turf/open/floor/tile/dark,
/area/deathmatch)
"mE" = (
/obj/structure/largecrate/random/secure,
/turf/open/floor/plating/ground/dirt,
/area/deathmatch)
"nl" = (
/obj/effect/landmark/weapon_spawn/tier2_weapon_spawn,
/turf/open/floor/industrial,
/area/deathmatch)
"nz" = (
/obj/structure/inflatable,
/turf/open/floor/industrial,
/area/deathmatch)
"nE" = (
/obj/structure/cargo_container/green{
	dir = 4
	},
/turf/open/floor/plating/ground/dirt,
/area/deathmatch)
"nT" = (
/obj/structure/cargo_container/ch_red{
	dir = 4
	},
/turf/open/floor/plating/ground/dirt,
/area/deathmatch)
"oi" = (
/obj/structure/platform{
	dir = 1
	},
/obj/structure/platform_decoration{
	dir = 5
	},
/obj/structure/platform{
	dir = 8
	},
/turf/open/floor/plating/ground/dirt,
/area/deathmatch)
"px" = (
/obj/structure/platform_decoration{
	dir = 8
	},
/turf/open/floor/plating/ground/dirt,
/area/deathmatch)
"pI" = (
/turf/open/floor/tile,
/area/deathmatch)
"pN" = (
/obj/structure/cargo_container{
	dir = 4
	},
/turf/open/floor/plating/ground/dirt,
/area/deathmatch)
"pY" = (
/obj/structure/platform{
	dir = 8
	},
/turf/open/floor/tile,
/area/deathmatch)
"qR" = (
/obj/effect/landmark/weapon_spawn/tier1_weapon_spawn,
/turf/open/floor/tile,
/area/deathmatch)
"qS" = (
/obj/effect/landmark/weapon_spawn/tier1_weapon_spawn,
/turf/open/floor/plating/ground/dirt,
/area/deathmatch)
"qZ" = (
/obj/machinery/door/airlock/sandstone,
/turf/open/floor/plating/ground/dirt,
/area/deathmatch)
"ri" = (
/obj/effect/landmark/weapon_spawn/tier4_weapon_spawn,
/obj/effect/landmark/deathmatch,
/turf/open/floor/tile,
/area/deathmatch)
"uf" = (
/obj/structure/platform{
	dir = 8
	},
/turf/open/floor/plating/ground/dirt,
/area/deathmatch)
"wz" = (
/obj/structure/cargo_container/green{
	dir = 1
	},
/turf/open/floor/plating/ground/dirt,
/area/deathmatch)
"wG" = (
/obj/structure/platform_decoration{
	dir = 1
	},
/turf/open/floor/plating/ground/dirt,
/area/deathmatch)
"wI" = (
/obj/structure/cargo_container,
/turf/open/floor/plating/ground/dirt,
/area/deathmatch)
"xg" = (
/obj/vehicle/train/cargo/trolley,
/turf/open/floor/plating/ground/dirt,
/area/deathmatch)
"xm" = (
/obj/structure/cargo_container/ch_red{
	dir = 1
	},
/turf/open/floor/plating/ground/dirt,
/area/deathmatch)
"yN" = (
/obj/structure/desertdam/decals/loose_sand_overlay,
/turf/open/floor/industrial,
/area/deathmatch)
"yY" = (
/obj/effect/landmark/weapon_spawn/tier1_weapon_spawn,
/obj/effect/landmark/deathmatch,
/turf/open/floor/plating/ground/dirt,
/area/deathmatch)
"zg" = (
/obj/structure/platform{
	dir = 4
	},
/turf/open/floor/plating/ground/dirt,
/area/deathmatch)
"AM" = (
/obj/effect/landmark/deathmatch,
/turf/open/floor/tile,
/area/deathmatch)
"Ba" = (
/obj/effect/landmark/weapon_spawn/tier2_weapon_spawn,
/obj/effect/landmark/deathmatch,
/turf/open/floor/tile/dark,
/area/deathmatch)
"BI" = (
/obj/structure/stairs{
	dir = 1
	},
/turf/open/floor/plating/ground/dirt,
/area/deathmatch)
"BV" = (
/obj/structure/platform{
	dir = 1
	},
/turf/open/floor/plating/ground/dirt,
/area/deathmatch)
"Cz" = (
/obj/structure/platform{
	dir = 8
	},
/obj/structure/cargo_container/horizontal{
	dir = 1
	},
/turf/open/floor/plating/ground/dirt,
/area/deathmatch)
"CS" = (
/obj/structure/ore_box,
/turf/open/floor/tile/dark,
/area/deathmatch)
"DN" = (
/obj/effect/landmark/weapon_spawn/tier3_weapon_spawn,
/obj/effect/landmark/deathmatch,
/turf/open/floor/tile/dark,
/area/deathmatch)
"DS" = (
/obj/structure/platform_decoration{
	dir = 8
	},
/obj/structure/platform_decoration{
	dir = 4
	},
/turf/open/floor/plating/ground/dirt,
/area/deathmatch)
"DV" = (
/obj/effect/landmark/weapon_spawn/tier3_weapon_spawn,
/turf/open/floor/plating/ground/dirt,
/area/deathmatch)
"DZ" = (
/obj/machinery/door/airlock/sandstone,
/turf/open/floor/industrial,
/area/deathmatch)
"Gm" = (
/obj/effect/landmark/weapon_spawn/tier5_weapon_spawn,
/turf/open/floor/industrial,
/area/deathmatch)
"Hh" = (
/obj/structure/platform,
/turf/open/floor/plating/ground/dirt,
/area/deathmatch)
"HM" = (
/obj/structure/stairs{
	dir = 1
	},
/obj/structure/desertdam/decals/loose_sand_overlay,
/turf/open/floor/plating/ground/dirt,
/area/deathmatch)
"HT" = (
/obj/structure/ore_box,
/turf/open/floor/tile,
/area/deathmatch)
"HY" = (
/obj/effect/decal/cleanable/rune,
/obj/item/explosive/plastique,
/turf/open/floor/plating/ground/dirt,
/area/deathmatch)
"Ic" = (
/obj/structure/platform{
	dir = 8
	},
/obj/structure/ore_box,
/turf/open/floor/plating/ground/dirt,
/area/deathmatch)
"Ii" = (
/obj/effect/landmark/deathmatch,
/turf/open/floor/plating/ground/dirt,
/area/deathmatch)
"IH" = (
/obj/structure/platform_decoration,
/turf/open/floor/plating/ground/dirt,
/area/deathmatch)
"Jb" = (
/obj/structure/platform_decoration{
	dir = 4
	},
/obj/structure/cargo_container/horizontal,
/turf/open/floor/plating/ground/dirt,
/area/deathmatch)
"Jg" = (
/obj/effect/landmark/weapon_spawn/tier3_weapon_spawn,
/obj/effect/landmark/deathmatch,
/turf/open/floor/plating/ground/dirt,
/area/deathmatch)
"Jv" = (
/obj/structure/cargo_container/ch_red,
/turf/open/floor/plating/ground/dirt,
/area/deathmatch)
"Jy" = (
/obj/structure/largecrate/random/barrel/yellow,
/turf/open/floor/tile,
/area/deathmatch)
"JF" = (
/obj/effect/landmark/weapon_spawn/tier5_weapon_spawn,
/turf/open/floor/tile,
/area/deathmatch)
"Lq" = (
/obj/structure/platform{
	dir = 8
	},
/obj/structure/largecrate/random/barrel/yellow,
/turf/open/floor/plating/ground/dirt,
/area/deathmatch)
"LF" = (
/obj/structure/largecrate/random/barrel/yellow,
/turf/open/floor/plating/ground/dirt,
/area/deathmatch)
"LJ" = (
/obj/structure/platform{
	dir = 4
	},
/obj/structure/largecrate/random/secure,
/turf/open/floor/plating/ground/dirt,
/area/deathmatch)
"Ng" = (
/obj/vehicle/train/cargo/engine,
/turf/open/floor/plating/ground/dirt,
/area/deathmatch)
"Nh" = (
/obj/structure/desertdam/decals/loose_sand_overlay,
/turf/open/floor/tile/dark,
/area/deathmatch)
"NI" = (
/obj/structure/desertdam/decals/loose_sand_overlay,
/turf/open/floor/tile,
/area/deathmatch)
"Oi" = (
/obj/effect/decal/cleanable/rune,
/obj/item/explosive/plastique,
/turf/open/floor/tile,
/area/deathmatch)
"OP" = (
/obj/structure/largecrate/random,
/turf/open/floor/plating/ground/dirt,
/area/deathmatch)
"Pf" = (
/obj/effect/landmark/weapon_spawn/tier5_weapon_spawn,
/turf/open/floor/plating/ground/dirt,
/area/deathmatch)
"Pr" = (
/turf/open/floor/tile/yellow/full,
/area/deathmatch)
"PV" = (
/obj/effect/landmark/weapon_spawn/tier5_weapon_spawn,
/turf/open/floor/tile/yellow/full,
/area/deathmatch)
"Qj" = (
/obj/structure/stairs{
	dir = 4
	},
/turf/open/floor/industrial,
/area/deathmatch)
"QP" = (
/obj/structure/inflatable,
/turf/open/floor/plating/ground/dirt,
/area/deathmatch)
"Sh" = (
/obj/vehicle/train/cargo/engine{
	dir = 1
	},
/turf/open/floor/plating/ground/dirt,
/area/deathmatch)
"So" = (
/obj/structure/largecrate/random,
/turf/open/floor/tile/dark,
/area/deathmatch)
"Sp" = (
/obj/structure/desertdam/decals/loose_sand_overlay/alt,
/turf/open/floor/tile,
/area/deathmatch)
"Ss" = (
/obj/structure/cargo_container/horizontal{
	dir = 1
	},
/turf/open/floor/industrial,
/area/deathmatch)
"SF" = (
/obj/machinery/door/airlock/sandstone,
/turf/open/floor/tile/yellow/full,
/area/deathmatch)
"SO" = (
/obj/structure/largecrate/random,
/turf/open/floor/tile,
/area/deathmatch)
"SU" = (
/obj/structure/cargo_container{
	dir = 1
	},
/turf/open/floor/plating/ground/dirt,
/area/deathmatch)
"Uq" = (
/obj/effect/landmark/weapon_spawn/tier2_weapon_spawn,
/obj/effect/landmark/deathmatch,
/turf/open/floor/plating/ground/dirt,
/area/deathmatch)
"WT" = (
/obj/structure/platform{
	dir = 8
	},
/obj/structure/cargo_container/horizontal{
	dir = 4
	},
/turf/open/floor/plating/ground/dirt,
/area/deathmatch)
"XI" = (
/obj/structure/cargo_container/horizontal{
	dir = 4
	},
/turf/open/floor/industrial,
/area/deathmatch)
"Yh" = (
/obj/structure/desertdam/decals/loose_sand_overlay/alt,
/turf/open/floor/tile/yellow/full,
/area/deathmatch)
"Yj" = (
/obj/effect/landmark/weapon_spawn/tier4_weapon_spawn,
/turf/open/floor/industrial,
/area/deathmatch)
"YD" = (
/turf/closed/wall/desert,
/area/deathmatch)
"Ze" = (
/obj/structure/ore_box,
/turf/open/floor/plating/ground/dirt,
/area/deathmatch)
"Zp" = (
/obj/structure/largecrate/guns/merc,
/turf/open/floor/tile,
/area/deathmatch)
"Zr" = (
/obj/effect/landmark/weapon_spawn/tier1_weapon_spawn,
/obj/effect/landmark/deathmatch,
/turf/open/floor/tile/dark,
/area/deathmatch)
"ZW" = (
/obj/effect/landmark/weapon_spawn/tier2_weapon_spawn,
/turf/open/floor/plating/ground/dirt,
/area/deathmatch)

(1,1,1) = {"
ez
ez
ez
ez
ez
ez
ez
ez
ez
ez
aa
aa
ez
ez
ez
aa
aa
aa
ez
ez
ez
aa
aa
aa
aa
aa
ez
ez
ez
ez
ez
ez
ez
ez
ez
ez
ez
ez
ez
ez
ez
aa
aa
aa
aa
ez
"}
(2,1,1) = {"
ez
YD
YD
YD
YD
YD
YD
YD
YD
YD
YD
px
hO
hO
hO
hO
hO
YD
ez
ez
ez
YD
Ss
XI
ch
YD
ez
ez
ez
ez
ez
ez
ez
ez
ez
ez
YD
YD
YD
YD
YD
YD
hO
hO
YD
ez
"}
(3,1,1) = {"
ez
YD
pI
pI
Jy
pI
pI
pI
AM
pI
Zp
BV
hO
hO
eX
hO
hO
YD
YD
YD
YD
YD
kE
kE
kE
YD
ez
YD
YD
YD
YD
YD
YD
YD
YD
YD
YD
hO
hO
hO
hO
hO
hO
hO
YD
ez
"}
(4,1,1) = {"
ez
YD
pI
pI
pI
pI
JF
pI
pI
pI
Sp
DS
hO
hO
hO
hO
hO
kz
kE
kE
kE
kE
nl
kE
kE
YD
ez
YD
hO
hO
hO
hO
hO
hO
hO
hO
hO
hO
hO
hO
qS
hO
hO
hO
YD
aa
"}
(5,1,1) = {"
ez
YD
pI
pI
pI
pI
pI
pI
jk
pI
pI
BV
hO
hO
hO
hO
Ii
kE
kE
yN
kE
kE
kE
kE
kE
YD
ez
YD
hO
hO
hO
hO
hO
hO
eX
hO
hO
hO
hO
hO
hO
hO
Ii
hO
xg
aa
"}
(6,1,1) = {"
ez
YD
YD
YD
YD
YD
pI
pI
pI
pI
pI
BV
hO
ZW
hO
hO
hO
YD
YD
YD
YD
YD
kE
if
kE
YD
YD
YD
hO
hO
Ii
hO
hO
hO
hO
hO
hO
Ii
hO
hO
hO
hO
hO
hO
xg
aa
"}
(7,1,1) = {"
ez
ez
ez
ez
ez
YD
uf
uf
uf
Cz
WT
Jb
hO
hO
hO
hO
hO
hO
YD
ez
ez
YD
kE
kE
kE
kE
kz
hO
hO
hO
hO
hO
hO
hO
hO
hO
IH
zg
zg
zg
zg
zg
zg
px
Ng
aa
"}
(8,1,1) = {"
ez
ez
ez
ez
ez
YD
hO
mE
hO
qS
hO
hO
hO
hO
Ii
hO
xg
hO
QP
YD
ez
YD
kE
Yj
yN
kE
kE
hO
hO
qS
hO
hO
hO
hO
hO
hO
Hh
Ze
hO
hO
hO
hO
hO
hO
hO
aa
"}
(9,1,1) = {"
ez
ez
ez
ez
ez
YD
hO
hO
HY
hO
hO
hO
hO
hO
hO
hO
xg
hO
YD
ez
ez
YD
kE
kE
kE
YD
YD
YD
hO
hO
hO
hO
hO
ZW
hO
hO
Hh
hO
hO
hO
qS
hO
eX
hO
hO
aa
"}
(10,1,1) = {"
ez
ez
ez
ez
ez
YD
hO
hO
OP
hO
hO
DV
hO
hO
QP
hO
Sh
YD
ez
ez
ez
YD
kE
if
kE
YD
ez
YD
hO
hO
hO
hO
hO
hO
mE
mE
Hh
hO
hO
hO
hO
hO
ZW
hO
hO
aa
"}
(11,1,1) = {"
ez
ez
ez
ez
ez
ez
YD
OP
Ze
hO
hO
hO
hO
hO
YD
YD
YD
ez
ez
ez
ez
YD
kE
kE
kE
YD
ez
YD
hO
hO
hO
Ii
hO
hO
hO
hO
Hh
hO
hO
hO
hO
hO
hO
hO
hO
aa
"}
(12,1,1) = {"
ez
ez
ez
ez
ez
ez
ez
YD
YD
YD
YD
YD
hO
qZ
YD
ez
ez
ez
YD
YD
YD
YD
YD
Qj
Qj
YD
ez
YD
YD
YD
hO
hO
hO
hO
hO
YD
YD
mE
hO
hO
hO
Ii
hO
hO
YD
aa
"}
(13,1,1) = {"
ez
ez
ez
ez
ez
ez
ez
ez
hO
hO
hO
hO
hO
hO
YD
ez
ez
ez
YD
kE
kE
kE
lK
if
kE
YD
ez
ez
ez
ez
YD
YD
YD
YD
YD
YD
YD
YD
hO
DV
hO
hO
hO
hO
YD
aa
"}
(14,1,1) = {"
ez
ez
ez
ez
ez
ez
ez
ez
hO
ZW
hO
eX
hO
hO
YD
ez
ez
ez
YD
if
kE
kE
lK
kE
Gm
YD
ez
ez
ez
ez
ez
ez
ez
ez
YD
YD
YD
YD
hO
hO
hO
hO
hO
hO
hO
aa
"}
(15,1,1) = {"
ez
ez
ez
ez
ez
ez
ez
ez
ez
hO
hO
hO
hO
QP
YD
ez
ez
ez
YD
kE
de
kE
YD
YD
YD
YD
ez
ez
ez
ez
ez
ez
ez
ez
ez
YD
YD
hO
hO
hO
xg
xg
hO
hO
hO
aa
"}
(16,1,1) = {"
ez
ez
ez
ez
ez
ez
ez
ez
ez
Jv
hO
hO
hO
QP
YD
ez
ez
ez
YD
kE
kE
kz
YD
ez
ez
ez
ez
ez
ez
ez
ez
ez
ez
ez
ez
ez
YD
YD
YD
YD
YD
YD
Jg
Uq
yY
aa
"}
(17,1,1) = {"
ez
ez
ez
ez
ez
ez
ez
ez
ez
xm
hO
hO
hO
hO
YD
ez
ez
ez
YD
kE
if
nz
YD
ez
ez
ez
YD
YD
YD
YD
YD
YD
YD
YD
YD
ez
ez
ez
ez
ez
ez
YD
Jg
Uq
Uq
aa
"}
(18,1,1) = {"
ez
ez
ez
ez
ez
ez
ez
ez
ez
nT
hO
hO
hO
hO
YD
ez
ez
ez
YD
kE
kE
kE
YD
ez
ez
YD
YD
YD
YD
hO
hO
hO
hO
hO
YD
ez
ez
ez
ez
ez
ez
YD
Uq
Uq
Uq
aa
"}
(19,1,1) = {"
ez
ez
ez
ez
ez
ez
ez
ez
ez
ez
hO
hO
hO
hO
YD
YD
YD
YD
YD
yN
DZ
DZ
YD
YD
YD
YD
hO
hO
hO
hO
hO
Ii
hO
hO
YD
ez
ez
ez
ez
ez
ez
YD
Jg
Uq
Uq
aa
"}
(20,1,1) = {"
ez
ez
ez
ez
ez
ez
ez
ez
ez
ez
hO
hO
Ii
hO
hO
hO
hO
hO
YD
hO
hO
hO
hO
hO
hO
hO
Ii
hO
hO
hO
hO
hO
hO
hO
YD
YD
YD
YD
YD
YD
YD
YD
Jg
Uq
yY
aa
"}
(21,1,1) = {"
ez
ez
ez
ez
ez
ez
ez
ez
ez
ez
xg
hO
hO
hO
hO
ZW
hO
hO
qZ
hO
hO
DV
hO
hO
hO
eX
hO
hO
Ii
hO
hO
hO
ZW
hO
hO
hO
hO
hO
hO
hO
hO
Hh
hO
hO
hO
aa
"}
(22,1,1) = {"
ez
ez
ez
ez
ez
ez
ez
ez
ez
ez
xg
hO
DV
hO
hO
hO
hO
hO
Pf
hO
Ii
hO
hO
hO
Ii
hO
hO
hO
hO
LF
hO
hO
hO
YD
YD
YD
YD
ez
ez
hO
qS
Hh
hO
Ii
hO
aa
"}
(23,1,1) = {"
ez
ez
ez
ez
ez
ez
ez
ez
ez
ez
Sh
hO
hO
hO
hO
ZW
hO
hO
YD
zg
zg
LJ
zg
zg
zg
zg
zg
zg
zg
hO
hO
hO
YD
YD
YD
YD
YD
YD
ez
ez
hO
Hh
hO
DV
hO
aa
"}
(24,1,1) = {"
ez
ez
ez
ez
ez
ez
ez
YD
YD
YD
YD
YD
hO
hO
mE
YD
YD
YD
YD
pI
pI
pI
pI
pI
pI
pI
pI
pI
Sp
hO
hO
hO
YD
YD
YD
YD
YD
YD
ez
ez
hO
Hh
hO
hO
hO
aa
"}
(25,1,1) = {"
ez
ez
ez
ez
ez
ez
ez
YD
Zr
Ba
DN
DN
Nh
md
So
YD
YD
YD
YD
pI
qR
pI
pI
YD
YD
YD
YD
YD
YD
YD
Ii
hO
YD
YD
YD
YD
YD
YD
ez
ez
hO
Hh
hO
hO
YD
aa
"}
(26,1,1) = {"
ez
ez
ez
ez
ez
ez
ez
YD
Ba
Ba
Zr
DN
md
md
cm
YD
YD
YD
YD
pI
pI
pI
YD
ez
ez
ez
ez
ez
ez
YD
hO
hO
YD
YD
YD
YD
YD
YD
ez
ez
hO
wG
hO
hO
YD
aa
"}
(27,1,1) = {"
ez
ez
ez
ez
ez
ez
ez
YD
Ba
Zr
Ba
Ba
md
eB
md
YD
YD
YD
YD
pI
pI
AM
YD
ez
ez
ez
ez
ez
ez
YD
hO
hO
hO
YD
YD
YD
YD
ez
ez
hO
hO
hO
ZW
hO
YD
aa
"}
(28,1,1) = {"
ez
ez
ez
ez
ez
ez
YD
YD
YD
YD
YD
YD
md
Nh
CS
YD
YD
YD
YD
ri
pI
pI
YD
ez
ez
ez
ez
ez
ez
YD
hO
hO
hO
hO
hO
Sh
xg
xg
hO
hO
hO
eX
hO
hO
YD
aa
"}
(29,1,1) = {"
ez
ez
ez
ez
ez
ez
YD
Jy
pI
pI
pI
pI
pY
pI
pY
pI
pI
pI
pI
pI
pI
pI
YD
ez
ez
ez
ez
ez
ez
YD
hO
Ii
hO
hO
hO
hO
hO
hO
hO
hO
Ii
hO
hO
hO
YD
aa
"}
(30,1,1) = {"
ez
ez
ez
ez
ez
ez
YD
Jy
pI
pI
pI
pI
AM
pI
pI
pI
qR
pI
pI
pI
pI
Zp
YD
ez
ez
ez
ez
ez
ez
YD
hO
hO
hO
qS
hO
hO
hO
hO
ZW
hO
hO
hO
hO
hO
YD
aa
"}
(31,1,1) = {"
ez
ez
ez
ez
ez
ez
YD
pI
pI
pI
pI
pI
pI
pI
pI
Zp
pI
pI
pI
pI
HT
SO
YD
YD
YD
YD
YD
YD
YD
YD
YD
YD
hO
hO
hO
hO
hO
hO
hO
LF
YD
YD
YD
YD
YD
aa
"}
(32,1,1) = {"
ez
ez
ez
ez
ez
ez
YD
pI
pI
AM
pI
oi
uf
hO
uf
YD
YD
YD
YD
YD
YD
YD
YD
YD
hO
hO
hO
hO
Pr
Yh
Pr
SF
hO
hO
DV
Ii
hO
hO
hO
hO
YD
ez
ez
ez
ez
ez
"}
(33,1,1) = {"
ez
ez
ez
ez
ez
ez
YD
pI
Jy
pI
pI
BV
aL
hO
hO
YD
ez
ez
ez
ez
ez
ez
YD
hO
wI
hO
hO
hO
SF
PV
Pr
ir
hO
hO
hO
hO
hO
hO
hO
hO
YD
ez
ez
ez
ez
ez
"}
(34,1,1) = {"
ez
ez
ez
ez
ez
ez
YD
pI
pI
pI
pI
BV
wz
hO
hO
YD
ez
ez
ez
ez
ez
YD
YD
hO
SU
hO
ZW
hO
SF
gC
Pr
SF
hO
hO
hO
xg
xg
Sh
hO
hO
YD
ez
ez
ez
ez
ez
"}
(35,1,1) = {"
ez
ez
ez
ez
ez
ez
YD
gA
qR
pI
pI
BV
nE
eX
hO
YD
ez
ez
ez
ez
ez
YD
YD
hO
pN
hO
hO
hO
YD
YD
YD
YD
YD
YD
YD
YD
YD
YD
YD
YD
YD
ez
ez
ez
ez
ez
"}
(36,1,1) = {"
ez
ez
ez
ez
ez
ez
YD
pI
pI
ht
Jy
BV
hO
hO
hO
YD
ez
ez
ez
ez
ez
ez
YD
QP
hO
hO
hO
hO
YD
YD
YD
YD
YD
YD
ez
ez
ez
ez
ez
ez
ez
ez
ez
ez
ez
ez
"}
(37,1,1) = {"
ez
ez
ez
YD
YD
YD
YD
pI
pI
pI
pI
BV
hO
hO
hO
YD
ez
ez
ez
ez
ez
ez
YD
hO
hO
hO
Ii
hO
hO
hO
hO
hO
LF
YD
ez
ez
ez
ez
ez
ez
ez
ez
ez
ez
ez
ez
"}
(38,1,1) = {"
ez
ez
ez
YD
hO
hO
BI
pI
pI
gA
SO
pY
BV
hO
Ii
YD
ez
ez
ez
ez
ez
ez
YD
hO
hO
hO
hO
hO
hO
ZW
hO
hO
hO
YD
ez
ez
ez
ez
ez
ez
ez
ez
ez
ez
ez
ez
"}
(39,1,1) = {"
ez
ez
ez
YD
hO
hO
BI
Sp
AM
pI
Oi
pI
BV
hO
hO
YD
YD
YD
YD
YD
YD
YD
YD
Ii
hO
hO
eX
hO
hO
hO
hO
qS
OP
YD
ez
ez
ez
ez
ez
ez
ez
ez
ez
ez
ez
ez
"}
(40,1,1) = {"
ez
ez
ez
YD
hO
Ii
HM
pI
pI
SO
pI
pI
BV
hO
hO
hO
hO
hO
hO
hO
hO
hO
hO
hO
hO
hO
hO
hO
hO
hO
hO
hO
Ze
YD
YD
YD
YD
ez
ez
ez
ez
ez
ez
ez
ez
ez
"}
(41,1,1) = {"
ez
ez
ez
YD
hO
hO
wG
Lq
uf
uf
uf
Ic
iE
hO
ZW
hO
hO
hO
hO
hO
qS
hO
hO
hO
hO
hO
hO
wG
uf
uf
uf
uf
uf
iE
hO
OP
YD
ez
ez
ez
ez
ez
ez
ez
ez
ez
"}
(42,1,1) = {"
ez
ez
ez
YD
hO
hO
hO
qS
hO
hO
Ii
hO
hO
hO
hO
hO
hO
hO
hO
hO
hO
hO
hO
hO
hO
Ii
hO
hO
hO
hO
hO
hO
Ii
hO
hO
Ze
YD
ez
ez
ez
ez
ez
ez
ez
ez
ez
"}
(43,1,1) = {"
ez
ez
ez
YD
hO
DV
hO
hO
hO
hO
hO
hO
hO
hO
hO
hO
hO
hO
hO
DV
hO
hO
hO
hO
hO
IH
zg
hO
zg
zg
zg
zg
px
ZW
OP
OP
YD
ez
ez
ez
ez
ez
ez
ez
ez
ez
"}
(44,1,1) = {"
ez
ez
ez
YD
YD
YD
YD
ZW
hO
YD
YD
YD
xg
xg
xg
xg
Ng
YD
YD
YD
YD
YD
YD
YD
YD
YD
pI
Sp
pI
NI
pI
pI
YD
YD
YD
YD
YD
ez
ez
ez
ez
ez
ez
ez
ez
ez
"}
(45,1,1) = {"
ez
ez
ez
ez
ez
ez
YD
hO
hO
YD
YD
YD
hO
hO
hO
hO
hO
YD
ez
ez
ez
ez
ez
ez
ez
YD
pI
pI
AM
JF
pI
pI
YD
ez
ez
ez
ez
ez
ez
ez
ez
ez
ez
ez
ez
ez
"}
(46,1,1) = {"
ez
ez
ez
ez
ez
ez
ez
ez
ez
ez
ez
aa
aa
aa
aa
aa
aa
aa
ez
ez
ez
ez
ez
ez
ez
aa
aa
aa
aa
aa
aa
aa
aa
ez
ez
ez
ez
ez
ez
ez
ez
ez
ez
ez
ez
ez
"}
