//MAP CONVERTED BY dmm2tgm.py THIS HEADER COMMENT PREVENTS RECONVERSION, DO NOT REMOVE
"a" = (
/turf/closed/desertdamrockwall/invincible,
/area/deathmatch)
"b" = (
/turf/closed/desertdamrockwall,
/area/deathmatch)
"c" = (
/turf/open/beach/sand,
/area/deathmatch)
"d" = (
/turf/closed/wall/desert,
/area/deathmatch)
"e" = (
/turf/open/floor/tile/brown/full,
/area/deathmatch)
"f" = (
/obj/structure/barricade/guardrail{
	dir = 4
	},
/turf/open/floor/tile/brown/full,
/area/deathmatch)
"g" = (
/obj/structure/largecrate/random,
/turf/open/beach/sand,
/area/deathmatch)
"h" = (
/turf/open/ground/desertdam,
/area/deathmatch)
"i" = (
/obj/effect/landmark/deathmatch,
/obj/effect/landmark/weapon_spawn/tier1_weapon_spawn,
/turf/open/floor/tile/dark,
/area/deathmatch)
"j" = (
/obj/effect/landmark/deathmatch,
/obj/effect/landmark/weapon_spawn/tier2_weapon_spawn,
/turf/open/floor/tile/dark,
/area/deathmatch)
"k" = (
/obj/effect/landmark/deathmatch,
/obj/effect/landmark/weapon_spawn/tier3_weapon_spawn,
/turf/open/floor/tile/dark,
/area/deathmatch)
"l" = (
/obj/structure/barricade/guardrail,
/turf/open/floor/tile/brown/full,
/area/deathmatch)
"m" = (
/obj/structure/barricade/guardrail,
/obj/structure/barricade/guardrail{
	dir = 4
	},
/turf/open/floor/tile/brown/full,
/area/deathmatch)
"n" = (
/obj/structure/barricade/guardrail,
/obj/structure/barricade/guardrail{
	dir = 8
	},
/turf/open/floor/tile/brown/full,
/area/deathmatch)
"o" = (
/turf/open/floor/tile/dark,
/area/deathmatch)
"p" = (
/obj/vehicle/train/cargo/trolley,
/turf/open/beach/sand,
/area/deathmatch)
"q" = (
/obj/machinery/door/airlock/sandstone,
/turf/open/beach/sand,
/area/deathmatch)
"r" = (
/turf/open/floor/tile/yellow/full,
/area/deathmatch)
"s" = (
/obj/structure/barricade/guardrail{
	dir = 4
	},
/turf/open/beach/sand,
/area/deathmatch)
"t" = (
/obj/machinery/door/airlock/sandstone,
/turf/open/floor/tile/yellow/full,
/area/deathmatch)
"u" = (
/obj/structure/largecrate/random,
/obj/structure/barricade/guardrail{
	dir = 4
	},
/turf/open/beach/sand,
/area/deathmatch)
"v" = (
/obj/structure/largecrate/random,
/turf/open/floor/tile/brown/full,
/area/deathmatch)
"w" = (
/obj/structure/barricade/guardrail{
	dir = 8
	},
/turf/open/floor/tile/brown/full,
/area/deathmatch)
"x" = (
/obj/structure/barricade/guardrail{
	dir = 1
	},
/obj/structure/barricade/guardrail{
	dir = 8
	},
/turf/open/ground/desertdam,
/area/deathmatch)
"y" = (
/obj/structure/barricade/guardrail{
	dir = 1
	},
/turf/open/ground/desertdam,
/area/deathmatch)
"z" = (
/obj/structure/barricade/guardrail{
	dir = 1
	},
/turf/open/beach/sand,
/area/deathmatch)
"A" = (
/obj/structure/barricade/guardrail{
	dir = 8
	},
/turf/open/ground/desertdam,
/area/deathmatch)
"B" = (
/obj/structure/barricade/guardrail{
	dir = 8
	},
/turf/open/beach/sand,
/area/deathmatch)
"C" = (
/obj/effect/landmark/deathmatch,
/obj/effect/landmark/weapon_spawn/tier3_weapon_spawn,
/turf/open/beach/sand,
/area/deathmatch)
"D" = (
/obj/effect/landmark/deathmatch,
/obj/effect/landmark/weapon_spawn/tier2_weapon_spawn,
/turf/open/beach/sand,
/area/deathmatch)
"E" = (
/obj/effect/landmark/deathmatch,
/obj/effect/landmark/weapon_spawn/tier1_weapon_spawn,
/turf/open/beach/sand,
/area/deathmatch)

(1,1,1) = {"
a
a
a
a
a
a
a
a
a
a
a
a
a
a
a
a
a
a
a
a
a
a
a
a
a
a
a
a
a
a
a
a
a
a
a
a
a
a
a
a
a
a
a
a
a
a
"}
(2,1,1) = {"
a
d
d
d
d
d
d
d
d
d
d
c
c
c
c
c
c
d
b
b
b
d
r
r
r
d
b
b
b
b
b
b
b
b
b
b
b
d
d
d
d
d
c
c
c
a
"}
(3,1,1) = {"
a
d
e
e
e
e
e
e
e
e
l
c
c
c
c
c
c
d
d
d
d
d
r
r
r
d
b
d
d
d
d
d
d
d
d
d
d
c
c
c
c
c
c
c
c
a
"}
(4,1,1) = {"
a
d
e
e
e
e
e
e
e
e
e
c
c
c
h
h
c
r
r
r
r
r
r
r
r
d
b
d
c
c
c
c
c
c
c
c
c
c
c
c
c
c
c
c
c
a
"}
(5,1,1) = {"
a
d
e
e
e
e
e
e
e
e
l
g
c
c
h
h
c
r
r
r
r
r
r
r
r
d
b
d
c
c
c
c
c
c
c
c
c
c
c
c
c
c
c
c
c
a
"}
(6,1,1) = {"
a
d
d
d
d
d
f
f
f
f
m
c
c
c
h
c
c
d
d
d
d
d
r
r
r
d
d
d
c
c
c
c
c
c
c
c
c
c
c
c
c
c
c
c
c
a
"}
(7,1,1) = {"
a
b
b
b
b
d
c
c
c
g
c
h
h
h
h
c
c
c
d
b
b
d
r
r
r
r
r
c
c
h
h
c
c
c
c
c
c
c
c
c
c
c
c
c
c
a
"}
(8,1,1) = {"
a
b
b
b
b
d
c
c
c
c
c
h
h
h
c
c
p
c
c
d
b
d
r
r
r
r
r
c
c
h
h
c
c
h
h
h
c
x
A
A
B
B
B
c
c
a
"}
(9,1,1) = {"
a
b
b
b
b
d
c
c
h
h
h
h
h
c
c
c
p
c
d
b
b
d
r
r
r
d
d
d
c
c
c
c
c
h
h
h
c
y
h
h
c
c
c
c
c
a
"}
(10,1,1) = {"
a
b
b
b
b
d
c
c
g
c
c
c
h
c
c
c
c
d
b
b
b
d
r
r
r
d
b
d
c
c
c
c
c
c
c
g
g
z
c
c
h
h
h
c
c
a
"}
(11,1,1) = {"
a
b
b
b
b
b
d
g
g
c
c
c
h
c
d
d
d
b
b
b
b
d
r
r
r
d
b
d
c
c
c
c
c
c
c
c
c
z
c
c
h
h
h
h
c
a
"}
(12,1,1) = {"
a
b
b
b
b
b
b
d
d
d
d
d
c
q
d
b
b
b
d
d
d
d
r
r
r
d
b
d
d
d
c
c
c
c
c
c
c
z
c
c
c
c
c
h
c
a
"}
(13,1,1) = {"
a
b
b
b
b
b
b
b
c
c
c
c
c
c
d
b
b
b
d
r
r
r
r
r
r
d
b
b
b
b
d
d
d
d
d
d
d
c
c
c
c
c
c
h
c
a
"}
(14,1,1) = {"
a
b
b
b
b
b
b
b
c
c
c
c
h
c
d
b
b
b
d
r
r
r
r
r
r
d
b
b
b
b
b
b
b
b
b
b
d
c
c
c
c
c
c
h
c
a
"}
(15,1,1) = {"
a
b
b
b
b
b
b
b
b
c
c
c
h
g
d
b
b
b
d
r
r
r
d
d
d
d
b
b
b
b
b
b
b
b
b
b
d
c
c
c
p
p
c
c
c
a
"}
(16,1,1) = {"
a
b
b
b
b
b
b
b
b
c
c
c
h
c
d
b
b
b
d
r
r
r
d
b
b
b
b
b
b
b
b
b
b
b
b
b
d
d
d
d
d
d
C
D
E
a
"}
(17,1,1) = {"
a
b
b
b
b
b
b
b
b
c
c
c
h
c
d
b
b
b
d
r
r
r
d
b
b
b
b
b
d
d
d
d
d
d
d
b
b
b
b
b
b
d
C
D
D
a
"}
(18,1,1) = {"
a
b
b
b
b
b
b
b
b
c
c
c
h
c
d
b
b
b
d
r
r
r
d
b
b
b
d
d
d
c
c
c
c
c
d
b
b
b
b
b
b
d
D
D
D
a
"}
(19,1,1) = {"
a
b
b
b
b
b
b
b
b
b
c
c
h
c
d
d
d
d
d
r
t
t
d
d
d
d
c
c
c
c
c
c
c
c
d
b
b
b
b
b
b
d
C
D
D
a
"}
(20,1,1) = {"
a
b
b
b
b
b
b
b
b
b
c
c
h
c
c
c
c
c
d
c
c
c
c
c
c
c
c
c
c
c
c
c
c
c
d
d
d
d
d
d
d
d
C
D
E
a
"}
(21,1,1) = {"
a
b
b
b
b
b
b
b
b
b
c
c
c
h
c
c
c
c
q
c
c
c
c
c
c
c
c
c
c
c
c
c
c
c
c
c
c
c
c
c
c
c
z
c
c
a
"}
(22,1,1) = {"
a
b
b
b
b
b
b
b
b
b
c
c
c
h
h
h
h
h
h
h
c
c
c
c
c
c
c
c
c
c
c
c
c
d
d
d
d
d
d
d
c
c
z
h
c
a
"}
(23,1,1) = {"
a
b
b
b
b
b
b
b
b
b
c
c
c
h
c
c
c
c
d
s
s
u
s
s
s
s
s
s
s
c
c
c
d
b
b
b
b
b
b
d
c
c
z
h
c
a
"}
(24,1,1) = {"
a
b
b
b
b
b
b
d
d
d
d
d
c
h
c
d
d
d
d
e
e
e
e
e
e
e
e
e
e
c
c
c
d
b
b
b
b
b
b
d
c
c
z
h
c
a
"}
(25,1,1) = {"
a
b
b
b
b
b
b
d
i
j
k
k
o
o
o
d
b
b
d
e
e
e
e
d
d
d
d
d
d
c
c
c
d
b
b
b
b
b
b
d
c
c
z
h
c
a
"}
(26,1,1) = {"
a
b
b
b
b
b
b
d
j
j
i
k
o
o
o
d
b
b
d
e
e
e
d
b
b
b
b
b
b
d
c
c
d
b
b
b
b
b
b
d
c
c
c
h
c
a
"}
(27,1,1) = {"
a
b
b
b
b
b
b
d
j
i
j
j
o
o
o
d
b
b
d
e
e
e
d
b
b
b
b
b
b
d
c
c
c
d
d
d
d
d
d
d
c
c
c
h
c
a
"}
(28,1,1) = {"
a
b
b
b
b
b
d
d
k
j
j
k
o
o
o
d
d
d
d
e
e
e
d
b
b
b
b
b
b
d
c
c
c
c
c
c
p
p
c
c
c
h
h
h
c
a
"}
(29,1,1) = {"
a
b
b
b
b
b
d
e
e
e
e
e
e
e
e
e
e
e
e
e
e
e
d
b
b
b
b
b
b
d
c
c
c
c
c
c
c
c
c
h
h
c
c
c
c
a
"}
(30,1,1) = {"
a
b
b
b
b
b
d
e
e
e
e
e
e
e
e
e
e
e
e
e
e
e
d
b
b
b
b
b
b
d
c
c
c
c
c
h
h
h
h
c
c
c
c
c
c
a
"}
(31,1,1) = {"
a
b
b
b
b
b
d
e
e
e
e
e
e
e
e
e
e
e
e
e
e
v
d
d
d
d
d
d
d
d
d
d
c
c
c
h
h
h
h
c
d
d
d
d
d
a
"}
(32,1,1) = {"
a
b
b
b
b
b
d
e
e
e
l
g
c
c
c
d
d
d
d
d
d
d
d
c
c
c
c
c
r
r
r
t
c
c
c
c
c
c
c
c
d
b
b
b
b
a
"}
(33,1,1) = {"
a
b
b
b
b
b
d
e
e
e
l
g
c
c
c
d
b
b
b
b
b
b
d
c
c
c
c
c
t
r
r
r
c
c
c
c
c
c
c
c
d
b
b
b
b
a
"}
(34,1,1) = {"
a
b
b
b
b
b
d
e
e
e
l
c
c
c
c
d
b
b
b
b
b
b
d
g
g
c
c
c
t
r
r
t
c
c
c
p
p
c
c
c
d
b
b
b
b
a
"}
(35,1,1) = {"
a
b
b
b
b
b
d
e
e
e
l
c
c
c
c
d
b
b
b
b
b
b
d
g
g
c
c
c
d
d
d
d
d
d
d
d
d
d
d
d
d
b
b
b
b
a
"}
(36,1,1) = {"
a
b
b
b
b
b
d
e
e
e
l
c
c
c
c
d
b
b
b
b
b
b
d
c
c
c
c
c
d
d
d
d
d
d
b
b
b
b
b
b
b
b
b
b
b
a
"}
(37,1,1) = {"
a
b
b
d
d
d
d
e
e
e
l
c
c
c
c
d
b
b
b
b
b
b
d
c
c
c
c
c
c
c
c
c
c
d
b
b
b
b
b
b
b
b
b
b
b
a
"}
(38,1,1) = {"
a
b
b
d
c
c
c
e
e
e
e
n
c
c
c
d
b
b
b
b
b
b
d
c
c
c
c
c
c
c
c
c
c
d
b
b
b
b
b
b
b
b
b
b
b
a
"}
(39,1,1) = {"
a
b
b
d
c
c
c
e
e
e
e
l
c
c
c
d
d
d
d
d
d
d
d
c
c
c
c
c
c
c
c
c
c
d
b
b
b
b
b
b
b
b
b
b
b
a
"}
(40,1,1) = {"
a
b
b
d
c
c
c
f
f
f
f
m
c
c
c
c
c
c
c
c
c
c
c
c
c
c
c
c
c
c
c
c
c
d
d
d
d
b
b
b
b
b
b
b
b
a
"}
(41,1,1) = {"
a
b
b
d
c
c
c
c
c
c
c
g
c
c
c
h
h
h
h
h
h
h
c
c
c
c
c
c
c
c
c
c
c
c
c
c
d
b
b
b
b
b
b
b
b
a
"}
(42,1,1) = {"
a
b
b
d
c
c
c
c
c
c
c
c
c
c
c
h
h
h
h
h
h
h
c
c
c
c
c
c
c
c
c
c
c
c
c
c
d
b
b
b
b
b
b
b
b
a
"}
(43,1,1) = {"
a
b
b
d
c
c
c
c
c
c
c
c
c
c
c
c
c
c
c
c
c
c
c
c
c
c
c
c
c
c
c
c
c
c
c
c
d
b
b
b
b
b
b
b
b
a
"}
(44,1,1) = {"
a
b
b
d
d
d
d
c
c
d
d
d
p
p
c
p
p
d
d
d
d
d
d
d
d
d
e
w
w
w
w
w
d
d
d
d
d
b
b
b
b
b
b
b
b
a
"}
(45,1,1) = {"
a
b
b
b
b
b
d
c
c
d
d
d
c
c
c
c
c
d
b
b
b
b
b
b
b
d
e
e
e
e
e
e
d
b
b
b
b
b
b
b
b
b
b
b
b
a
"}
(46,1,1) = {"
a
a
a
a
a
a
a
a
a
a
a
a
a
a
a
a
a
a
a
a
a
a
a
a
a
a
a
a
a
a
a
a
a
a
a
a
a
a
a
a
a
a
a
a
a
a
"}
