//MAP CONVERTED BY dmm2tgm.py THIS HEADER COMMENT PREVENTS RECONVERSION, DO NOT REMOVE
"aa" = (
/turf/closed/wall/desert/invincible,
/area/deathmatch)
"ak" = (
/obj/effect/ai_node,
/turf/open/floor/tile,
/area/deathmatch)
"aL" = (
/obj/structure/cargo_container/green,
/turf/open/floor/plating/ground/dirt,
/area/deathmatch)
"bq" = (
/obj/effect/landmark/eord_roomba,
/turf/open/floor/plating/ground/dirt,
/area/deathmatch)
"ch" = (
/obj/structure/cargo_container/horizontal,
/turf/open/floor/industrial,
/area/deathmatch)
"cm" = (
/obj/structure/desertdam/decals/loose_sand_overlay/alt,
/turf/open/floor/tile/dark,
/area/deathmatch)
"de" = (
/obj/effect/landmark/weapon_spawn/tier3_weapon_spawn,
/turf/open/floor/industrial,
/area/deathmatch)
"ez" = (
/turf/closed/mineral/smooth/desertdamrockwall,
/area/deathmatch)
"eB" = (
/obj/effect/landmark/deathmatch,
/turf/open/floor/tile/dark,
/area/deathmatch)
"eJ" = (
/obj/structure/window/framed/mainship/hull,
/obj/structure/window/framed/wood,
/turf/open/floor/wood,
/area/deathmatch)
"eX" = (
/obj/effect/landmark/weapon_spawn/tier4_weapon_spawn,
/turf/open/floor/plating/ground/dirt,
/area/deathmatch)
"gA" = (
/obj/structure/inflatable/wall,
/turf/open/floor/tile,
/area/deathmatch)
"gC" = (
/obj/structure/largecrate/guns/merc,
/turf/open/floor/tile/yellow/full,
/area/deathmatch)
"gY" = (
/obj/effect/spawner/random/misc/plushie/nospawnninetynine,
/turf/open/floor/tile/dark,
/area/deathmatch)
"ht" = (
/obj/effect/landmark/weapon_spawn/tier4_weapon_spawn,
/turf/open/floor/tile,
/area/deathmatch)
"hD" = (
/obj/structure/platform{
	dir = 10
	},
/turf/open/floor/tile,
/area/deathmatch)
"hH" = (
/obj/effect/ai_node,
/turf/open/floor/plating/ground/dirt,
/area/deathmatch)
"hO" = (
/obj/effect/landmark/weapon_spawn/tier3_weapon_spawn,
/obj/effect/ai_node,
/turf/open/floor/plating/ground/dirt,
/area/deathmatch)
"ia" = (
/obj/effect/landmark/deathmatch,
/obj/effect/ai_node,
/obj/effect/ai_node,
/turf/open/floor/industrial,
/area/deathmatch)
"if" = (
/obj/effect/landmark/deathmatch,
/turf/open/floor/industrial,
/area/deathmatch)
"ir" = (
/obj/structure/desertdam/decals/loose_sand_overlay,
/turf/open/floor/tile/yellow/full,
/area/deathmatch)
"iE" = (
/obj/structure/platform_decoration{
	dir = 4
	},
/turf/open/floor/plating/ground/dirt,
/area/deathmatch)
"jk" = (
/obj/effect/landmark/weapon_spawn/tier2_weapon_spawn,
/turf/open/floor/tile,
/area/deathmatch)
"jH" = (
/obj/structure/window/framed/mainship/hull,
/obj/structure/window/framed/wood,
/turf/open/floor/mainship/mono,
/area/deathmatch)
"kh" = (
/obj/structure/cargo_container/horizontal,
/turf/open/floor/plating/ground/dirt,
/area/deathmatch)
"kz" = (
/obj/structure/desertdam/decals/loose_sand_overlay/alt,
/turf/open/floor/industrial,
/area/deathmatch)
"kE" = (
/obj/effect/ai_node,
/turf/open/floor/industrial,
/area/deathmatch)
"kP" = (
/obj/structure/cargo_container/horizontal{
	dir = 4
	},
/turf/open/floor/plating/ground/dirt,
/area/deathmatch)
"lq" = (
/obj/structure/cargo_container/horizontal{
	dir = 1
	},
/turf/open/floor/plating/ground/dirt,
/area/deathmatch)
"lI" = (
/obj/structure/platform{
	dir = 6
	},
/turf/open/floor/tile,
/area/deathmatch)
"lK" = (
/obj/structure/stairs,
/turf/open/floor/industrial,
/area/deathmatch)
"md" = (
/obj/structure/desertdam/decals/loose_sand_overlay/alt,
/obj/effect/ai_node,
/turf/open/floor/industrial,
/area/deathmatch)
"mC" = (
/obj/structure/window/framed/mainship/requisitions,
/obj/structure/window/framed/wood,
/turf/open/floor/wood,
/area/deathmatch)
"mE" = (
/obj/structure/largecrate/random/secure,
/turf/open/floor/plating/ground/dirt,
/area/deathmatch)
"nl" = (
/obj/effect/landmark/weapon_spawn/tier2_weapon_spawn,
/turf/open/floor/industrial,
/area/deathmatch)
"nz" = (
/obj/structure/inflatable/wall,
/turf/open/floor/industrial,
/area/deathmatch)
"nE" = (
/obj/structure/cargo_container/green{
	dir = 4
	},
/turf/open/floor/plating/ground/dirt,
/area/deathmatch)
"nM" = (
/obj/effect/landmark/deathmatch,
/obj/effect/ai_node,
/turf/open/floor/plating/ground/dirt,
/area/deathmatch)
"nT" = (
/obj/structure/cargo_container/ch_red{
	dir = 4
	},
/turf/open/floor/plating/ground/dirt,
/area/deathmatch)
"od" = (
/obj/machinery/door/airlock/mainship/generic{
	dir = 2
	},
/turf/open/floor/plating/ground/dirt,
/area/deathmatch)
"px" = (
/obj/structure/platform_decoration{
	dir = 8
	},
/turf/open/floor/plating/ground/dirt,
/area/deathmatch)
"pI" = (
/turf/open/floor/tile,
/area/deathmatch)
"pN" = (
/obj/structure/cargo_container{
	dir = 4
	},
/turf/open/floor/plating/ground/dirt,
/area/deathmatch)
"pY" = (
/obj/structure/platform{
	dir = 8
	},
/turf/open/floor/tile,
/area/deathmatch)
"qR" = (
/obj/effect/landmark/weapon_spawn/tier1_weapon_spawn,
/turf/open/floor/tile,
/area/deathmatch)
"qS" = (
/obj/structure/platform_decoration{
	dir = 8
	},
/obj/effect/ai_node,
/turf/open/floor/plating/ground/dirt,
/area/deathmatch)
"qZ" = (
/obj/machinery/door/airlock/mainship/generic,
/turf/open/floor/plating/ground/dirt,
/area/deathmatch)
"ri" = (
/obj/effect/landmark/weapon_spawn/tier4_weapon_spawn,
/obj/effect/landmark/deathmatch,
/turf/open/floor/tile,
/area/deathmatch)
"ry" = (
/obj/machinery/door/window{
	dir = 8
	},
/obj/effect/ai_node,
/turf/open/floor/wood,
/area/deathmatch)
"rA" = (
/obj/effect/spawner/random/engineering/ore_box,
/obj/structure/platform{
	dir = 9
	},
/turf/open/floor/plating/ground/dirt,
/area/deathmatch)
"tN" = (
/obj/structure/largecrate/guns/merc,
/obj/structure/platform,
/turf/open/floor/tile,
/area/deathmatch)
"uf" = (
/obj/structure/platform{
	dir = 8
	},
/turf/open/floor/plating/ground/dirt,
/area/deathmatch)
"vG" = (
/obj/effect/spawner/random/engineering/ore_box,
/obj/structure/platform{
	dir = 4
	},
/turf/open/floor/tile/dark,
/area/deathmatch)
"wz" = (
/obj/structure/cargo_container/green{
	dir = 1
	},
/turf/open/floor/plating/ground/dirt,
/area/deathmatch)
"wG" = (
/obj/structure/platform_decoration{
	dir = 1
	},
/turf/open/floor/plating/ground/dirt,
/area/deathmatch)
"wI" = (
/obj/structure/cargo_container,
/turf/open/floor/plating/ground/dirt,
/area/deathmatch)
"xb" = (
/obj/effect/spawner/random/misc/plushie/nospawnninetyfive,
/turf/open/floor/tile/yellow/full,
/area/deathmatch)
"xf" = (
/obj/structure/desertdam/decals/loose_sand_overlay/alt,
/obj/structure/platform{
	dir = 8
	},
/turf/open/floor/tile,
/area/deathmatch)
"xg" = (
/obj/vehicle/train/cargo/trolley,
/turf/open/floor/plating/ground/dirt,
/area/deathmatch)
"xm" = (
/obj/structure/cargo_container/ch_red{
	dir = 1
	},
/turf/open/floor/plating/ground/dirt,
/area/deathmatch)
"xn" = (
/turf/open/floor/tile/dark,
/area/deathmatch)
"xQ" = (
/obj/structure/desertdam/decals/loose_sand_overlay,
/obj/effect/landmark/eord_roomba,
/turf/open/floor/industrial,
/area/deathmatch)
"yN" = (
/obj/structure/desertdam/decals/loose_sand_overlay,
/turf/open/floor/industrial,
/area/deathmatch)
"yV" = (
/turf/closed/wall/wood,
/area/deathmatch)
"yY" = (
/obj/effect/landmark/weapon_spawn/tier1_weapon_spawn,
/obj/effect/landmark/deathmatch,
/turf/open/floor/plating/ground/dirt,
/area/deathmatch)
"ze" = (
/obj/structure/platform{
	dir = 4
	},
/turf/open/floor/tile,
/area/deathmatch)
"zg" = (
/obj/structure/platform{
	dir = 4
	},
/turf/open/floor/plating/ground/dirt,
/area/deathmatch)
"AM" = (
/obj/effect/landmark/deathmatch,
/turf/open/floor/tile,
/area/deathmatch)
"Ba" = (
/obj/effect/landmark/weapon_spawn/tier2_weapon_spawn,
/obj/effect/landmark/deathmatch,
/turf/open/floor/tile/dark,
/area/deathmatch)
"Bg" = (
/obj/effect/landmark/deathmatch,
/turf/open/floor/wood,
/area/deathmatch)
"Bt" = (
/obj/item/storage/belt/champion,
/turf/open/floor/wood,
/area/deathmatch)
"BI" = (
/obj/structure/stairs,
/turf/open/floor/plating/ground/dirt,
/area/deathmatch)
"BV" = (
/obj/structure/platform{
	dir = 1
	},
/turf/open/floor/plating/ground/dirt,
/area/deathmatch)
"Cc" = (
/obj/structure/desertdam/decals/loose_sand_overlay,
/obj/structure/platform{
	dir = 8
	},
/turf/open/floor/tile,
/area/deathmatch)
"DN" = (
/obj/effect/landmark/weapon_spawn/tier3_weapon_spawn,
/obj/effect/landmark/deathmatch,
/turf/open/floor/tile/dark,
/area/deathmatch)
"DS" = (
/obj/structure/platform_decoration{
	dir = 8
	},
/obj/structure/platform_decoration{
	dir = 4
	},
/turf/open/floor/plating/ground/dirt,
/area/deathmatch)
"DV" = (
/obj/effect/landmark/weapon_spawn/tier3_weapon_spawn,
/turf/open/floor/plating/ground/dirt,
/area/deathmatch)
"DZ" = (
/obj/machinery/door/airlock/mainship/generic,
/turf/open/floor/industrial,
/area/deathmatch)
"FE" = (
/turf/open/floor/plating/ground/dirt,
/area/deathmatch)
"Gm" = (
/obj/effect/landmark/weapon_spawn/tier5_weapon_spawn,
/turf/open/floor/industrial,
/area/deathmatch)
"Ht" = (
/turf/open/floor/wood,
/area/deathmatch)
"HM" = (
/obj/structure/stairs,
/obj/structure/desertdam/decals/loose_sand_overlay,
/turf/open/floor/plating/ground/dirt,
/area/deathmatch)
"HT" = (
/obj/effect/spawner/random/engineering/ore_box,
/turf/open/floor/tile,
/area/deathmatch)
"HY" = (
/obj/effect/decal/cleanable/rune,
/obj/item/explosive/plastique,
/turf/open/floor/plating/ground/dirt,
/area/deathmatch)
"Ii" = (
/obj/effect/landmark/deathmatch,
/turf/open/floor/plating/ground/dirt,
/area/deathmatch)
"IH" = (
/obj/structure/platform_decoration,
/turf/open/floor/plating/ground/dirt,
/area/deathmatch)
"Jg" = (
/obj/effect/landmark/weapon_spawn/tier3_weapon_spawn,
/obj/effect/landmark/deathmatch,
/turf/open/floor/plating/ground/dirt,
/area/deathmatch)
"Ji" = (
/obj/structure/platform,
/turf/open/floor/tile,
/area/deathmatch)
"Jv" = (
/obj/structure/cargo_container/ch_red,
/turf/open/floor/plating/ground/dirt,
/area/deathmatch)
"Jy" = (
/obj/structure/largecrate/random/barrel/yellow,
/turf/open/floor/tile,
/area/deathmatch)
"JF" = (
/obj/effect/landmark/weapon_spawn/tier5_weapon_spawn,
/turf/open/floor/tile,
/area/deathmatch)
"JS" = (
/obj/structure/platform{
	dir = 4
	},
/turf/open/floor/tile/dark,
/area/deathmatch)
"Lu" = (
/obj/structure/largecrate/random,
/obj/structure/platform{
	dir = 4
	},
/turf/open/floor/tile,
/area/deathmatch)
"LF" = (
/obj/structure/largecrate/random/barrel/yellow,
/turf/open/floor/plating/ground/dirt,
/area/deathmatch)
"Mo" = (
/obj/effect/spawner/random/engineering/ore_box,
/obj/structure/platform{
	dir = 4
	},
/turf/open/floor/plating/ground/dirt,
/area/deathmatch)
"MP" = (
/turf/closed/mineral/smooth/desertdamrockwall/indestructible,
/area/deathmatch)
"Ng" = (
/obj/vehicle/train/cargo/engine,
/turf/open/floor/plating/ground/dirt,
/area/deathmatch)
"Nh" = (
/obj/structure/desertdam/decals/loose_sand_overlay,
/turf/open/floor/tile/dark,
/area/deathmatch)
"NA" = (
/obj/effect/landmark/weapon_spawn/tier3_weapon_spawn,
/obj/effect/landmark/eord_roomba,
/turf/open/floor/plating/ground/dirt,
/area/deathmatch)
"Oi" = (
/obj/effect/decal/cleanable/rune,
/obj/item/explosive/plastique,
/turf/open/floor/tile,
/area/deathmatch)
"OP" = (
/obj/structure/largecrate/random,
/turf/open/floor/plating/ground/dirt,
/area/deathmatch)
"Pf" = (
/obj/effect/landmark/weapon_spawn/tier5_weapon_spawn,
/turf/open/floor/plating/ground/dirt,
/area/deathmatch)
"Pr" = (
/turf/open/floor/tile/yellow/full,
/area/deathmatch)
"PV" = (
/obj/effect/landmark/weapon_spawn/tier5_weapon_spawn,
/turf/open/floor/tile/yellow/full,
/area/deathmatch)
"Qj" = (
/obj/structure/stairs{
	dir = 8
	},
/turf/open/floor/industrial,
/area/deathmatch)
"QP" = (
/obj/structure/inflatable/wall,
/turf/open/floor/plating/ground/dirt,
/area/deathmatch)
"Sh" = (
/obj/vehicle/train/cargo/engine{
	dir = 1
	},
/turf/open/floor/plating/ground/dirt,
/area/deathmatch)
"Si" = (
/obj/effect/landmark/weapon_spawn/tier1_weapon_spawn,
/turf/open/floor/plating/ground/dirt,
/area/deathmatch)
"So" = (
/obj/structure/largecrate/random,
/turf/open/floor/tile/dark,
/area/deathmatch)
"Sp" = (
/obj/structure/desertdam/decals/loose_sand_overlay/alt,
/turf/open/floor/tile,
/area/deathmatch)
"Ss" = (
/obj/structure/cargo_container/horizontal{
	dir = 1
	},
/turf/open/floor/industrial,
/area/deathmatch)
"SF" = (
/obj/machinery/door/airlock/mainship/generic{
	dir = 2
	},
/turf/open/floor/tile/yellow/full,
/area/deathmatch)
"SO" = (
/obj/structure/largecrate/random,
/turf/open/floor/tile,
/area/deathmatch)
"SU" = (
/obj/structure/cargo_container{
	dir = 1
	},
/turf/open/floor/plating/ground/dirt,
/area/deathmatch)
"TF" = (
/obj/structure/window/framed/wood,
/turf/open/floor/wood,
/area/deathmatch)
"Ua" = (
/turf/open/floor/industrial,
/area/deathmatch)
"Uq" = (
/obj/effect/landmark/weapon_spawn/tier2_weapon_spawn,
/obj/effect/landmark/deathmatch,
/turf/open/floor/plating/ground/dirt,
/area/deathmatch)
"Uy" = (
/obj/machinery/door/window/right,
/turf/open/floor/wood,
/area/deathmatch)
"XI" = (
/obj/structure/cargo_container/horizontal{
	dir = 4
	},
/turf/open/floor/industrial,
/area/deathmatch)
"XP" = (
/obj/structure/platform_decoration{
	dir = 5
	},
/turf/open/floor/plating/ground/dirt,
/area/deathmatch)
"Yh" = (
/obj/structure/desertdam/decals/loose_sand_overlay/alt,
/turf/open/floor/tile/yellow/full,
/area/deathmatch)
"Yj" = (
/obj/effect/landmark/weapon_spawn/tier4_weapon_spawn,
/turf/open/floor/industrial,
/area/deathmatch)
"Yu" = (
/obj/effect/ai_node,
/obj/structure/platform{
	dir = 8
	},
/turf/open/floor/tile,
/area/deathmatch)
"YD" = (
/turf/closed/wall/desert,
/area/deathmatch)
"YX" = (
/obj/structure/largecrate/random/barrel/yellow,
/obj/structure/platform,
/turf/open/floor/tile,
/area/deathmatch)
"Ze" = (
/obj/effect/spawner/random/engineering/ore_box,
/turf/open/floor/plating/ground/dirt,
/area/deathmatch)
"Zp" = (
/obj/structure/largecrate/guns/merc,
/turf/open/floor/tile,
/area/deathmatch)
"Zr" = (
/obj/effect/landmark/weapon_spawn/tier1_weapon_spawn,
/obj/effect/landmark/deathmatch,
/turf/open/floor/tile/dark,
/area/deathmatch)
"ZW" = (
/obj/effect/landmark/weapon_spawn/tier2_weapon_spawn,
/turf/open/floor/plating/ground/dirt,
/area/deathmatch)

(1,1,1) = {"
MP
MP
MP
MP
MP
MP
MP
MP
MP
MP
aa
aa
MP
MP
MP
aa
aa
aa
MP
MP
MP
aa
aa
aa
aa
aa
MP
MP
MP
MP
MP
MP
MP
MP
MP
MP
MP
MP
MP
MP
MP
aa
aa
aa
aa
MP
"}
(2,1,1) = {"
MP
YD
YD
YD
YD
YD
YD
YD
YD
YD
YD
px
FE
FE
FE
FE
FE
YD
ez
ez
ez
YD
Ss
XI
ch
YD
ez
ez
ez
ez
ez
ez
ez
ez
ez
ez
YD
YD
YD
YD
YD
YD
FE
FE
YD
MP
"}
(3,1,1) = {"
MP
YD
pI
pI
Jy
pI
pI
pI
AM
pI
tN
FE
FE
FE
eX
FE
FE
YD
YD
YD
YD
YD
Ua
Ua
Ua
YD
ez
YD
YD
YD
YD
YD
YD
YD
YD
YD
YD
FE
FE
FE
FE
FE
FE
FE
YD
MP
"}
(4,1,1) = {"
MP
YD
pI
pI
ak
pI
JF
pI
pI
pI
Sp
DS
hH
FE
hH
FE
FE
kz
Ua
Ua
Ua
Ua
nl
kE
Ua
YD
ez
YD
FE
FE
FE
FE
FE
FE
FE
FE
FE
FE
FE
FE
Si
FE
FE
FE
YD
aa
"}
(5,1,1) = {"
MP
YD
pI
pI
pI
pI
pI
pI
jk
pI
Ji
FE
FE
FE
FE
FE
Ii
Ua
Ua
yN
Ua
Ua
Ua
Ua
Ua
YD
ez
YD
FE
FE
FE
FE
FE
FE
eX
FE
FE
FE
FE
FE
FE
FE
Ii
FE
xg
aa
"}
(6,1,1) = {"
MP
YD
YD
YD
YD
YD
ze
ze
ze
ze
lI
FE
FE
ZW
FE
FE
FE
YD
YD
YD
YD
YD
Ua
if
Ua
YD
YD
YD
FE
FE
Ii
FE
FE
FE
FE
FE
FE
Ii
FE
FE
FE
FE
FE
FE
xg
aa
"}
(7,1,1) = {"
MP
ez
ez
ez
ez
YD
FE
FE
FE
lq
kP
kh
FE
FE
FE
FE
FE
FE
YD
ez
ez
YD
Ua
kE
Ua
Ua
md
FE
FE
FE
FE
FE
FE
FE
FE
hH
FE
FE
FE
FE
FE
FE
FE
qS
Ng
aa
"}
(8,1,1) = {"
MP
ez
ez
ez
ez
YD
FE
mE
FE
Si
FE
FE
FE
FE
Ii
FE
xg
FE
QP
YD
ez
YD
Ua
Yj
xQ
Ua
Ua
FE
FE
Si
FE
FE
FE
FE
FE
FE
FE
rA
uf
uf
uf
uf
uf
FE
FE
aa
"}
(9,1,1) = {"
MP
ez
ez
ez
ez
YD
FE
FE
HY
FE
FE
FE
FE
FE
FE
FE
xg
FE
YD
ez
ez
YD
Ua
Ua
Ua
YD
YD
YD
FE
FE
FE
FE
FE
ZW
FE
FE
FE
BV
FE
FE
Si
FE
eX
FE
FE
aa
"}
(10,1,1) = {"
MP
ez
ez
ez
ez
YD
FE
FE
OP
FE
FE
NA
FE
FE
QP
FE
Sh
YD
ez
ez
ez
YD
Ua
if
Ua
YD
ez
YD
FE
FE
FE
FE
FE
FE
mE
mE
FE
BV
bq
FE
FE
FE
ZW
FE
FE
aa
"}
(11,1,1) = {"
MP
ez
ez
ez
ez
ez
YD
OP
Ze
FE
FE
FE
FE
FE
YD
YD
YD
ez
ez
ez
ez
YD
Ua
Ua
Ua
YD
ez
YD
FE
FE
FE
Ii
FE
FE
FE
FE
FE
BV
FE
FE
FE
FE
FE
FE
FE
aa
"}
(12,1,1) = {"
MP
ez
ez
ez
ez
ez
ez
YD
YD
YD
YD
YD
hH
qZ
YD
ez
ez
ez
YD
YD
YD
YD
YD
Qj
Qj
YD
ez
YD
YD
YD
FE
FE
FE
FE
FE
YD
YD
mE
FE
FE
FE
Ii
FE
FE
YD
aa
"}
(13,1,1) = {"
MP
ez
ez
ez
ez
ez
ez
ez
FE
FE
FE
FE
FE
FE
YD
ez
ez
ez
YD
Ua
Ua
Ua
lK
if
Ua
YD
ez
ez
ez
ez
YD
YD
YD
YD
YD
YD
YD
YD
FE
DV
FE
FE
FE
hH
YD
aa
"}
(14,1,1) = {"
MP
ez
ez
ez
ez
ez
ez
ez
FE
ZW
FE
eX
FE
FE
YD
ez
ez
ez
YD
ia
Ua
Ua
lK
kE
Gm
YD
ez
ez
ez
ez
ez
ez
ez
ez
YD
YD
YD
YD
FE
FE
FE
FE
FE
FE
FE
aa
"}
(15,1,1) = {"
MP
ez
ez
ez
ez
ez
ez
ez
ez
FE
FE
FE
FE
QP
YD
ez
ez
ez
YD
Ua
de
Ua
YD
YD
YD
YD
ez
ez
ez
ez
ez
ez
ez
ez
ez
YD
YD
FE
FE
FE
xg
xg
FE
FE
FE
aa
"}
(16,1,1) = {"
MP
ez
ez
ez
ez
ez
ez
ez
ez
Jv
FE
FE
FE
QP
YD
ez
ez
ez
YD
Ua
Ua
kz
YD
ez
ez
ez
ez
ez
ez
ez
ez
ez
ez
ez
ez
ez
YD
YD
YD
YD
YD
YD
Jg
Uq
yY
aa
"}
(17,1,1) = {"
MP
ez
ez
ez
ez
ez
ez
ez
ez
xm
FE
FE
FE
FE
YD
ez
ez
ez
YD
Ua
if
nz
YD
ez
ez
ez
YD
YD
YD
YD
YD
YD
YD
YD
YD
ez
ez
ez
ez
ez
ez
YD
Jg
Uq
Uq
aa
"}
(18,1,1) = {"
MP
ez
ez
ez
ez
ez
ez
ez
ez
nT
FE
FE
FE
FE
YD
ez
ez
ez
YD
Ua
Ua
Ua
YD
ez
ez
YD
YD
YD
YD
FE
FE
FE
FE
FE
YD
ez
ez
ez
ez
ez
ez
YD
Uq
Uq
Uq
aa
"}
(19,1,1) = {"
MP
ez
ez
ez
ez
ez
ez
ez
ez
ez
FE
FE
FE
FE
YD
YD
YD
YD
YD
yN
DZ
DZ
YD
YD
YD
YD
FE
FE
FE
FE
FE
Ii
FE
FE
YD
ez
ez
ez
ez
ez
ez
YD
Jg
Uq
Uq
aa
"}
(20,1,1) = {"
MP
ez
ez
ez
ez
ez
ez
ez
ez
ez
FE
FE
Ii
FE
FE
FE
FE
FE
YD
FE
FE
FE
FE
FE
FE
FE
Ii
FE
FE
FE
FE
FE
FE
FE
YD
YD
YD
YD
YD
YD
YD
YD
Jg
Uq
yY
aa
"}
(21,1,1) = {"
MP
ez
ez
ez
ez
ez
ez
ez
ez
ez
xg
FE
hH
FE
FE
ZW
FE
FE
od
FE
FE
DV
FE
FE
FE
eX
FE
FE
Ii
FE
hH
FE
ZW
FE
FE
FE
FE
FE
FE
FE
hH
FE
BV
FE
FE
aa
"}
(22,1,1) = {"
MP
ez
ez
ez
ez
ez
ez
ez
ez
ez
xg
FE
DV
hH
FE
FE
FE
FE
Pf
hH
Ii
FE
FE
FE
Ii
FE
FE
FE
FE
LF
hH
FE
FE
FE
FE
FE
FE
FE
FE
FE
Si
FE
BV
nM
FE
aa
"}
(23,1,1) = {"
MP
ez
ez
ez
ez
ez
ez
ez
ez
ez
Sh
FE
FE
FE
FE
ZW
FE
FE
YD
FE
FE
mE
FE
FE
FE
bq
FE
FE
FE
FE
FE
FE
FE
yV
TF
TF
ry
jH
jH
yV
FE
FE
BV
DV
FE
aa
"}
(24,1,1) = {"
MP
ez
ez
ez
ez
ez
ez
YD
YD
YD
YD
YD
FE
FE
mE
YD
YD
YD
YD
pY
pY
Yu
pY
pY
pY
pY
pY
pY
xf
FE
hH
FE
FE
mC
Bg
Ht
Ht
Ht
Bg
eJ
FE
FE
BV
FE
FE
aa
"}
(25,1,1) = {"
MP
ez
ez
ez
ez
ez
ez
YD
Zr
Ba
DN
DN
Nh
xn
So
YD
YD
YD
YD
pI
qR
pI
pI
YD
YD
YD
YD
YD
YD
YD
Ii
FE
FE
mC
Ht
Ht
Ht
Ht
Ht
eJ
FE
FE
BV
FE
YD
aa
"}
(26,1,1) = {"
MP
ez
ez
ez
ez
ez
ez
YD
Ba
Ba
Zr
DN
xn
gY
cm
YD
YD
YD
YD
pI
pI
pI
YD
ez
ez
ez
ez
ez
ez
YD
FE
FE
FE
mC
Ht
Ht
Bt
Ht
Ht
eJ
FE
wG
FE
FE
YD
aa
"}
(27,1,1) = {"
MP
ez
ez
ez
ez
ez
ez
YD
Ba
Zr
Ba
Ba
xn
eB
xn
YD
YD
YD
YD
pI
pI
AM
YD
ez
ez
ez
ez
ez
ez
YD
FE
FE
FE
mC
Ht
Ht
Ht
Ht
Ht
eJ
FE
FE
ZW
FE
YD
aa
"}
(28,1,1) = {"
MP
ez
ez
ez
ez
ez
YD
YD
YD
YD
YD
YD
JS
Nh
vG
YD
YD
YD
YD
ri
pI
pI
YD
ez
ez
ez
ez
ez
ez
YD
FE
FE
FE
mC
Bg
Ht
Ht
Ht
Bg
eJ
FE
eX
FE
FE
YD
aa
"}
(29,1,1) = {"
MP
ez
ez
ez
ez
ez
YD
Jy
pI
pI
pI
pI
pI
pI
pI
pI
pI
pI
pI
pI
pI
ak
YD
ez
ez
ez
ez
ez
ez
YD
hH
Ii
FE
yV
mC
mC
Uy
eJ
eJ
yV
nM
FE
FE
hH
YD
aa
"}
(30,1,1) = {"
MP
ez
ez
ez
ez
ez
YD
Jy
pI
ak
pI
pI
AM
ak
pI
pI
qR
pI
pI
pI
ak
Zp
YD
ez
ez
ez
ez
ez
ez
YD
FE
FE
FE
Si
FE
FE
FE
FE
ZW
FE
FE
FE
FE
FE
YD
aa
"}
(31,1,1) = {"
MP
ez
ez
ez
ez
ez
YD
pI
pI
pI
pI
ze
ze
pI
ze
Zp
pI
pI
pI
pI
HT
SO
YD
YD
YD
YD
YD
YD
YD
YD
YD
YD
FE
FE
FE
FE
FE
FE
FE
FE
FE
YD
YD
YD
YD
aa
"}
(32,1,1) = {"
MP
ez
ez
ez
ez
ez
YD
pI
pI
AM
Ji
XP
FE
FE
FE
YD
YD
YD
YD
YD
YD
YD
YD
YD
FE
FE
FE
hH
Pr
Yh
xb
SF
FE
hH
DV
Ii
FE
FE
hH
FE
YD
YD
ez
ez
ez
MP
"}
(33,1,1) = {"
MP
ez
ez
ez
ez
ez
YD
pI
Jy
pI
Ji
FE
aL
FE
FE
YD
ez
ez
ez
ez
ez
ez
YD
FE
wI
FE
FE
FE
SF
PV
Pr
ir
FE
FE
FE
FE
FE
FE
bq
FE
YD
ez
ez
ez
ez
MP
"}
(34,1,1) = {"
MP
ez
ez
ez
ez
ez
YD
pI
pI
pI
Ji
FE
wz
FE
FE
YD
ez
ez
ez
ez
ez
YD
YD
FE
SU
FE
ZW
FE
SF
gC
Pr
SF
FE
FE
FE
xg
xg
Sh
FE
FE
YD
ez
ez
ez
ez
MP
"}
(35,1,1) = {"
MP
ez
ez
ez
ez
ez
YD
gA
qR
pI
Ji
FE
nE
eX
FE
YD
ez
ez
ez
ez
ez
YD
YD
FE
pN
FE
FE
FE
YD
YD
YD
YD
YD
YD
YD
YD
YD
YD
YD
YD
YD
ez
ez
ez
ez
MP
"}
(36,1,1) = {"
MP
ez
ez
ez
ez
ez
YD
pI
pI
ht
YX
FE
FE
FE
FE
YD
ez
ez
ez
ez
ez
ez
YD
QP
FE
FE
FE
hH
YD
YD
YD
YD
YD
YD
ez
ez
ez
ez
ez
ez
ez
ez
ez
ez
ez
MP
"}
(37,1,1) = {"
MP
ez
ez
YD
YD
YD
YD
pI
pI
ak
Ji
FE
FE
FE
FE
YD
ez
ez
ez
ez
ez
ez
YD
FE
FE
FE
Ii
FE
FE
FE
FE
FE
LF
YD
ez
ez
ez
ez
ez
ez
ez
ez
ez
ez
ez
MP
"}
(38,1,1) = {"
MP
ez
ez
YD
FE
hH
BI
pI
ak
gA
SO
hD
FE
FE
Ii
YD
ez
ez
ez
ez
ez
ez
YD
FE
FE
FE
FE
FE
FE
ZW
FE
FE
FE
YD
ez
ez
ez
ez
ez
ez
ez
ez
ez
ez
ez
MP
"}
(39,1,1) = {"
MP
ez
ez
YD
FE
FE
BI
Sp
AM
pI
Oi
Ji
FE
FE
FE
YD
YD
YD
YD
YD
YD
YD
YD
Ii
FE
FE
eX
FE
FE
FE
FE
Si
OP
YD
ez
ez
ez
ez
ez
ez
ez
ez
ez
ez
ez
MP
"}
(40,1,1) = {"
MP
ez
ez
YD
FE
Ii
HM
ze
ze
Lu
ze
lI
FE
FE
FE
FE
FE
FE
FE
FE
FE
FE
FE
FE
FE
FE
FE
FE
zg
zg
zg
zg
Mo
YD
YD
YD
YD
ez
ez
ez
ez
ez
ez
ez
ez
MP
"}
(41,1,1) = {"
MP
ez
ez
YD
FE
FE
wG
LF
FE
FE
FE
Ze
FE
FE
ZW
FE
FE
FE
bq
FE
Si
FE
FE
FE
FE
FE
FE
wG
FE
FE
FE
FE
FE
iE
FE
OP
YD
ez
ez
ez
ez
ez
ez
ez
ez
MP
"}
(42,1,1) = {"
MP
ez
ez
YD
FE
FE
FE
Si
FE
FE
Ii
FE
FE
FE
FE
FE
FE
FE
FE
FE
FE
FE
FE
FE
FE
Ii
FE
FE
FE
FE
FE
FE
Ii
FE
FE
Ze
YD
ez
ez
ez
ez
ez
ez
ez
ez
MP
"}
(43,1,1) = {"
MP
ez
ez
YD
FE
hO
FE
FE
FE
FE
FE
FE
FE
hH
FE
FE
FE
FE
FE
DV
FE
hH
FE
FE
FE
IH
FE
hH
FE
FE
FE
FE
px
ZW
OP
OP
YD
ez
ez
ez
ez
ez
ez
ez
ez
MP
"}
(44,1,1) = {"
MP
ez
ez
YD
YD
YD
YD
ZW
FE
YD
YD
YD
xg
xg
xg
xg
Ng
YD
YD
YD
YD
YD
YD
YD
YD
YD
pY
Sp
pY
Cc
pY
pY
YD
YD
YD
YD
YD
ez
ez
ez
ez
ez
ez
ez
ez
MP
"}
(45,1,1) = {"
MP
ez
ez
ez
ez
ez
YD
FE
FE
YD
YD
YD
FE
FE
FE
FE
FE
YD
ez
ez
ez
ez
ez
ez
ez
YD
pI
pI
AM
JF
pI
pI
YD
ez
ez
ez
ez
ez
ez
ez
ez
ez
ez
ez
ez
MP
"}
(46,1,1) = {"
MP
MP
MP
MP
MP
MP
MP
MP
MP
MP
MP
aa
aa
aa
aa
aa
aa
aa
MP
MP
MP
MP
MP
MP
MP
aa
aa
aa
aa
aa
aa
aa
aa
MP
MP
MP
MP
MP
MP
MP
MP
MP
MP
MP
MP
MP
"}
