//MAP CONVERTED BY dmm2tgm.py THIS HEADER COMMENT PREVENTS RECONVERSION, DO NOT REMOVE
"aa" = (
/turf/closed/wall/desert/invincible,
/area/deathmatch)
"ak" = (
/atom/movable/effect/ai_node,
/turf/open/floor/tile,
/area/deathmatch)
"aL" = (
/obj/structure/cargo_container/green,
/turf/open/floor/plating/ground/dirt,
/area/deathmatch)
"ch" = (
/obj/structure/cargo_container/horizontal,
/turf/open/floor/industrial,
/area/deathmatch)
"cm" = (
/obj/structure/desertdam/decals/loose_sand_overlay/alt,
/turf/open/floor/tile/dark,
/area/deathmatch)
"de" = (
/atom/movable/effect/landmark/weapon_spawn/tier3_weapon_spawn,
/turf/open/floor/industrial,
/area/deathmatch)
"ez" = (
/turf/closed/desertdamrockwall,
/area/deathmatch)
"eB" = (
/atom/movable/effect/landmark/deathmatch,
/turf/open/floor/tile/dark,
/area/deathmatch)
"eX" = (
/atom/movable/effect/landmark/weapon_spawn/tier4_weapon_spawn,
/turf/open/floor/plating/ground/dirt,
/area/deathmatch)
"gA" = (
/obj/structure/inflatable,
/turf/open/floor/tile,
/area/deathmatch)
"gC" = (
/obj/structure/largecrate/guns/merc,
/turf/open/floor/tile/yellow/full,
/area/deathmatch)
"ht" = (
/atom/movable/effect/landmark/weapon_spawn/tier4_weapon_spawn,
/turf/open/floor/tile,
/area/deathmatch)
"hH" = (
/atom/movable/effect/ai_node,
/turf/open/floor/plating/ground/dirt,
/area/deathmatch)
"hO" = (
/atom/movable/effect/landmark/weapon_spawn/tier3_weapon_spawn,
/atom/movable/effect/ai_node,
/turf/open/floor/plating/ground/dirt,
/area/deathmatch)
"ia" = (
/atom/movable/effect/landmark/deathmatch,
/atom/movable/effect/ai_node,
/atom/movable/effect/ai_node,
/turf/open/floor/industrial,
/area/deathmatch)
"if" = (
/atom/movable/effect/landmark/deathmatch,
/turf/open/floor/industrial,
/area/deathmatch)
"ir" = (
/obj/structure/desertdam/decals/loose_sand_overlay,
/turf/open/floor/tile/yellow/full,
/area/deathmatch)
"iE" = (
/obj/structure/platform_decoration{
	dir = 4
	},
/turf/open/floor/plating/ground/dirt,
/area/deathmatch)
"jk" = (
/atom/movable/effect/landmark/weapon_spawn/tier2_weapon_spawn,
/turf/open/floor/tile,
/area/deathmatch)
"kz" = (
/obj/structure/desertdam/decals/loose_sand_overlay/alt,
/turf/open/floor/industrial,
/area/deathmatch)
"kE" = (
/atom/movable/effect/ai_node,
/turf/open/floor/industrial,
/area/deathmatch)
"lK" = (
/obj/structure/stairs{
	dir = 1
	},
/turf/open/floor/industrial,
/area/deathmatch)
"md" = (
/obj/structure/desertdam/decals/loose_sand_overlay/alt,
/atom/movable/effect/ai_node,
/turf/open/floor/industrial,
/area/deathmatch)
"mE" = (
/obj/structure/largecrate/random/secure,
/turf/open/floor/plating/ground/dirt,
/area/deathmatch)
"nl" = (
/atom/movable/effect/landmark/weapon_spawn/tier2_weapon_spawn,
/turf/open/floor/industrial,
/area/deathmatch)
"nz" = (
/obj/structure/inflatable,
/turf/open/floor/industrial,
/area/deathmatch)
"nE" = (
/obj/structure/cargo_container/green{
	dir = 4
	},
/turf/open/floor/plating/ground/dirt,
/area/deathmatch)
"nM" = (
/atom/movable/effect/landmark/deathmatch,
/atom/movable/effect/ai_node,
/turf/open/floor/plating/ground/dirt,
/area/deathmatch)
"nT" = (
/obj/structure/cargo_container/ch_red{
	dir = 4
	},
/turf/open/floor/plating/ground/dirt,
/area/deathmatch)
"oi" = (
/obj/structure/platform{
	dir = 1
	},
/obj/structure/platform_decoration{
	dir = 5
	},
/obj/structure/platform{
	dir = 8
	},
/turf/open/floor/plating/ground/dirt,
/area/deathmatch)
"px" = (
/obj/structure/platform_decoration{
	dir = 8
	},
/turf/open/floor/plating/ground/dirt,
/area/deathmatch)
"pI" = (
/turf/open/floor/tile,
/area/deathmatch)
"pN" = (
/obj/structure/cargo_container{
	dir = 4
	},
/turf/open/floor/plating/ground/dirt,
/area/deathmatch)
"pY" = (
/obj/structure/platform{
	dir = 8
	},
/turf/open/floor/tile,
/area/deathmatch)
"qR" = (
/atom/movable/effect/landmark/weapon_spawn/tier1_weapon_spawn,
/turf/open/floor/tile,
/area/deathmatch)
"qS" = (
/obj/structure/platform_decoration{
	dir = 8
	},
/atom/movable/effect/ai_node,
/turf/open/floor/plating/ground/dirt,
/area/deathmatch)
"qZ" = (
/obj/machinery/door/airlock/sandstone,
/turf/open/floor/plating/ground/dirt,
/area/deathmatch)
"ri" = (
/atom/movable/effect/landmark/weapon_spawn/tier4_weapon_spawn,
/atom/movable/effect/landmark/deathmatch,
/turf/open/floor/tile,
/area/deathmatch)
"uf" = (
/obj/structure/platform{
	dir = 8
	},
/turf/open/floor/plating/ground/dirt,
/area/deathmatch)
"wz" = (
/obj/structure/cargo_container/green{
	dir = 1
	},
/turf/open/floor/plating/ground/dirt,
/area/deathmatch)
"wG" = (
/obj/structure/platform_decoration{
	dir = 1
	},
/turf/open/floor/plating/ground/dirt,
/area/deathmatch)
"wI" = (
/obj/structure/cargo_container,
/turf/open/floor/plating/ground/dirt,
/area/deathmatch)
"xg" = (
/obj/vehicle/train/cargo/trolley,
/turf/open/floor/plating/ground/dirt,
/area/deathmatch)
"xm" = (
/obj/structure/cargo_container/ch_red{
	dir = 1
	},
/turf/open/floor/plating/ground/dirt,
/area/deathmatch)
"xn" = (
/turf/open/floor/tile/dark,
/area/deathmatch)
"yN" = (
/obj/structure/desertdam/decals/loose_sand_overlay,
/turf/open/floor/industrial,
/area/deathmatch)
"yY" = (
/atom/movable/effect/landmark/weapon_spawn/tier1_weapon_spawn,
/atom/movable/effect/landmark/deathmatch,
/turf/open/floor/plating/ground/dirt,
/area/deathmatch)
"zg" = (
/obj/structure/platform{
	dir = 4
	},
/turf/open/floor/plating/ground/dirt,
/area/deathmatch)
"AM" = (
/atom/movable/effect/landmark/deathmatch,
/turf/open/floor/tile,
/area/deathmatch)
"Ba" = (
/atom/movable/effect/landmark/weapon_spawn/tier2_weapon_spawn,
/atom/movable/effect/landmark/deathmatch,
/turf/open/floor/tile/dark,
/area/deathmatch)
"BI" = (
/obj/structure/stairs{
	dir = 1
	},
/turf/open/floor/plating/ground/dirt,
/area/deathmatch)
"BV" = (
/obj/structure/platform{
	dir = 1
	},
/turf/open/floor/plating/ground/dirt,
/area/deathmatch)
"Cz" = (
/obj/structure/platform{
	dir = 8
	},
/obj/structure/cargo_container/horizontal{
	dir = 1
	},
/turf/open/floor/plating/ground/dirt,
/area/deathmatch)
"CS" = (
/obj/structure/ore_box,
/turf/open/floor/tile/dark,
/area/deathmatch)
"DN" = (
/atom/movable/effect/landmark/weapon_spawn/tier3_weapon_spawn,
/atom/movable/effect/landmark/deathmatch,
/turf/open/floor/tile/dark,
/area/deathmatch)
"DS" = (
/obj/structure/platform_decoration{
	dir = 8
	},
/obj/structure/platform_decoration{
	dir = 4
	},
/turf/open/floor/plating/ground/dirt,
/area/deathmatch)
"DV" = (
/atom/movable/effect/landmark/weapon_spawn/tier3_weapon_spawn,
/turf/open/floor/plating/ground/dirt,
/area/deathmatch)
"DZ" = (
/obj/machinery/door/airlock/sandstone,
/turf/open/floor/industrial,
/area/deathmatch)
"FE" = (
/turf/open/floor/plating/ground/dirt,
/area/deathmatch)
"Gm" = (
/atom/movable/effect/landmark/weapon_spawn/tier5_weapon_spawn,
/turf/open/floor/industrial,
/area/deathmatch)
"Hh" = (
/obj/structure/platform,
/turf/open/floor/plating/ground/dirt,
/area/deathmatch)
"HM" = (
/obj/structure/stairs{
	dir = 1
	},
/obj/structure/desertdam/decals/loose_sand_overlay,
/turf/open/floor/plating/ground/dirt,
/area/deathmatch)
"HT" = (
/obj/structure/ore_box,
/turf/open/floor/tile,
/area/deathmatch)
"HY" = (
/atom/movable/effect/decal/cleanable/rune,
/obj/item/explosive/plastique,
/turf/open/floor/plating/ground/dirt,
/area/deathmatch)
"Ic" = (
/obj/structure/platform{
	dir = 8
	},
/obj/structure/ore_box,
/turf/open/floor/plating/ground/dirt,
/area/deathmatch)
"Ii" = (
/atom/movable/effect/landmark/deathmatch,
/turf/open/floor/plating/ground/dirt,
/area/deathmatch)
"IH" = (
/obj/structure/platform_decoration,
/turf/open/floor/plating/ground/dirt,
/area/deathmatch)
"Jb" = (
/obj/structure/platform_decoration{
	dir = 4
	},
/obj/structure/cargo_container/horizontal,
/turf/open/floor/plating/ground/dirt,
/area/deathmatch)
"Jg" = (
/atom/movable/effect/landmark/weapon_spawn/tier3_weapon_spawn,
/atom/movable/effect/landmark/deathmatch,
/turf/open/floor/plating/ground/dirt,
/area/deathmatch)
"Jv" = (
/obj/structure/cargo_container/ch_red,
/turf/open/floor/plating/ground/dirt,
/area/deathmatch)
"Jy" = (
/obj/structure/largecrate/random/barrel/yellow,
/turf/open/floor/tile,
/area/deathmatch)
"JF" = (
/atom/movable/effect/landmark/weapon_spawn/tier5_weapon_spawn,
/turf/open/floor/tile,
/area/deathmatch)
"Lq" = (
/obj/structure/platform{
	dir = 8
	},
/obj/structure/largecrate/random/barrel/yellow,
/turf/open/floor/plating/ground/dirt,
/area/deathmatch)
"LF" = (
/obj/structure/largecrate/random/barrel/yellow,
/turf/open/floor/plating/ground/dirt,
/area/deathmatch)
"LJ" = (
/obj/structure/platform{
	dir = 4
	},
/obj/structure/largecrate/random/secure,
/turf/open/floor/plating/ground/dirt,
/area/deathmatch)
"Ng" = (
/obj/vehicle/train/cargo/engine,
/turf/open/floor/plating/ground/dirt,
/area/deathmatch)
"Nh" = (
/obj/structure/desertdam/decals/loose_sand_overlay,
/turf/open/floor/tile/dark,
/area/deathmatch)
"NI" = (
/obj/structure/desertdam/decals/loose_sand_overlay,
/turf/open/floor/tile,
/area/deathmatch)
"Oi" = (
/atom/movable/effect/decal/cleanable/rune,
/obj/item/explosive/plastique,
/turf/open/floor/tile,
/area/deathmatch)
"OP" = (
/obj/structure/largecrate/random,
/turf/open/floor/plating/ground/dirt,
/area/deathmatch)
"Pf" = (
/atom/movable/effect/landmark/weapon_spawn/tier5_weapon_spawn,
/turf/open/floor/plating/ground/dirt,
/area/deathmatch)
"Pr" = (
/turf/open/floor/tile/yellow/full,
/area/deathmatch)
"PV" = (
/atom/movable/effect/landmark/weapon_spawn/tier5_weapon_spawn,
/turf/open/floor/tile/yellow/full,
/area/deathmatch)
"Qj" = (
/obj/structure/stairs{
	dir = 4
	},
/turf/open/floor/industrial,
/area/deathmatch)
"QP" = (
/obj/structure/inflatable,
/turf/open/floor/plating/ground/dirt,
/area/deathmatch)
"Sh" = (
/obj/vehicle/train/cargo/engine{
	dir = 1
	},
/turf/open/floor/plating/ground/dirt,
/area/deathmatch)
"Si" = (
/atom/movable/effect/landmark/weapon_spawn/tier1_weapon_spawn,
/turf/open/floor/plating/ground/dirt,
/area/deathmatch)
"So" = (
/obj/structure/largecrate/random,
/turf/open/floor/tile/dark,
/area/deathmatch)
"Sp" = (
/obj/structure/desertdam/decals/loose_sand_overlay/alt,
/turf/open/floor/tile,
/area/deathmatch)
"Ss" = (
/obj/structure/cargo_container/horizontal{
	dir = 1
	},
/turf/open/floor/industrial,
/area/deathmatch)
"SF" = (
/obj/machinery/door/airlock/sandstone,
/turf/open/floor/tile/yellow/full,
/area/deathmatch)
"SO" = (
/obj/structure/largecrate/random,
/turf/open/floor/tile,
/area/deathmatch)
"SU" = (
/obj/structure/cargo_container{
	dir = 1
	},
/turf/open/floor/plating/ground/dirt,
/area/deathmatch)
"Ua" = (
/turf/open/floor/industrial,
/area/deathmatch)
"Uq" = (
/atom/movable/effect/landmark/weapon_spawn/tier2_weapon_spawn,
/atom/movable/effect/landmark/deathmatch,
/turf/open/floor/plating/ground/dirt,
/area/deathmatch)
"WT" = (
/obj/structure/platform{
	dir = 8
	},
/obj/structure/cargo_container/horizontal{
	dir = 4
	},
/turf/open/floor/plating/ground/dirt,
/area/deathmatch)
"XI" = (
/obj/structure/cargo_container/horizontal{
	dir = 4
	},
/turf/open/floor/industrial,
/area/deathmatch)
"Yh" = (
/obj/structure/desertdam/decals/loose_sand_overlay/alt,
/turf/open/floor/tile/yellow/full,
/area/deathmatch)
"Yj" = (
/atom/movable/effect/landmark/weapon_spawn/tier4_weapon_spawn,
/turf/open/floor/industrial,
/area/deathmatch)
"YD" = (
/turf/closed/wall/desert,
/area/deathmatch)
"Ze" = (
/obj/structure/ore_box,
/turf/open/floor/plating/ground/dirt,
/area/deathmatch)
"Zp" = (
/obj/structure/largecrate/guns/merc,
/turf/open/floor/tile,
/area/deathmatch)
"Zr" = (
/atom/movable/effect/landmark/weapon_spawn/tier1_weapon_spawn,
/atom/movable/effect/landmark/deathmatch,
/turf/open/floor/tile/dark,
/area/deathmatch)
"ZW" = (
/atom/movable/effect/landmark/weapon_spawn/tier2_weapon_spawn,
/turf/open/floor/plating/ground/dirt,
/area/deathmatch)

(1,1,1) = {"
ez
ez
ez
ez
ez
ez
ez
ez
ez
ez
aa
aa
ez
ez
ez
aa
aa
aa
ez
ez
ez
aa
aa
aa
aa
aa
ez
ez
ez
ez
ez
ez
ez
ez
ez
ez
ez
ez
ez
ez
ez
aa
aa
aa
aa
ez
"}
(2,1,1) = {"
ez
YD
YD
YD
YD
YD
YD
YD
YD
YD
YD
px
FE
FE
FE
FE
FE
YD
ez
ez
ez
YD
Ss
XI
ch
YD
ez
ez
ez
ez
ez
ez
ez
ez
ez
ez
YD
YD
YD
YD
YD
YD
FE
FE
YD
ez
"}
(3,1,1) = {"
ez
YD
pI
pI
Jy
pI
pI
pI
AM
pI
Zp
BV
FE
FE
eX
FE
FE
YD
YD
YD
YD
YD
Ua
Ua
Ua
YD
ez
YD
YD
YD
YD
YD
YD
YD
YD
YD
YD
FE
FE
FE
FE
FE
FE
FE
YD
ez
"}
(4,1,1) = {"
ez
YD
pI
pI
ak
pI
JF
pI
pI
pI
Sp
DS
hH
FE
hH
FE
FE
kz
Ua
Ua
Ua
Ua
nl
kE
Ua
YD
ez
YD
FE
FE
FE
FE
FE
FE
FE
FE
FE
FE
FE
FE
Si
FE
FE
FE
YD
aa
"}
(5,1,1) = {"
ez
YD
pI
pI
pI
pI
pI
pI
jk
pI
pI
BV
FE
FE
FE
FE
Ii
Ua
Ua
yN
Ua
Ua
Ua
Ua
Ua
YD
ez
YD
FE
FE
FE
FE
FE
FE
eX
FE
FE
FE
FE
FE
FE
FE
Ii
FE
xg
aa
"}
(6,1,1) = {"
ez
YD
YD
YD
YD
YD
pI
pI
pI
pI
pI
BV
FE
ZW
FE
FE
FE
YD
YD
YD
YD
YD
Ua
if
Ua
YD
YD
YD
FE
FE
Ii
FE
FE
FE
FE
FE
FE
Ii
FE
FE
FE
FE
FE
FE
xg
aa
"}
(7,1,1) = {"
ez
ez
ez
ez
ez
YD
uf
uf
uf
Cz
WT
Jb
FE
FE
FE
FE
FE
FE
YD
ez
ez
YD
Ua
kE
Ua
Ua
md
FE
FE
FE
FE
FE
FE
FE
FE
hH
IH
zg
zg
zg
zg
zg
zg
qS
Ng
aa
"}
(8,1,1) = {"
ez
ez
ez
ez
ez
YD
FE
mE
FE
Si
FE
FE
FE
FE
Ii
FE
xg
FE
QP
YD
ez
YD
Ua
Yj
yN
Ua
Ua
FE
FE
Si
FE
FE
FE
FE
FE
FE
Hh
Ze
FE
FE
FE
FE
FE
FE
FE
aa
"}
(9,1,1) = {"
ez
ez
ez
ez
ez
YD
FE
FE
HY
FE
FE
FE
FE
FE
FE
FE
xg
FE
YD
ez
ez
YD
Ua
Ua
Ua
YD
YD
YD
FE
FE
FE
FE
FE
ZW
FE
FE
Hh
FE
FE
FE
Si
FE
eX
FE
FE
aa
"}
(10,1,1) = {"
ez
ez
ez
ez
ez
YD
FE
FE
OP
FE
FE
DV
FE
FE
QP
FE
Sh
YD
ez
ez
ez
YD
Ua
if
Ua
YD
ez
YD
FE
FE
FE
FE
FE
FE
mE
mE
Hh
FE
FE
FE
FE
FE
ZW
FE
FE
aa
"}
(11,1,1) = {"
ez
ez
ez
ez
ez
ez
YD
OP
Ze
FE
FE
FE
FE
FE
YD
YD
YD
ez
ez
ez
ez
YD
Ua
Ua
Ua
YD
ez
YD
FE
FE
FE
Ii
FE
FE
FE
FE
Hh
FE
FE
FE
FE
FE
FE
FE
FE
aa
"}
(12,1,1) = {"
ez
ez
ez
ez
ez
ez
ez
YD
YD
YD
YD
YD
hH
qZ
YD
ez
ez
ez
YD
YD
YD
YD
YD
Qj
Qj
YD
ez
YD
YD
YD
FE
FE
FE
FE
FE
YD
YD
mE
FE
FE
FE
Ii
FE
FE
YD
aa
"}
(13,1,1) = {"
ez
ez
ez
ez
ez
ez
ez
ez
FE
FE
FE
FE
FE
FE
YD
ez
ez
ez
YD
Ua
Ua
Ua
lK
if
Ua
YD
ez
ez
ez
ez
YD
YD
YD
YD
YD
YD
YD
YD
FE
DV
FE
FE
FE
hH
YD
aa
"}
(14,1,1) = {"
ez
ez
ez
ez
ez
ez
ez
ez
FE
ZW
FE
eX
FE
FE
YD
ez
ez
ez
YD
ia
Ua
Ua
lK
kE
Gm
YD
ez
ez
ez
ez
ez
ez
ez
ez
YD
YD
YD
YD
FE
FE
FE
FE
FE
FE
FE
aa
"}
(15,1,1) = {"
ez
ez
ez
ez
ez
ez
ez
ez
ez
FE
FE
FE
FE
QP
YD
ez
ez
ez
YD
Ua
de
Ua
YD
YD
YD
YD
ez
ez
ez
ez
ez
ez
ez
ez
ez
YD
YD
FE
FE
FE
xg
xg
FE
FE
FE
aa
"}
(16,1,1) = {"
ez
ez
ez
ez
ez
ez
ez
ez
ez
Jv
FE
FE
FE
QP
YD
ez
ez
ez
YD
Ua
Ua
kz
YD
ez
ez
ez
ez
ez
ez
ez
ez
ez
ez
ez
ez
ez
YD
YD
YD
YD
YD
YD
Jg
Uq
yY
aa
"}
(17,1,1) = {"
ez
ez
ez
ez
ez
ez
ez
ez
ez
xm
FE
FE
FE
FE
YD
ez
ez
ez
YD
Ua
if
nz
YD
ez
ez
ez
YD
YD
YD
YD
YD
YD
YD
YD
YD
ez
ez
ez
ez
ez
ez
YD
Jg
Uq
Uq
aa
"}
(18,1,1) = {"
ez
ez
ez
ez
ez
ez
ez
ez
ez
nT
FE
FE
FE
FE
YD
ez
ez
ez
YD
Ua
Ua
Ua
YD
ez
ez
YD
YD
YD
YD
FE
FE
FE
FE
FE
YD
ez
ez
ez
ez
ez
ez
YD
Uq
Uq
Uq
aa
"}
(19,1,1) = {"
ez
ez
ez
ez
ez
ez
ez
ez
ez
ez
FE
FE
FE
FE
YD
YD
YD
YD
YD
yN
DZ
DZ
YD
YD
YD
YD
FE
FE
FE
FE
FE
Ii
FE
FE
YD
ez
ez
ez
ez
ez
ez
YD
Jg
Uq
Uq
aa
"}
(20,1,1) = {"
ez
ez
ez
ez
ez
ez
ez
ez
ez
ez
FE
FE
Ii
FE
FE
FE
FE
FE
YD
FE
FE
FE
FE
FE
FE
FE
Ii
FE
FE
FE
FE
FE
FE
FE
YD
YD
YD
YD
YD
YD
YD
YD
Jg
Uq
yY
aa
"}
(21,1,1) = {"
ez
ez
ez
ez
ez
ez
ez
ez
ez
ez
xg
FE
hH
FE
FE
ZW
FE
FE
qZ
FE
FE
DV
FE
FE
FE
eX
FE
FE
Ii
FE
hH
FE
ZW
FE
FE
FE
FE
FE
FE
FE
hH
Hh
FE
FE
FE
aa
"}
(22,1,1) = {"
ez
ez
ez
ez
ez
ez
ez
ez
ez
ez
xg
FE
DV
hH
FE
FE
FE
FE
Pf
hH
Ii
FE
FE
FE
Ii
FE
FE
FE
FE
LF
hH
FE
FE
YD
YD
YD
YD
ez
ez
FE
Si
Hh
FE
nM
FE
aa
"}
(23,1,1) = {"
ez
ez
ez
ez
ez
ez
ez
ez
ez
ez
Sh
FE
FE
FE
FE
ZW
FE
FE
YD
zg
zg
LJ
zg
zg
zg
zg
zg
zg
zg
FE
FE
FE
YD
YD
YD
YD
YD
YD
ez
ez
FE
Hh
FE
DV
FE
aa
"}
(24,1,1) = {"
ez
ez
ez
ez
ez
ez
ez
YD
YD
YD
YD
YD
FE
FE
mE
YD
YD
YD
YD
pI
pI
ak
pI
pI
pI
pI
pI
pI
Sp
FE
hH
FE
YD
YD
YD
YD
YD
YD
ez
ez
FE
Hh
FE
FE
FE
aa
"}
(25,1,1) = {"
ez
ez
ez
ez
ez
ez
ez
YD
Zr
Ba
DN
DN
Nh
xn
So
YD
YD
YD
YD
pI
qR
pI
pI
YD
YD
YD
YD
YD
YD
YD
Ii
FE
YD
YD
YD
YD
YD
YD
ez
ez
FE
Hh
FE
FE
YD
aa
"}
(26,1,1) = {"
ez
ez
ez
ez
ez
ez
ez
YD
Ba
Ba
Zr
DN
xn
xn
cm
YD
YD
YD
YD
pI
pI
pI
YD
ez
ez
ez
ez
ez
ez
YD
FE
FE
YD
YD
YD
YD
YD
YD
ez
ez
FE
wG
FE
FE
YD
aa
"}
(27,1,1) = {"
ez
ez
ez
ez
ez
ez
ez
YD
Ba
Zr
Ba
Ba
xn
eB
xn
YD
YD
YD
YD
pI
pI
AM
YD
ez
ez
ez
ez
ez
ez
YD
FE
FE
FE
YD
YD
YD
YD
ez
ez
FE
FE
FE
ZW
FE
YD
aa
"}
(28,1,1) = {"
ez
ez
ez
ez
ez
ez
YD
YD
YD
YD
YD
YD
xn
Nh
CS
YD
YD
YD
YD
ri
pI
pI
YD
ez
ez
ez
ez
ez
ez
YD
FE
FE
FE
FE
FE
Sh
xg
xg
FE
FE
FE
eX
FE
FE
YD
aa
"}
(29,1,1) = {"
ez
ez
ez
ez
ez
ez
YD
Jy
pI
pI
pI
pI
pY
pI
pY
pI
pI
pI
pI
pI
pI
ak
YD
ez
ez
ez
ez
ez
ez
YD
hH
Ii
FE
hH
FE
FE
FE
FE
hH
FE
nM
FE
FE
hH
YD
aa
"}
(30,1,1) = {"
ez
ez
ez
ez
ez
ez
YD
Jy
pI
ak
pI
pI
AM
ak
pI
pI
qR
pI
pI
pI
ak
Zp
YD
ez
ez
ez
ez
ez
ez
YD
FE
FE
FE
Si
FE
FE
FE
FE
ZW
FE
FE
FE
FE
FE
YD
aa
"}
(31,1,1) = {"
ez
ez
ez
ez
ez
ez
YD
pI
pI
pI
pI
pI
pI
pI
pI
Zp
pI
pI
pI
pI
HT
SO
YD
YD
YD
YD
YD
YD
YD
YD
YD
YD
FE
FE
FE
FE
FE
FE
FE
LF
YD
YD
YD
YD
YD
aa
"}
(32,1,1) = {"
ez
ez
ez
ez
ez
ez
YD
pI
pI
AM
pI
oi
uf
FE
uf
YD
YD
YD
YD
YD
YD
YD
YD
YD
FE
FE
FE
hH
Pr
Yh
Pr
SF
FE
hH
DV
Ii
FE
FE
hH
FE
YD
ez
ez
ez
ez
ez
"}
(33,1,1) = {"
ez
ez
ez
ez
ez
ez
YD
pI
Jy
pI
pI
BV
aL
FE
FE
YD
ez
ez
ez
ez
ez
ez
YD
FE
wI
FE
FE
FE
SF
PV
Pr
ir
FE
FE
FE
FE
FE
FE
FE
FE
YD
ez
ez
ez
ez
ez
"}
(34,1,1) = {"
ez
ez
ez
ez
ez
ez
YD
pI
pI
pI
pI
BV
wz
FE
FE
YD
ez
ez
ez
ez
ez
YD
YD
FE
SU
FE
ZW
FE
SF
gC
Pr
SF
FE
FE
FE
xg
xg
Sh
FE
FE
YD
ez
ez
ez
ez
ez
"}
(35,1,1) = {"
ez
ez
ez
ez
ez
ez
YD
gA
qR
pI
pI
BV
nE
eX
FE
YD
ez
ez
ez
ez
ez
YD
YD
FE
pN
FE
FE
FE
YD
YD
YD
YD
YD
YD
YD
YD
YD
YD
YD
YD
YD
ez
ez
ez
ez
ez
"}
(36,1,1) = {"
ez
ez
ez
ez
ez
ez
YD
pI
pI
ht
Jy
BV
FE
FE
FE
YD
ez
ez
ez
ez
ez
ez
YD
QP
FE
FE
FE
hH
YD
YD
YD
YD
YD
YD
ez
ez
ez
ez
ez
ez
ez
ez
ez
ez
ez
ez
"}
(37,1,1) = {"
ez
ez
ez
YD
YD
YD
YD
pI
pI
ak
pI
BV
FE
FE
FE
YD
ez
ez
ez
ez
ez
ez
YD
FE
FE
FE
Ii
FE
FE
FE
FE
FE
LF
YD
ez
ez
ez
ez
ez
ez
ez
ez
ez
ez
ez
ez
"}
(38,1,1) = {"
ez
ez
ez
YD
FE
hH
BI
pI
ak
gA
SO
pY
BV
FE
Ii
YD
ez
ez
ez
ez
ez
ez
YD
FE
FE
FE
FE
FE
FE
ZW
FE
FE
FE
YD
ez
ez
ez
ez
ez
ez
ez
ez
ez
ez
ez
ez
"}
(39,1,1) = {"
ez
ez
ez
YD
FE
FE
BI
Sp
AM
pI
Oi
pI
BV
FE
FE
YD
YD
YD
YD
YD
YD
YD
YD
Ii
FE
FE
eX
FE
FE
FE
FE
Si
OP
YD
ez
ez
ez
ez
ez
ez
ez
ez
ez
ez
ez
ez
"}
(40,1,1) = {"
ez
ez
ez
YD
FE
Ii
HM
pI
pI
SO
pI
pI
BV
FE
FE
FE
FE
FE
FE
FE
FE
FE
FE
FE
FE
FE
FE
FE
FE
FE
FE
FE
Ze
YD
YD
YD
YD
ez
ez
ez
ez
ez
ez
ez
ez
ez
"}
(41,1,1) = {"
ez
ez
ez
YD
FE
FE
wG
Lq
uf
uf
uf
Ic
iE
FE
ZW
FE
FE
FE
FE
FE
Si
FE
FE
FE
FE
FE
FE
wG
uf
uf
uf
uf
uf
iE
FE
OP
YD
ez
ez
ez
ez
ez
ez
ez
ez
ez
"}
(42,1,1) = {"
ez
ez
ez
YD
FE
FE
FE
Si
FE
FE
Ii
FE
FE
FE
FE
FE
FE
FE
FE
FE
FE
FE
FE
FE
FE
Ii
FE
FE
FE
FE
FE
FE
Ii
FE
FE
Ze
YD
ez
ez
ez
ez
ez
ez
ez
ez
ez
"}
(43,1,1) = {"
ez
ez
ez
YD
FE
hO
FE
FE
FE
FE
FE
FE
FE
hH
FE
FE
FE
FE
FE
DV
FE
hH
FE
FE
FE
IH
zg
hH
zg
zg
zg
zg
px
ZW
OP
OP
YD
ez
ez
ez
ez
ez
ez
ez
ez
ez
"}
(44,1,1) = {"
ez
ez
ez
YD
YD
YD
YD
ZW
FE
YD
YD
YD
xg
xg
xg
xg
Ng
YD
YD
YD
YD
YD
YD
YD
YD
YD
pI
Sp
pI
NI
pI
pI
YD
YD
YD
YD
YD
ez
ez
ez
ez
ez
ez
ez
ez
ez
"}
(45,1,1) = {"
ez
ez
ez
ez
ez
ez
YD
FE
FE
YD
YD
YD
FE
FE
FE
FE
FE
YD
ez
ez
ez
ez
ez
ez
ez
YD
pI
pI
AM
JF
pI
pI
YD
ez
ez
ez
ez
ez
ez
ez
ez
ez
ez
ez
ez
ez
"}
(46,1,1) = {"
ez
ez
ez
ez
ez
ez
ez
ez
ez
ez
ez
aa
aa
aa
aa
aa
aa
aa
ez
ez
ez
ez
ez
ez
ez
aa
aa
aa
aa
aa
aa
aa
aa
ez
ez
ez
ez
ez
ez
ez
ez
ez
ez
ez
ez
ez
"}
