//MAP CONVERTED BY dmm2tgm.py THIS HEADER COMMENT PREVENTS RECONVERSION, DO NOT REMOVE
"ay" = (
/obj/effect/landmark/weapon_spawn/tier3_weapon_spawn,
/turf/open/floor/plating/asteroidfloor,
/area/deathmatch)
"bi" = (
/turf/open/floor/plating/ground/mars/random/dirt,
/area/deathmatch)
"db" = (
/obj/effect/landmark/weapon_spawn/tier2_weapon_spawn,
/turf/open/floor/plating/ground/mars/random/sand,
/area/deathmatch)
"dj" = (
/turf/open/floor/plating/ground/mars/random/sand,
/area/deathmatch)
"dl" = (
/obj/effect/decal/sandytile/sandyplating,
/turf/closed/wall,
/area/deathmatch)
"dB" = (
/obj/effect/landmark/deathmatch,
/turf/open/floor/plating/asteroidplating,
/area/deathmatch)
"dD" = (
/obj/effect/landmark/weapon_spawn/tier2_weapon_spawn,
/turf/open/floor/plating/ground/mars/dirttosand{
	dir = 1
	},
/area/deathmatch)
"dO" = (
/turf/open/floor/plating/asteroidplating{
	color = "#888888"
	},
/area/deathmatch)
"fF" = (
/obj/structure/rack,
/obj/effect/spawner/random/plushie{
	spawn_nothing_percentage = 95
	},
/turf/open/floor/plating/asteroidplating,
/area/deathmatch)
"hw" = (
/obj/effect/landmark/deathmatch,
/turf/open/floor/plating/ground/mars/random/dirt,
/area/deathmatch)
"ix" = (
/obj/structure/rack,
/obj/effect/landmark/weapon_spawn/tier3_weapon_spawn,
/turf/open/floor/plating/asteroidfloor,
/area/deathmatch)
"jb" = (
/turf/open/floor/stairs/rampbottom{
	color = "#888888";
	dir = 8
	},
/area/deathmatch)
"jc" = (
/obj/machinery/door/poddoor/railing{
	dir = 1
	},
/turf/open/floor/plating/asteroidwarning{
	dir = 1
	},
/area/deathmatch)
"jJ" = (
/obj/effect/landmark/weapon_spawn/tier2_weapon_spawn,
/turf/open/floor/plating/ground/mars/dirttosand{
	dir = 9
	},
/area/deathmatch)
"jM" = (
/obj/structure/ore_box,
/turf/open/floor/plating/ground/mars/dirttosand,
/area/deathmatch)
"jP" = (
/obj/machinery/door/poddoor/railing,
/turf/open/floor/plating/asteroidfloor,
/area/deathmatch)
"kh" = (
/obj/structure/cargo_container/nt,
/turf/open/floor/plating/asteroidplating,
/area/deathmatch)
"kR" = (
/obj/structure/prop/mainship/hangar_stencil/two,
/turf/open/floor/plating/asteroidplating,
/area/deathmatch)
"kU" = (
/obj/structure/cargo_container/nt,
/turf/open/floor/plating/ground/mars/random/sand,
/area/deathmatch)
"nt" = (
/obj/structure/ore_box,
/turf/open/floor/plating/ground/mars/dirttosand{
	dir = 8
	},
/area/deathmatch)
"nN" = (
/obj/structure/cargo_container/nt{
	dir = 4
	},
/turf/open/floor/plating/asteroidplating,
/area/deathmatch)
"od" = (
/turf/closed/wall,
/area/deathmatch)
"oD" = (
/obj/effect/decal/cleanable/rune,
/obj/item/explosive/plastique,
/turf/open/floor/plating/asteroidplating,
/area/deathmatch)
"oH" = (
/obj/structure/largecrate/random/barrel/yellow,
/turf/open/floor/plating/asteroidfloor,
/area/deathmatch)
"pV" = (
/obj/effect/landmark/weapon_spawn/tier2_weapon_spawn,
/turf/open/floor/plating/ground/mars/dirttosand,
/area/deathmatch)
"pX" = (
/obj/structure/largecrate,
/turf/open/floor/plating/ground/mars/random/sand,
/area/deathmatch)
"rv" = (
/obj/machinery/door/poddoor/railing,
/turf/open/floor/plating/asteroidplating,
/area/deathmatch)
"rF" = (
/turf/open/floor/stairs/rampbottom{
	dir = 8
	},
/area/deathmatch)
"sr" = (
/obj/effect/landmark/weapon_spawn/tier2_weapon_spawn,
/turf/open/floor/plating/ground/mars/random/dirt,
/area/deathmatch)
"sw" = (
/obj/structure/largecrate,
/turf/open/floor/plating/ground/mars/dirttosand{
	dir = 10
	},
/area/deathmatch)
"tf" = (
/obj/structure/largecrate,
/turf/open/floor/plating/asteroidplating,
/area/deathmatch)
"tF" = (
/obj/structure/rack,
/turf/open/floor/plating/asteroidplating,
/area/deathmatch)
"tH" = (
/obj/structure/cargo_container/nt{
	dir = 1
	},
/turf/open/floor/plating/asteroidplating,
/area/deathmatch)
"tZ" = (
/obj/structure/rack,
/turf/open/floor/plating/asteroidfloor,
/area/deathmatch)
"up" = (
/turf/open/floor/plating/ground/mars/dirttosand{
	dir = 10
	},
/area/deathmatch)
"vi" = (
/obj/effect/landmark/deathmatch,
/turf/open/floor/plating/ground/mars/dirttosand{
	dir = 6
	},
/area/deathmatch)
"vv" = (
/turf/open/floor/plating/ground/mars/dirttosand{
	dir = 9
	},
/area/deathmatch)
"vW" = (
/obj/structure/platform,
/turf/open/floor/plating/asteroidfloor,
/area/deathmatch)
"wl" = (
/obj/structure/cargo_container/ch_red{
	dir = 4
	},
/turf/open/floor/plating/ground/mars/random/sand,
/area/deathmatch)
"wH" = (
/obj/machinery/door/poddoor/railing{
	dir = 1
	},
/obj/effect/landmark/weapon_spawn/tier2_weapon_spawn,
/turf/open/floor/plating/asteroidwarning{
	dir = 1
	},
/area/deathmatch)
"wI" = (
/obj/effect/landmark/weapon_spawn/tier2_weapon_spawn,
/turf/open/floor/plating/asteroidplating,
/area/deathmatch)
"xu" = (
/obj/machinery/door/poddoor/railing{
	dir = 1
	},
/turf/open/floor/stairs/rampbottom{
	color = "#888888";
	dir = 8
	},
/area/deathmatch)
"zr" = (
/obj/structure/cargo_container{
	dir = 1
	},
/turf/open/floor/plating/ground/mars/random/dirt,
/area/deathmatch)
"zQ" = (
/obj/structure/ore_box,
/turf/open/floor/plating/ground/mars/random/dirt,
/area/deathmatch)
"Ab" = (
/obj/effect/landmark/weapon_spawn/tier2_weapon_spawn,
/turf/open/floor/plating/asteroidplating{
	color = "#888888"
	},
/area/deathmatch)
"Ax" = (
/obj/effect/landmark/weapon_spawn/tier3_weapon_spawn,
/turf/open/floor/plating/ground/mars/random/sand,
/area/deathmatch)
"AF" = (
/obj/structure/cargo_container/ch_red{
	dir = 1
	},
/turf/open/floor/plating/ground/mars/random/sand,
/area/deathmatch)
"AN" = (
/obj/structure/cargo_container/nt{
	dir = 4
	},
/turf/open/floor/plating/ground/mars/random/sand,
/area/deathmatch)
"De" = (
/obj/effect/landmark/weapon_spawn/tier2_weapon_spawn,
/turf/open/floor/stairs/rampbottom{
	dir = 4
	},
/area/deathmatch)
"Do" = (
/obj/effect/landmark/deathmatch,
/turf/open/floor/stairs/rampbottom{
	dir = 8
	},
/area/deathmatch)
"Fc" = (
/obj/structure/table/reinforced,
/turf/open/floor/plating/asteroidfloor,
/area/deathmatch)
"Fm" = (
/obj/effect/decal/cleanable/rune,
/turf/open/floor/plating/asteroidplating,
/area/deathmatch)
"Fp" = (
/turf/open/floor/plating/asteroidplating,
/area/deathmatch)
"Go" = (
/obj/effect/landmark/deathmatch,
/turf/open/floor/plating/ground/mars/random/sand,
/area/deathmatch)
"GJ" = (
/obj/machinery/door/poddoor/railing{
	dir = 8
	},
/turf/open/floor/plating/asteroidwarning{
	dir = 8
	},
/area/deathmatch)
"Ip" = (
/turf/open/floor/plating/ground/mars/dirttosand,
/area/deathmatch)
"Jf" = (
/turf/open/floor/plating/ground/mars/dirttosand{
	dir = 5
	},
/area/deathmatch)
"Jn" = (
/obj/structure/ore_box,
/turf/open/floor/plating/asteroidplating,
/area/deathmatch)
"JW" = (
/obj/machinery/door/poddoor/railing{
	dir = 8
	},
/obj/effect/landmark/weapon_spawn/tier3_weapon_spawn,
/turf/open/floor/plating/asteroidwarning{
	dir = 8
	},
/area/deathmatch)
"KZ" = (
/turf/open/floor/plating/ground/mars/dirttosand{
	dir = 4
	},
/area/deathmatch)
"Lv" = (
/obj/machinery/door/poddoor/railing{
	dir = 2
	},
/obj/machinery/door/poddoor/railing{
	dir = 8
	},
/turf/open/floor/plating/asteroidfloor,
/area/deathmatch)
"LA" = (
/obj/effect/landmark/weapon_spawn/tier2_weapon_spawn,
/turf/open/floor/stairs/rampbottom{
	dir = 8
	},
/area/deathmatch)
"LY" = (
/obj/effect/landmark/weapon_spawn/tier3_weapon_spawn,
/turf/open/floor/stairs/rampbottom{
	color = "#888888";
	dir = 8
	},
/area/deathmatch)
"Mn" = (
/turf/open/floor/plating/asteroidfloor,
/area/deathmatch)
"Mx" = (
/obj/structure/rack,
/turf/open/floor/plating/ground/mars/random/sand,
/area/deathmatch)
"My" = (
/obj/effect/landmark/deathmatch,
/turf/open/floor/plating/asteroidfloor,
/area/deathmatch)
"MV" = (
/obj/effect/landmark/weapon_spawn/tier2_weapon_spawn,
/turf/open/floor/plating/asteroidfloor,
/area/deathmatch)
"Pv" = (
/obj/structure/fence,
/turf/open/floor/plating/ground/mars/random/sand,
/area/deathmatch)
"Px" = (
/obj/machinery/door/poddoor/railing{
	dir = 2
	},
/turf/open/floor/stairs/rampbottom{
	color = "#888888";
	dir = 8
	},
/area/deathmatch)
"PF" = (
/turf/open/floor/plating/ground/mars/dirttosand{
	dir = 1
	},
/area/deathmatch)
"QE" = (
/obj/effect/landmark/weapon_spawn/tier5_weapon_spawn,
/turf/open/floor/plating/ground/mars/dirttosand,
/area/deathmatch)
"QN" = (
/obj/structure/prop/mainship/hangar_stencil,
/turf/open/floor/plating/asteroidplating,
/area/deathmatch)
"QO" = (
/obj/structure/largecrate,
/turf/open/floor/plating/asteroidfloor,
/area/deathmatch)
"QR" = (
/obj/structure/platform{
	dir = 8
	},
/turf/open/floor/plating/asteroidfloor,
/area/deathmatch)
"Sf" = (
/obj/machinery/door/poddoor/railing{
	dir = 2
	},
/turf/open/floor/plating/asteroidwarning,
/area/deathmatch)
"TU" = (
/obj/structure/platform,
/obj/effect/landmark/weapon_spawn/tier2_weapon_spawn,
/turf/open/floor/plating/asteroidfloor,
/area/deathmatch)
"Uc" = (
/obj/machinery/door/poddoor/railing{
	dir = 2
	},
/turf/open/floor/plating/asteroidfloor,
/area/deathmatch)
"VQ" = (
/obj/structure/cargo_container/ch_red{
	layer = 5
	},
/turf/open/floor/plating/ground/mars/random/sand,
/area/deathmatch)
"Wa" = (
/obj/machinery/door/poddoor/railing{
	dir = 8
	},
/turf/open/floor/plating/asteroidfloor,
/area/deathmatch)
"Wj" = (
/obj/structure/window/framed/colony,
/turf/open/floor/plating,
/area/deathmatch)
"Wn" = (
/obj/effect/forcefield{
	desc = "You can't get in. Heh.";
	name = "Blocker"
	},
/turf/closed/wall,
/area/deathmatch)
"Xe" = (
/turf/open/floor/plating/ground/mars/dirttosand{
	dir = 8
	},
/area/deathmatch)
"XI" = (
/turf/open/floor/plating/ground/mars/dirttosand{
	dir = 6
	},
/area/deathmatch)
"XY" = (
/turf/closed/desertdamrockwall,
/area/deathmatch)
"YE" = (
/obj/structure/largecrate,
/turf/open/floor/plating/ground/mars/random/dirt,
/area/deathmatch)
"YK" = (
/obj/machinery/door/poddoor/railing{
	dir = 2
	},
/obj/effect/landmark/weapon_spawn/tier3_weapon_spawn,
/turf/open/floor/plating/asteroidfloor,
/area/deathmatch)
"YO" = (
/turf/open/floor/stairs/rampbottom{
	dir = 4
	},
/area/deathmatch)
"ZA" = (
/obj/structure/table/reinforced,
/obj/effect/spawner/random/plushie{
	spawn_nothing_percentage = 95
	},
/turf/open/floor/plating/asteroidfloor,
/area/deathmatch)
"ZH" = (
/obj/effect/forcefield{
	desc = "You can't get in. Heh.";
	name = "Blocker"
	},
/obj/machinery/door/poddoor/mainship/ammo,
/turf/open/floor/plating/ground/mars/random/sand,
/area/deathmatch)
"ZI" = (
/obj/effect/landmark/deathmatch,
/turf/open/floor/plating/ground/mars/dirttosand,
/area/deathmatch)
"ZJ" = (
/obj/structure/cargo_container/nt{
	dir = 1
	},
/turf/open/floor/plating/ground/mars/random/sand,
/area/deathmatch)
"ZO" = (
/obj/effect/landmark/deathmatch,
/turf/open/floor/plating/asteroidplating{
	color = "#888888"
	},
/area/deathmatch)
"ZT" = (
/obj/effect/landmark/weapon_spawn/tier2_weapon_spawn,
/turf/open/floor/plating/ground/mars/dirttosand{
	dir = 8
	},
/area/deathmatch)

(1,1,1) = {"
XY
XY
XY
XY
XY
XY
XY
XY
XY
XY
XY
XY
XY
XY
XY
XY
XY
XY
XY
XY
XY
XY
XY
XY
XY
XY
XY
XY
XY
XY
XY
XY
XY
XY
XY
XY
Wn
Wn
Wn
Wn
Wn
XY
XY
XY
XY
XY
"}
(2,1,1) = {"
XY
XY
XY
XY
XY
XY
XY
XY
XY
XY
XY
XY
XY
XY
XY
XY
XY
XY
XY
XY
XY
XY
XY
XY
XY
XY
XY
XY
XY
XY
od
od
od
od
od
od
od
MV
My
Mn
od
od
od
od
od
Wn
"}
(3,1,1) = {"
XY
XY
XY
XY
XY
XY
XY
XY
XY
XY
XY
XY
XY
XY
XY
XY
XY
XY
XY
XY
XY
XY
XY
XY
XY
XY
XY
XY
XY
XY
od
Mn
Mn
My
Mn
Mn
Mn
Mn
Mn
Mn
MV
Mn
Mn
Mn
Mn
Wn
"}
(4,1,1) = {"
XY
XY
XY
XY
XY
XY
XY
XY
XY
XY
XY
XY
XY
XY
XY
XY
XY
XY
XY
XY
XY
XY
XY
XY
XY
XY
XY
XY
XY
XY
od
Mn
Mn
Mn
MV
Mn
Mn
Mn
Mn
Mn
Mn
My
Mn
MV
Mn
Wn
"}
(5,1,1) = {"
XY
XY
XY
XY
XY
XY
XY
XY
XY
XY
XY
XY
XY
XY
XY
XY
XY
XY
XY
XY
XY
XY
XY
XY
XY
XY
XY
XY
XY
XY
od
Mn
Mn
od
od
od
od
od
od
od
od
od
od
Mn
Mn
Wn
"}
(6,1,1) = {"
XY
XY
XY
XY
XY
XY
XY
XY
XY
XY
XY
XY
XY
XY
XY
XY
XY
XY
XY
XY
XY
XY
XY
XY
XY
XY
XY
XY
XY
XY
od
MV
Mn
od
od
Mn
jP
jP
jP
jP
jP
Mn
od
Mn
Mn
Wn
"}
(7,1,1) = {"
XY
XY
XY
XY
XY
XY
XY
XY
XY
XY
XY
XY
XY
XY
XY
XY
XY
XY
XY
XY
XY
XY
XY
XY
XY
XY
XY
XY
XY
XY
od
rF
rF
od
od
Sf
Fp
Fp
Fp
Fp
dB
jc
od
Mn
Mn
Wn
"}
(8,1,1) = {"
XY
XY
XY
XY
XY
XY
XY
XY
XY
XY
XY
XY
XY
XY
XY
XY
XY
Pv
Pv
Pv
Pv
Pv
Pv
Pv
Pv
XY
XY
XY
XY
XY
od
rF
rF
od
od
Sf
wI
Fp
oD
Fp
Fp
jc
od
Mn
MV
Wn
"}
(9,1,1) = {"
XY
XY
XY
XY
XY
XY
XY
XY
XY
XY
XY
XY
XY
XY
XY
XY
dj
dj
dj
dj
vv
Xe
Xe
up
dj
Ax
XY
XY
XY
XY
od
Do
rF
od
od
Sf
Fp
Fp
Fp
Fp
Fp
jc
Mn
Mn
Mn
Wn
"}
(10,1,1) = {"
XY
XY
XY
XY
XY
XY
XY
XY
XY
XY
XY
XY
XY
XY
XY
dj
vv
Xe
ZT
Xe
bi
bi
hw
bi
up
dj
XY
XY
XY
XY
od
rF
LA
od
od
Sf
Fp
fF
tf
kR
Fp
jc
Mn
Mn
Mn
Wn
"}
(11,1,1) = {"
XY
XY
XY
XY
XY
XY
XY
XY
XY
XY
XY
XY
XY
vv
Xe
Xe
bi
bi
bi
bi
bi
bi
bi
bi
sr
up
dj
dj
od
XY
od
rF
rF
od
od
Sf
Fp
tf
tf
Fp
Fp
jc
Mn
MV
My
Wn
"}
(12,1,1) = {"
XY
XY
XY
XY
XY
XY
XY
XY
XY
XY
XY
XY
vv
sr
bi
bi
hw
bi
bi
zr
bi
bi
bi
bi
bi
Ip
dj
Go
od
od
od
rF
rF
od
od
Sf
Fp
Fp
Fp
Fp
Fp
wH
Mn
Mn
Mn
Wn
"}
(13,1,1) = {"
XY
XY
XY
XY
XY
XY
XY
XY
XY
XY
XY
vv
bi
bi
bi
bi
bi
bi
bi
zr
zQ
bi
bi
bi
bi
bi
Xe
od
od
Mn
Uc
rF
rF
od
od
Sf
dB
Fp
wI
Fp
Fp
jc
od
Mn
od
Wn
"}
(14,1,1) = {"
XY
XY
XY
XY
XY
XY
XY
XY
XY
vv
bi
bi
bi
bi
hw
bi
bi
bi
bi
bi
bi
bi
hw
bi
bi
bi
bi
sr
Fp
Mn
Uc
rF
Do
od
od
Sf
Fp
Fp
Fp
Fp
Fp
jc
od
MV
Mn
Wn
"}
(15,1,1) = {"
XY
XY
XY
XY
XY
XY
XY
XY
jJ
bi
bi
bi
KZ
KZ
KZ
bi
sr
bi
bi
bi
bi
bi
bi
bi
sr
bi
bi
bi
od
Mn
Mn
Mn
Mn
od
od
Sf
Fp
rF
rF
rF
Fp
jc
od
Fc
ix
Wn
"}
(16,1,1) = {"
XY
XY
XY
XY
XY
XY
XY
vv
bi
bi
bi
XI
XY
XY
XY
Jf
KZ
od
od
od
od
od
bi
bi
bi
bi
bi
hw
od
My
Mn
MV
Mn
od
od
Mn
Wa
Mn
Mn
Mn
Wa
Mn
od
od
od
Wn
"}
(17,1,1) = {"
XY
XY
XY
XY
XY
XY
XY
PF
bi
bi
vi
XY
XY
XY
XY
dj
dj
od
oH
Mn
My
Fp
bi
bi
bi
bi
bi
Ip
od
od
Mn
Mn
My
od
od
od
od
dO
Ab
dO
od
od
od
XY
XY
XY
"}
(18,1,1) = {"
XY
XY
XY
XY
XY
XY
XY
PF
sr
Ip
XY
XY
XY
XY
XY
XY
db
od
Mn
Mn
Mn
Fp
sr
bi
bi
bi
bi
QE
kU
od
Mn
Mn
Mn
od
XY
od
dO
dO
dO
dO
dO
od
XY
XY
XY
XY
"}
(19,1,1) = {"
XY
XY
XY
XY
XY
XY
XY
PF
bi
XI
XY
XY
XY
XY
XY
XY
Ax
od
od
MV
Mn
od
Jf
KZ
KZ
bi
bi
Ip
ZJ
od
Mn
Mn
oH
od
XY
od
dO
od
od
od
dO
od
XY
XY
XY
XY
"}
(20,1,1) = {"
XY
XY
XY
XY
XY
XY
vv
bi
Ip
XY
XY
XY
XY
XY
XY
XY
XY
XY
od
Mn
Mn
od
od
od
od
bi
bi
Ip
AN
od
Fp
Fp
od
od
XY
od
dO
dO
dO
dO
ZO
od
XY
XY
XY
XY
"}
(21,1,1) = {"
XY
XY
XY
XY
XY
XY
PF
hw
Ip
dj
dj
XY
od
od
od
od
od
od
od
Fp
Fp
Fp
Fp
tf
od
bi
sr
bi
nt
Xe
bi
ZI
dj
dj
XY
od
od
jb
jb
jb
od
od
XY
XY
XY
XY
"}
(22,1,1) = {"
XY
XY
XY
XY
XY
XY
PF
bi
XI
VQ
dj
dj
od
Mn
Mn
Mn
My
Mn
Mn
Fp
Fp
Fp
Fp
Fp
od
bi
bi
bi
bi
bi
bi
Ip
dj
XY
XY
XY
od
jb
LY
jb
od
XY
XY
XY
XY
XY
"}
(23,1,1) = {"
XY
XY
XY
XY
XY
dj
dD
Ip
dj
AF
Go
dj
od
Mn
Mn
Mn
Mn
Mn
Mn
Fp
dB
Fp
wI
Fp
od
YE
bi
bi
bi
bi
bi
pV
XY
XY
XY
XY
od
od
od
od
od
XY
XY
XY
XY
XY
"}
(24,1,1) = {"
XY
XY
XY
XY
dj
vv
bi
jM
dj
wl
dj
Ax
od
Mn
vW
od
od
od
od
Fp
Fp
Fp
QN
Fp
od
Lv
bi
bi
bi
bi
bi
Ip
XY
XY
XY
XY
XY
XY
XY
XY
XY
XY
XY
XY
XY
XY
"}
(25,1,1) = {"
XY
XY
XY
XY
dj
PF
hw
Ip
od
od
od
od
od
My
TU
Mn
Mn
Mn
Wj
Fp
Fp
Fp
Fp
Fp
od
YK
Jf
bi
hw
bi
bi
Ip
XY
XY
XY
XY
XY
XY
XY
XY
XY
XY
XY
XY
XY
XY
"}
(26,1,1) = {"
XY
XY
XY
XY
dj
PF
bi
Ip
od
Mn
Mn
Mn
Mn
Mn
Mn
Mn
od
Mn
Wj
Fp
Fp
kh
Jn
Fp
od
Uc
dj
PF
bi
bi
bi
Ip
dj
dj
XY
XY
XY
XY
XY
XY
XY
XY
XY
XY
XY
XY
"}
(27,1,1) = {"
XY
XY
dj
dj
db
PF
bi
Ip
od
Mn
MV
Mn
Mn
Mn
vW
Mn
od
Mn
Wj
Fp
Fp
tH
Fp
Fp
od
Uc
db
PF
bi
bi
bi
YE
sw
dj
XY
XY
XY
XY
XY
XY
XY
XY
XY
XY
XY
XY
"}
(28,1,1) = {"
XY
db
Go
Ax
dj
PF
hw
Ip
od
Mn
Mn
od
Mn
vW
QR
Mn
od
YO
od
Fp
Fp
nN
Fp
dB
od
Wj
Wj
Wj
od
bi
bi
YE
Ip
db
dj
XY
XY
XY
XY
XY
XY
XY
ZH
ZH
XY
XY
"}
(29,1,1) = {"
XY
dj
dj
dj
dj
Jf
bi
Ip
od
Mn
Mn
od
Mn
vW
My
ZA
od
Fp
Fp
Fp
Fp
Fm
Fp
Fp
od
ay
Mn
Mn
od
bi
bi
bi
Ip
dj
dj
XY
XY
XY
XY
XY
XY
db
dj
dj
Ax
XY
"}
(30,1,1) = {"
XY
ZH
ZH
XY
XY
dj
PF
pV
od
My
Mn
od
Mn
vW
Mn
QO
od
Fp
dB
Fp
Fp
Fp
Fp
Fp
od
od
od
Mn
od
bi
bi
bi
Ip
dj
dj
db
XY
XY
XY
XY
XY
dj
dj
dj
Go
XY
"}
(31,1,1) = {"
XY
XY
XY
XY
XY
dj
Jf
bi
bi
bi
sr
od
MV
vW
od
od
od
Fp
wI
Fp
Fp
Fp
Fp
Fp
od
Mn
MV
Mn
Fp
bi
bi
bi
ZI
dj
dj
dj
XY
XY
XY
XY
dj
dj
dj
dj
dj
XY
"}
(32,1,1) = {"
XY
XY
XY
XY
XY
XY
dj
Jf
KZ
bi
bi
od
Mn
Mn
tZ
Fc
od
GJ
GJ
GJ
GJ
JW
GJ
GJ
od
tZ
Mn
My
Fp
bi
bi
bi
Ip
dj
dj
dj
XY
XY
XY
dj
dj
dj
dj
dj
dj
XY
"}
(33,1,1) = {"
XY
XY
XY
XY
XY
XY
dj
dj
dj
Jf
KZ
od
My
Mn
Mn
Fc
od
od
od
od
od
od
od
od
od
od
Mn
MV
od
bi
bi
KZ
XI
dj
dj
dj
dj
dj
dj
dj
Go
dj
dj
dj
dj
XY
"}
(34,1,1) = {"
XY
XY
XY
XY
XY
XY
XY
XY
dj
db
dj
od
Mn
Mn
Mn
Mn
od
tF
Fp
Fp
tf
Fp
Fp
tF
od
od
Mn
Mn
od
KZ
XI
dj
dj
dj
dj
dj
Go
dj
dj
dj
dj
dj
dj
db
XY
XY
"}
(35,1,1) = {"
XY
XY
XY
XY
XY
XY
XY
XY
XY
dj
Go
od
od
Mn
MV
Mn
Mn
dB
Fp
Fp
Fp
Fp
wI
Fp
My
Mn
Mn
Mn
od
dj
db
dj
dj
XY
dj
dj
dj
dj
dj
dj
dj
dj
dj
XY
XY
XY
"}
(36,1,1) = {"
XY
XY
XY
XY
XY
XY
XY
XY
XY
dj
dj
XY
od
od
Mn
Mn
Mn
Fp
Fp
wI
Fp
Fp
Fp
Fp
Mn
Mn
MV
Mn
od
XY
XY
XY
XY
XY
XY
db
dj
dj
dj
XY
XY
XY
XY
XY
XY
XY
"}
(37,1,1) = {"
XY
XY
XY
XY
XY
XY
XY
XY
XY
Mx
pX
XY
XY
od
od
od
od
Fp
Fp
rv
rv
rv
Fp
Fp
dl
od
od
od
od
XY
XY
XY
XY
XY
XY
XY
XY
XY
XY
XY
XY
XY
XY
XY
XY
XY
"}
(38,1,1) = {"
XY
XY
XY
XY
XY
XY
XY
XY
XY
XY
XY
XY
XY
XY
XY
XY
od
YO
YO
xu
jb
Px
YO
YO
od
XY
XY
XY
XY
XY
XY
XY
XY
XY
XY
XY
XY
XY
XY
XY
XY
XY
XY
XY
XY
XY
"}
(39,1,1) = {"
XY
XY
XY
XY
XY
XY
XY
XY
XY
XY
XY
XY
XY
XY
XY
XY
od
YO
YO
xu
LY
Px
YO
YO
od
XY
XY
XY
XY
XY
XY
XY
XY
XY
XY
XY
XY
XY
XY
XY
XY
XY
XY
XY
XY
XY
"}
(40,1,1) = {"
XY
XY
XY
XY
XY
XY
XY
XY
XY
XY
XY
XY
XY
XY
XY
XY
od
De
YO
xu
jb
Px
YO
De
od
XY
XY
XY
XY
XY
XY
XY
XY
XY
XY
XY
XY
XY
XY
XY
XY
XY
XY
XY
XY
XY
"}
(41,1,1) = {"
XY
XY
XY
XY
XY
XY
XY
XY
XY
XY
XY
XY
XY
XY
XY
XY
od
Fp
dB
Fp
Fp
Fp
Fp
Fp
od
XY
XY
XY
XY
XY
XY
XY
XY
XY
XY
XY
XY
XY
XY
XY
XY
XY
XY
XY
XY
XY
"}
(42,1,1) = {"
XY
XY
XY
XY
XY
XY
XY
XY
XY
XY
XY
XY
XY
XY
XY
XY
od
Fp
Fp
Fp
Fp
dB
Fp
Fp
od
XY
XY
XY
XY
XY
XY
XY
XY
XY
XY
XY
XY
XY
XY
XY
XY
XY
XY
XY
XY
XY
"}
(43,1,1) = {"
XY
XY
XY
XY
XY
XY
XY
XY
XY
XY
XY
XY
XY
XY
XY
XY
od
od
od
Fp
wI
Fp
od
od
XY
XY
XY
XY
XY
XY
XY
XY
XY
XY
XY
XY
XY
XY
XY
XY
XY
XY
XY
XY
XY
XY
"}
(44,1,1) = {"
XY
XY
XY
XY
XY
XY
XY
XY
XY
XY
XY
XY
XY
XY
XY
XY
XY
XY
od
Fp
Fp
Fp
od
XY
XY
XY
XY
XY
XY
XY
XY
XY
XY
XY
XY
XY
XY
XY
XY
XY
XY
XY
XY
XY
XY
XY
"}
(45,1,1) = {"
XY
XY
XY
XY
XY
XY
XY
XY
XY
XY
XY
XY
XY
XY
XY
XY
XY
XY
od
tf
Fp
tF
od
XY
XY
XY
XY
XY
XY
XY
XY
XY
XY
XY
XY
XY
XY
XY
XY
XY
XY
XY
XY
XY
XY
XY
"}
(46,1,1) = {"
XY
XY
XY
XY
XY
XY
XY
XY
XY
XY
XY
XY
XY
XY
XY
XY
XY
XY
Wn
Wn
Wn
Wn
Wn
XY
XY
XY
XY
XY
XY
XY
XY
XY
XY
XY
XY
XY
XY
XY
XY
XY
XY
XY
XY
XY
XY
XY
"}
