"a" = (/turf/open/floor/rogue/dirt,/area/rogue/outdoors/bog)
"b" = (/turf/closed/mineral/rogue/bedrock,/area/rogue)
"c" = (/obj/structure/flora/roguetree,/turf/open/floor/rogue/dirt,/area/rogue/outdoors/bog)
"d" = (/turf/closed/mineral/rogue/bedrock,/area/rogue/indoors/cave)
"e" = (/turf/open/water/swamp/deep,/area/rogue/outdoors/bog)
"f" = (/obj/machinery/light/rogue/firebowl/standing/blue,/turf/open/floor/rogue/dirt/road,/area/rogue/indoors/cave)
"g" = (/turf/closed/mineral/random/rogue/high,/area/rogue/outdoors/bog)
"h" = (/turf/open/water/cleanshallow,/area/rogue/outdoors/bog)
"i" = (/turf/open/water/cleanshallow,/area/rogue/indoors/cave)
"j" = (/turf/closed/wall/mineral/rogue/craftstone,/area/rogue/outdoors/bog)
"l" = (/turf/closed/mineral/random/rogue/high,/area/rogue/indoors/cave)
"o" = (/turf/closed/mineral/rogue/bedrock,/area/rogue/outdoors/bog)
"q" = (/obj/effect/landmark/start/adventurerlate{icon_state = "arrow"; dir = 8},/turf/open/floor/rogue/dirt,/area/rogue/outdoors/bog)
"r" = (/turf/open/floor/rogue/dirt,/area/rogue/indoors/cave)
"v" = (/obj/structure/portal,/turf/closed/mineral/rogue/bedrock,/area/rogue/outdoors/bog)
"w" = (/turf/open/floor/rogue/dirt/road,/area/rogue/indoors/cave)
"x" = (/obj/effect/landmark/start/adventurerlate{icon_state = "arrow"; dir = 4},/turf/open/floor/rogue/dirt/road,/area/rogue/outdoors/bog)
"y" = (/turf/open/floor/rogue/hexstone,/area/rogue/outdoors/bog)
"z" = (/obj/effect/landmark/start/adventurerlate{icon_state = "arrow"; dir = 8},/turf/open/floor/rogue/dirt/road,/area/rogue/outdoors/bog)
"B" = (/obj/effect/landmark/events/testportal{aportalloc = "bog"},/turf/open/floor/rogue/dirt/road,/area/rogue/outdoors/bog)
"D" = (/turf/open/floor/rogue/dirt/road,/area/rogue/outdoors/bog)
"F" = (/obj/effect/landmark/start/adventurerlate,/turf/open/floor/rogue/dirt/road,/area/rogue/outdoors/bog)
"G" = (/turf/open/water/swamp,/area/rogue/outdoors/bog)
"M" = (/obj/effect/landmark/start/adventurerlate{icon_state = "arrow"; dir = 1},/turf/open/floor/rogue/dirt/road,/area/rogue/outdoors/bog)
"O" = (/obj/effect/landmark/start/adventurerlate{icon_state = "arrow"; dir = 1},/turf/open/floor/rogue/dirt,/area/rogue/outdoors/bog)
"Q" = (/turf/closed/mineral/random/rogue/med,/area/rogue/outdoors/bog)
"S" = (/obj/structure/fluff/traveltile/vampire{aportalgoesto = "vampin"; aportalid = "vampexit"},/turf/open/floor/rogue/dirt,/area/rogue/outdoors/woods)
"U" = (/obj/machinery/light/rogue/firebowl/standing,/turf/open/floor/rogue/hexstone,/area/rogue/outdoors/bog)
"V" = (/obj/effect/landmark/mapGenerator/rogue/bog{endTurfX = 128; endTurfY = 128},/turf/closed/mineral/rogue/bedrock,/area/rogue)
"X" = (/obj/effect/landmark/mapGenerator/sunlights{endTurfX = 128; endTurfY = 128},/turf/closed/mineral/rogue/bedrock,/area/rogue/outdoors/bog)
"Y" = (/obj/structure/fluff/traveltile{aallmig = "rwfieldbog"; aportalgoesto = "bogrtout"; aportalid = "bogrtin"},/turf/open/floor/rogue/dirt/road,/area/rogue/outdoors/bog)
"Z" = (/turf/closed/mineral/rogue/salt,/area/rogue/outdoors/bog)

(1,1,1) = {"
bbbbbbbbbbbbbbbbbbbbbbbbbbbbbbbbbbbbbbbbbbbbbbbbbbbbbbbbbbbbbbbbbbbbbbbbbbbbbbbbbbbbbbbbbbbbbbbbbbbbbbbbbbbbbbbbbbbbbbbbbbbbbbbb
booooooooooDDGGGGGGGGGGGGGGGGGGGGGGGGGGGGGGoooooooooooooYYoooooooooooYYGGGGGGGGGGGGGGGGGGGGGGGGGGGQQQQQQQGGGGGGGGQQQQQQQQQQQQQob
booooooooooDDDDDDDDDDDDDDDDDDDDDDDDDGGGGGGGGGGGooooooGGGDDGGGGGGGGGGGDDGGGGGGGGGGGGGGGGGGGGDDDDDDDQQQQQQQDDDGGGDDQQQQQQQQQQQQQob
boooooDDDDDDzDDDDDDDDDDDDDDDDDDDDDDGGGDDDDDDDDDDDDDDDGGGDDGGGGDDDDDDDDDDDDDDDGGGGGGGaaaaaGGDDDDDDDQQQQQQQDDDGGGDQQQQQQQQQQQQQQob
boooooaaaaaDDDaaaaaaaaaaaaaaaaaaGGGGGaaaaaaaaaaaaaaaaaGGDDGGGGaaaaaaaDBaaaaaaacaaaaaaaaaGGGaaaaaaaQQQQQQQaaaGGaaQQQQQQQQQQQQQQob
boooeeeGGGaDDaaaaaaGGGGGGGGGGaaaaGaGaaaaaaaaaaaaaaaaaaaaDDaaGGaaaaaaaDDaaaaaaaccaaaaaaaGGGGaaaaQQQQQQQQQQaaaGGaaQQQQQQQQQQQQQQob
boooeeeGGGaDaaaaaaaGGGGGGGGGGaaaaaaGaaaaaaaGGaaaaaDDDaaaDDaaGGaaaaaaaDDaaaaaaaaccccaaaGGGGGaaaaQQQQQQQQQQaaaGGaaQQQQQQQQQQQQQQob
boooeeeeeGaDDaaZaaaGGGGeeGGGGaaaaaaGGaaaaaaGGaGaaaDzDaaaDDaaaaaaaaaaaDDaaaaaaaaccccaaaaaGGGaaaaQQQQQQQQQQaaaGGaaaaaQQQQQQQQQQQob
booDaGeeeGaDDaaaaaGGGeeeeeeGGGaaaaaaaaaaaGGGGaGaaaDDDaaaDaaaaaaaaaaaaDDaaaaaaaaacccaaaaaGGGaaaaQQQQQQQQQQaaaGGaaaaaaQQQQQQQQQQob
booDaGeeeGaaDaaaaaGGGeeeeeeGGGGGaaaaaaaaaaGGGGGaaaaaaaaaDaaaaaaGaaaaaDDaaaaaGaaacccaaaaaGGGaaaaaaQQQQQQQQaaaGaGGaaaaQQQQQQQQQQob
bGDDaGeeeGaaDaaaaaGGGeeeeeeeGGGGaaaaaaaaaaaGGGGaaaaaaaaaDaaaaaaaaGaaaDDaaaaaGaaaaccaaaaaaGGDDDaaaQQQQQQQQaaaGGGGaaaaaaaQQQQQQQob
boDDaGGGeGaaDaaaaaaGGeeeeeeeGGaaaaaaaaaaaaaGGGGGaaaaaaaaDaaaaaaGaGaaaDDDaaaaGaaaacccaaaaaaGDzDaaaQQQQQQQQaaaGGGaaaaaaaaQQQQDDDob
boDDaaGaGGaaDaaaaaaGGeeeeeeeGGaaaaaaGGaaaaaaGGGGaaaaaaaaDaaaaaaGGGGaaDzDaaaaGaaaacccaaaaaGGDDDaaaaQQQQQQaaaaaGGDDDDDDDDDDDDDzDob
boDDaaaaGGaaDaaaaaaGGGGeeeeeGGaaaaaaaGaaaaaaGGGGaaaaaaaaDaaaaaaaGGGaaDDDaaaaGaaaaaccaaGGGGGGaaaaaaaaQQQQaaaaaaGGaaaaaaaaGaGDDDob
booDaaaaaaaaDaaaaaaGGGGGGGeeeGaaaaGGGGaaZaaaaGaGaaaaaaaaDaaaaaaaGGGaaDaaaaGaGaaaaaccaaaaaaGGaaaaaaaaQQQQaaaaaaGGaaaaaaaaGGGDDGob
booDaaaaaaDDDaaaaaaaaaaGGGeeeGaaaaaaaaaaaaaaaGGGaaaaaaaaDaaaaaaaaaaaaDaaaaaaGaGaaacccaaaaaGGaaaaaaaaQQQQaaaaaaGGGaaaaaaaGGGDDGob
bDDDDDDDDDDxDDDDDDaaaaaGGGGeeGaaaaaaaaaaaaaaaGGGaaaaaaaaDaaaaaaaaaaaaDaaaaaaaaGaaaccaaaaaaaGGaaaaaaQQQQQaaaaaaaaGGaaaaaGGGaDDGob
bDDDaaaaaaDDDaaaaDaaaaaaGGGGGGaaaaaaaaaaaaaaaGGGaaaaaaDDDDDDDDDDDDDDDDaaaaaaaaGaaacccaaaaaaGGGaaaaaQQQQQaaaaaaaaGGGaaaaGGaaDGGob
booDaoooooaaaaaaaDaaaaaaaaaaaaaaaaaaaaaaaaaaaGGGaaaaaaaaaDMDaaaaaaaaaDaaaaGGaGGaaccccaaaaGGGaaaaaaaaaQQQaaaaaaaaaGGGaaaGaaaDGGob
boooooooooooooaaaDaaaaaaaaaaaaaaaDDDaaaaaaaaaGGGaaaaaaaaaDDDaaaaaaaaaDaaaaaGGGaaacccccaaaGaaaaaaaaaaaQQQaaaaaaaaGGGGaGaaaaaDGGob
booooooaaaooaaaaaDaaGGGGGGaaaaaaaDxDaaaaaaaaaGGGaaaaaaaaaaaaaaaaaaaaaDaaaaaaaaaaccccaaaaaGaaaaaaaaaaaaaaaaDDDaaaGGGGGaaaaaaDGGob
booooooaaaaaGGGGaDaaGGaaaGGaaaaaaDDDaaaaaaaaaGGGaaaaaaaaaaaaaaaaaaaaaDaGGGGaaaaaccccaaaaaGaaaaaaaaaaaaaaaaDMDaaaGGGGaaaaaaaDGGob
boooooaaaaaaGaaaaDaaaaaaaaaaaaaaaaaaaaaaaaaaaGGGaaaaaaaaaaaaaaaaaaaaaGGGGGaaaaaaaaaccccaaGaaaaaaaDDDaaaaaaDDDaaGGGGaaaaaaaGGGGob
boooooaaaaaaaGGaaDaaaaaaaaaaaGGGGaaaaaaaaaaaaGGGaaGGaGGaaaaaaaaaaaaaGGGGGaaaaaaaaaaccccaaaaaaaaaaDxDaaaaaaaaaaGGGGGaaaaaaaGGGGob
boooooaaZaaaGGaaaDaGGGGGGaGGGGGGGaaaaaaaaaaaaGGaGGaaGGaaaaaaaaaaaaaGGGGaaaaaaaaaaaaaaaaaaaaaaaaaaDDDaaaaaaaaaaGGGGaaaaaaaaGGGGob
boooooaaaaaaGaaaaDaGGeeeeeGGGeGGGaaaaaaaaaGGGaGaaaaaGaaaaaaaaaaaaaGGGDaaaaaaaaaaaaaaaaaaaaaaaaaaaaaaaaaaaaaaaGGGaaaaaaaaaGGGGGob
boooooaaaaaaGaaaaDaGGeeeeeeeeeGGGaaaaaaGGGGaaaaaaaGGGaaaaaaaaaaaaaaaaDaaaaaaaaaaaaaDDDaaaaaaaGGaGGaaaaaaaaaaaaaaaaaaaaaaaGGGGGob
boooooaaaaaaGaaaaDaGGeeeeeeeeeeGGaaaaaaGGaaaaaaaaaGGGGaaaaaGaaaaaaaaaDaaaaaaaaaaaaaDzDaaaaaaaaGGGGGaaaaaaaaaaaaaaaaaaaaaaGGDGGob
boooooaaaaaaaaaaaDaGGGGGeeeeGGGGGaaaaaaaaaGGaaaaaaGGGGGaaaaGaaaaaaDDDDaaaaaaaaaGaaaDDDaaaaaaaaaaGGGGGaaaaaaaaaaaaaaaaaaaGGaDGGob
boooooaaaaaaaaaaaDaaaaaaGGGGGGGGGaaaaaaaaaaGGGaaaaGGGGGaaaaGaaaaaaDFDDaaaaaGGGGaGGaaaaaaaaaaaaaGGGaGGaaaaaaaaaaaaaaaaaaaaaaDGGob
boooooaaaGGaaaaaaDaaaaaaGGGGGaaaaaaaaaaaDDDDDGDDDDDDDDDDDDDGDDDDDDDDDDaaaaGGaaaaGGaaaaaaaaaaaGGGaaaaaaaaaaaaaaaaaaaaaaaaaaaDGGob
boooooaaaaGGaaaaaDaaaaaaaaaaaaaaGGaaaaaaGGGGGGaaaaaaGaaaaaaGaaaaaaaaaaaaaGGaaaaaaGaaaGGGGGGaaGGaaaaaaaaaaaaaaaaaaaaaaaaaaaaDGGob
booooaaDDDaGGaaaaDaGaaaaaaaacaaaaGGaaaaaDaaaaaaaaaaGGaaaaaaaaGaaaaaaaaaaaGGaaaaaaGGaaaaGGaaaGGGGaaaaaaaaaaaaaaaaaaaaaaaaDDDDGGob
booooaaDxDaaGGaaaDaGaaaaaaaacaaaaaGGaaaaDaaaaGGGGGGGGGaaaGGGGaGaaGGGaaaaaGGaaaaaaaGaaaaGaaaaaaaGGGGaaaaaaaaDDDaaaaaaaaaaDzDDGQob
booooaaDDDaaaaaaaDGGaaaaccaacaaaaaaGaaaaDaaaGGGeeeeaeeGaaaGGGaGGGGGGGGGGaaGGGGaaaaaaaaaGaaaaaaaaaaaaaaaaaaaDFDaaaaaaaaaaDDDDGQob
booooooooooaaooooooooooocccacaaaaaaGaaaaDaaaGGeeeeeeeeGaaaGGGaaGGeeGGGGGaaaGGGaaaaaaaaaaaaaaaaaaaaaaaaaaaaaDDDaaaaaaaaaaaaaDQQob
boooooooooooooooooooooooaccaccaaaaGGaaaaDaGGeeeeeeeeeeGGaaaGGaaGGeeGGGGGGeeeGGGGGGGGaaaaaaaaaaQQQaaaaaaaaaaaaaaaaaaaaaaaaaaDQQob
booooaaaaaaaaaaaGGaooooaacccccaaaaGaaaaaDaGGeeeaaaaaeeGGaaaGGaaGGeeeeeGGGGeeeeeGGGGGaaaaaaaaQQQQQQQQQaaaaaaaaaaaaaaaaaaaaaaQQQob
bGDDaaaGGGGGaaaaGDaaaaaaacccccaaaaaaaaaaDDDGeeaaaaaaeeeGaaaaaaaGGeGGeeeeeeeeeeeeeeeGaaaaaQQQQQQQQQQQQQaaaaaaaaaaaaaaaQaaaaaQQQob
bGDDaGGeeeGGGaGGaDaaaaaaaaccccaaaaaaaaaaDzDGeeaaaZaaGeeGGGaaaaaaaaGGGGGeeeeeeeeeeeeGGaaaaQQQQQQQQQQQQQQQQQQQQQQQQQQQQQaaQaQQQQob
beeeeeGeeeGGaaGaaDaaaaaaaacccccaaaaaZaaaDDDGeeaaaaaaaeeGGGaaaaOaaaGGGGGGGeeeeeeeeeeaaaaaaaQQQQQQQQQQQQQQQQQQQQQQQQQQQQQQQQQQQQob
beeeeeeeeGGaaaaaaDaaaaaaaaccccaaaaaGGaaaDaGGGeaaaaaaaeGaGGaaaaaaaaGGGGGGGeeeeeeGGGGGaaaaaaaaQQQQQQQQQQQQQQQQQQQQQQQQQQQQQQQQQQob
bGeeeeeeeGaaaaaaaDDDDaaaaaaaccaaaaaaGaaaDaGGGeeeeeeeeeGGGGGaaaaaaaGGGGGGGaaaGGGGGGaaaaaaaaaaaaQQQQQQQQQQQQQQQQQQQQQQQQQQQQQQQQob
beeeeeGGGaaaaaaaaDDxDaaaaaaaacaaaaaaGGaaDaaGGeeeeeeeeeGGGGGGaaaaaaGGGGGGGaaaaGGGGaaaaaaaaaaaaaaaaaaaaQQQQQQQQQQQQQQaQQaQQQaQQGob
bGGeeeGGaaaaaaaaaDDDDaaaaaaaacaaaaaaaGaaDaaaGGGGGGGGGGaGGGaGaaaDaaaaaaaGaaaaaGGaGGaaaaaaaaaaaDDDaaaaaaaDDDDDDDDDDaaaaaaaaaDDDGob
bGGGGGaaaaaGGGGGaDaaaaaaaaaaacaaaaaaaaaaDaaaaaaaaGGaGaaaaaaGGaaDaaaaaaaaaaaaaaaGGGaaaaaaaaaaaDzDaaaaaaaDaaaaaaaDDDDDDDDDDDDzDGob
bGGDaaaaaaGGaaaaaDaaaaaaaaaaacaaaaaaaaaaDDDDDDDGDDDDDDDDDDDDGGDDDDDDaaaaaaaaaaaGGGaaGGGaaaaaaDDDaaaaaaaDaaaaaaaaaaaaaaaaaaDDDaob
bGGDaaaaaaGaaaaaaDaaaaaaaGaaaaaaGGGGaaaaDaaaaGGaaaaaaaaaaaaaaaaDaaaaaaaaaaaaaaaaaGaaGaGGGGaaaaaaaaaaaaaaaDDDaaaaaaaaaacccccaccob
bGGDaaaaaGGaaaaGGDGGaaaaaaGGGGGaGGGGaaaaDaaaGGaaaaGGGaaaaaaaaaaDaaaaaaaaGGGGGaaaaaaGGaaaaaGaaaaaaaGaaaaaaDzDaaaaaaaaaccccccaccob
bGGDaaaaaGaaaaGGGGGaaaaaaaaaGGGGGGGGaGGaDaaaGGGGGGaaaaaaaaaaaaaDaaaaGGGaGGGGaaaaaaaGaaaaaaaaaaaaaaGGGGaaaDDDaaaaaaaaccccccccccob
bGGDaaaaaaaaaaGGGDGGaaaaaaaaGGeeeeeGGGGGDaaaaaaaaaaaaaaaaaaaaaaDaaaGGGGeeeeGGaaaaaaaaaaaaaaaaaaaaaGGaaaaaaaaaaaaaaacccccccccccob
bGGDDDDaaaaaaGGaaDaGaaaaaaaaGGeeeeeGGGGGaaaaaaaaaaaaaaeeeeaaaaaDaaGGeeeeeeeGGaaaaaaaaaaaaaaaaaaaaaaaaaaaaaaaaaaaacccccooooooccob
bGGDDzDaaaaGGaaaaDGGaaaaaaaaGGeeeeeeGGGaaaaaaaaaaaaaeeeeeeaaaaaDaaGGeeeeeeeeeeGGaaaaaaaaaaaZaaaaaaaaaaaaaaaaaaccccccccjvooojccob
bGGDDDDaaaaaGGaaaDaGaaaaaaaaGGeeeeeeGGGGaaaaaaaaeeeeeeeeeeaaaaaDaaGGeeeeeeeeeeGGaaaaaaaaaaaaaaaaaaaaaaaaaaaaaccccccaaajUyyUjccob
bGGDaaaaaaaGDGDDDDDGDDDDDDDDDaaaGeeeGGGGaaaaeeeeeeeeeeeeaaaaaaaDaaGGGeeeeeeeeeGGZaaaaaaaaaaaaaaaaaaaaaaaaaaaccccccaaaajyyyyjaaob
bGGDaaaaaaaGGGaaaDaGaaaaDDaaaaaaGeeeGGGaaaaaeeeeeeeeaGGaaaaaaaaDaaGGGGGeeeeeeeGGaDDDaaaaaaaaaaaaaaaaaaaaaaaacccccaaaaajyyyyjaaob
bGGDaaaaaaaaGGaaaDGGaaaaDDaaaaaaGeeeGGaaaaaaaGGaaaaaaGaaaaaaaaaDaaGGGGaeeeeeeeGGaDFDaaaaaaaaaaaaaaaaaaaaaaacccccaaaaaaaGaaaaaaob
bGGDaaaaGGaaGGaaaGGGaaaaDDDaaaaaaGGGGGaaaaaGGGaaaaaaGGaaaacaaaaDaaaaGGGGGGGGGGGGaDDDaaaaaaaaaaaaaaaGGaaaaacccccaaaaaGGGaaaaaaaob
bGGDaaaGGaaaGGaaaaaaaaaaDzDaaaaaaaGGGaaaaaGGGGaaaaaaaaaaaccaaaazaaaaGaaaGGGGGaaaaaaaaaaaaaaaaaaaaaGGGGaaaccccccaaaaGGaaaaaaaaaob
bGGDaaaGGGaaaaaaaaaaaaaaDDDaaaaaaaaaaDDDaGGaaaaaaaaaaaacccaaaaaDaaaaaaaaaaaaaGaGGGGGGGGGaaaaaaGaaGGaGGaGGaaccccaaaaGGaaaaaaaaSob
bDDDaaaaaaaaaaccaccaaaaaaDaaaaaaaaaaaDzDaaaaaaaaaaaaaacccacaaaaDaaaaaaaaaaGGGGaaaGGGaaaaaaaaGGGGGGGGGGaGGaaccccaaaaGGGaaaaaaaSob
bDDDaaaaaaaacccccccccaaaaDaaaaaaaaaaaDDDaaaaaaaaaacccccccccaaaaDaaaaaaaaaaaGGGaGGaaaaaaaaaaaGaaaaaaGGaaaGGGGaaaaGGGGGGGGaaaaaSob
baaaaaaaaccccccccccccaaaaDaaaaaaaaaaaaaaaaaaaaaaccacccccccaaaaaDaaaaaGaaaaaaaGGaaaaaaaaaaaaaaaaaaaaGaaaaGGGGaGGGGGGGaaaaaaaaaSob
baaaaaaacccccccccccccccccDaaaaaaaaaaaaaaaaaaaaacacccccccccaaaaaDaaaaGGGaaaaaaGaaaaaaaaaaaGaaaaaaaaaGaaaaGGGGGccaGGGGaaaaaaaaaaob
bccaaaacccccccccccccccaaaDaaaaaaccccccacacacacccccccccccccaaaaGDaGGGGGaaaaaaaaaaaaaaaaaaGGaaaDDDaaaGaaaaGGGGacccaaaaaaaaaaaaaaob
bccccccccccccccccccaaaaaaDacccccccccccccccccccccccccccacaaaaaGGGGGGGaaaaaaaaaaaaaaaaaaaaGaaaaDzDaaaaaaGaaaaaaccccaaaaaaaaaaaaaob
bccccccccccccaaaaaaaaaaaaDaaaaaaaaaaaaaaaaacccaaaaaaaaaaaaaaaGGGaaaaaaaaaaaaaaaaaaaaaaaaaaaaaDDDaaGaaaaaaaaaaccccaaaaaaaaaaGaaob
bccaaaaaaaaaaaaaaaaaaaaaaDaaaaaaaaaaaaaaaaaaaaaaaaaaaaaaaaaaGGGDaaaaaaaaaaaaaaaaaccaaaaaaaaaaaaaaaGGaaaaaacaacccccaaaaaaaaaGaaob
baGGaaaaaaaaaaaaaaaaaaaaaDaaaaaaaaaaaaaaaGaaaaaaaGGaaaaaaaaGGGaDDDDaaaaaaaaaaaaacccaaaaaaaaaZaaaaaGGaaaaaacaacacccaaaaaaaaaGaaob
baGGaaaaaaaaaaaacaaaaaaaDDDDDDDDDDDDDDDGGGDDDDDDDGGDDDDDDDDGGDDDDzDaaaaaaaaaaaacccaacaaaaaaaaaaaaaGGaaaaaacaacaccccaccaaaaaaaaob
baaGGaaaaaaaaaaccaaaaaaaDFDaaaaaaaaaaaaGaaaaaaaaaaGaaaaaaaGGGGaDDDDaaaaaaaaaccccccacaccccccccccaaGGacccccccaaacccccccccaaaaaaaob
bGGGGaaaaaacccccccaaaaaaDDDaaaaaaaaaaaGGaaaaaaaaaaGaaaaaaaGGaGaDaaaaaaaaaaccccccccacaccaccccaaaaaGGaacccccaaaaacccccccccaaaaaaob
bGGGGaaaaaaaacccccaaaaaaaDaaaaaaaaaaaGGaaaaeeeeeeeeeeeeeeaaaaaaDaaaaaaaaaccccccccccaaaaaaaacaaaaaaGaaaaaaaaaaaaacaccccccccaacaob
bGGGaaaaaaaaaaaaaaaaaaaaaDaaaaaaaaaaaGGaaeeeeeeeeeeeeeeeeaaaaaaaaaaaaaacaaccccaccaaaaaaaaaaaaaaaaGGaaaaaaaaaaaaaaaaccaccccaaccob
bGGGaGaaaaaaaaaaaaaaaaaaaaaaaaaaaaaaaaaaaeeeeGaaaaaaaaaGGaaaaaaaaaaaacaacaccccccaaaDDDaaaaaaaaaaaGGaaaaaaaaaaaaaaaaaccccccccccob
bGGDaGaaaaaaaaaaaaaGGGaaaaaaaaaaGGGGaaGGGaaeeeaaaaaaaaaaaaaaaaaaaaaaaaccccccccaaaaaDFDaaaaaaaaaaaaaDDDDDaaaaaaaaaaaaaccaacccccob
bGGDaGaaaaaaaaaaaaGGGaaaaaaaaaaGGGGGGGGaaaeeeeaaaaaaaaaaaaaaaaaaaaccaccccccaaaaaaaaDDDaaaGaGaaaaaaaDDDGDDDDDDDDDDDDDDaaaacccccob
bGGDaGGGGGaaaaaaaGGGGaaaaaaaaGGGaGGGGaaaaaeeaaaaaaaaaaaaaaacacaaaaccccccaaaaaaaGaaaaaaaaaaaaaaaaaaaDDGGGDGaaaaaDzDaaDaaaaaaaccob
bGGDGGaaaGGGaaaaaGGaGaaaaaaaaaaaaaGGGGaaaaaaaaaaccccccccccccccccccccccccaaaaaGGGaaaaGaaaGaaaaaaaaaaDDGGGGGaaaaaDDDaaDaaaaaaaaaob
bGGDGGaaaaaaaaaaaGGaaGaaaaaaaaaaaaaaaGaaaaaaaccccccccccccccccccccccccacaaaaGGGaaaaeeeeeeaaaGaaaaaGaGDGGGGGaaaaaaaaaaDDDDDDDDDGob
bGGGGGaaaaaaaaaaaaaaaGaaaaaaacccaaaaaaaaaaaaaacacacccccccccaaaaccccaaaaaaaaGaaeeeeeeeeeeaaaGaaaaaGaGGGGGGGaaaaaaaaaGaaaaaaGGDGob
bGGGGaaaaaaaaaaaaaaaaaaaaaaacccccccaaaaaaaaaaaaccccaaccccaaaaaaaaaaaaaaaaaaaaaeeeeeeeeeeaaGGaaaGGGaDGGGGGDaaGaaaaaaGGaaaaaGGGGob
bGGDaaaaaaZaaaaaaaaaccaaaaaacccccccccaaaaaaaaaaccaccccaaaaaaaaaaaaaaaaaaaaaaaaeeeeeeeeeeGaGaaaaaGGaaGGGGGDGaaaaaaaaaaaaaaaGGGGob
bGGDaaaaaaaaaaaaaaacccaaaaaacccaaaaaaaaaaaGaaaaaccaaaaaaaaaaaaaaDDDaaaaaGaaaaGeeeeeeeeeeGGaaaaaaGaaaGGGGGDaaGaGaaaaaaaaaaaGGGGob
bGGDaaaaaaaaaaaaacccccaaaaGaaaaaaaaaaaaaaaGaaaaaaaaaaaaGaGGaaaaaDxDaaaaGGaGeeeeeeeeeeeaaaaaaaaaaGaaGGGGGGDaaaGGGGGGaaaaaaaGGGGob
bGGDaaaDDDaaaaaaaccaaaaaaGGGGaaaaaaZaaaaaGGaGaaaaaaaaaaGGGaaaaaaDDDaaaaeeeeeeeeeeaeeGGGaaaaaaaaaGaaGGGGGGDaaaGGaGGGGaaaaaaGGGGob
bGGDaaaDFDaaaaaaaccaaaaaaGGGGaaaaaaaaaaaaGGGGaaaaaaaaaGGaaaaaaaaaaaaaaGeeeeeeeaaaaaaaaGGGaaaaaaaaaaaGGGGDDaaaaGaaaGGaaaaaGGGGGob
bGGDaaaDDDaaaaaaaaaaaaaaaaGGGGaaaaaaaaaaaGGGGaaaaaaaaGGaaaaaaaaaaaaaaaGGGGGGaaaaaaaaaaaaaaGaaaaaaaaaGGGGGDaaaaaaaaGaaaaaaGGDGGob
bGGDaaaaaaaaaaaaaaaaaaaaaaGGGGGaaaGGaaaaaGGGGaaGaaaaaGaaaaaaGGaaaGGaaaGGaGGGaaaaaaaaaaaaaaaaaaaaaaaaDDGGGGaaaaaaaaaaGaaGGGGGGGob
bGGGaaaaaaaaaaaaaaaaZaaaaaaGGaGaaaGGGaGGGGGGGaGGaaaaaGaaaaaGGGaaGGGGGaaaaaaaaaaaaaaaaaaaaaaaaaaaaaaaDGGDGGaaaaaaaaaaGaaGGGGDDGob
bGGGaaGGaaaaaaaaaaaaaaaaaaaaGGGaaaGaGGGGGGGGGGGaaaaaaaaaaaaGeeeeeeeGaaaaaaaaaaaaaaaaaaaaaaaDDDaaaaaaaaaaaaaaaaaaaaaaaGaGaaGGDGob
bGGGaaaGGaGGaGaaaaaaaaaDDDaaaaGGaaGaaaGGaaaGaaaaaaaaaaaaaaaGeeeeeeeGaaaaaaaaaaaaaaaaaaaaaaaDxDaaaaaaaaaaaaaaaaaaaaaaaGGaaaGDDGob
bGGGaaaaGGaGGGaaaaaaaaaDxDaaaaaaaaGaaaGeeeeGaaaaaaaaaaaaaaGGeeeeeeeGGaaaaaaGaaaaaaaaaaaaaaaDDDaaaaaaaaaaaaaaaDDDaaaaaaGaaGGDDGob
bGGGaaaaaGGGGaaaaaaaaaaDDDaaaaaaaGGaaaGeeeeaaaaaaaaaaaaaaaGeeeeeeeeGGGaaaaaGaaaaogggoaaooaaaaaaaaaaaaaaaaaaaaDzDaaaaaaaaaGaDDGob
bGGDaaaaaGGaGGaaaaaaaaaaaaaaaaGaGGaaaaGGeeeaaaaaaccaDDDaaaGeeeeeeeeGGaaaaaaGaaaooggggggggoooaaaaaaaaaaaaaaaaaDDDaaaaaaaaaGGDDGob
bGGGaaaGGaGGGGaaaaaaaaaaaaaaGGGaaaaqaaGGeeeGaaaaaccaDMDaaGGeeeeeeeeeGaaDDDaGaaaooooggggggggggggooaaaaaaaaaaaaaaaaaaaaaaaaGGDDGob
bGDDaaaaGGGaGGaaaaaaaaaaaaaaGGGGaaaaaaGGGeeaaaaacccaDDDaaGGeeeeeeeeeGaaDxDaGGaaaaaoooogggggggggooooaaaaaaaaaaaaaaaaaahhaaGGDDGob
bGDDaaaaaaaaaaaaaaaaaaaaaaaaGGGGGaaaaaaGGeeGaacccccaaaaaGGGeeeeeeeeeGaGDDDaaGaaaaaaaoogggggggggooooaaaaDDaaaaaaaaaaaahhaaGGGGGob
bGDDaaDDDaaaaaaaaaaaaaaaaaaaGeeeeaaaaaaGGeeGaacccccaaaaaaGGeeeeeeeeeGGGaaaaaGaaaaaaaaogggggggggoooooooaDDDDDDDaaaaaaahhaaaaGGGob
bGDDaaDMDaaaaaaaaaaaaaaaaaaaGeeeeGGaaaaGGGGGaaccccccaaaaaaaGGGGGGGGaGGGaaaaaGaaaaaaaaogggggggggoooooooooDDDDDDaaaaaahhhaaaaDDGob
bGDDaaDDDaGaaaaaaaaaaZZaaaaaGGeeeeeGaaaGGGGGaaccccccaaaaaaaaDDDaaaaGGGGGGGaGGaaaaDDDDDgggggggggooooooowwwDDDDDDaaaaahhhaaaaDDGob
bGDDaaaaaaaGGaaaaaaaaaaaaaaaGGeeeeeGaaaaGGGGaaccccccaaaaaaaaDzDaaaaaGGaaGGGaaaaaaDDDDDoogggggggodddwwwwwwoooDDDaaoaahhhaaaaDDGob
bGDDGGGGaaaaaGaaaaaaaaaaaaaaGGGeeeeGGGaaaaaaaaacccccaaaaaaaaDDDaaaaaGaaaGaaaaaaaowwwwwdogggggggoddwwwwwddooooooooooohhhoooooooob
bGDDaGGGGaaaaaGGGaaaaaaaaaaaGGGeeeeGGGaaaaaaaaccccccaaaaaaaaaaGeeGGGGGaaGGaaaaaaowwwwdddlllllllodwwwwddooooooooooooohhhoooooooob
bGDDaaaaGGGGGaaaGGaaaaaaaaaaaaGeeeeGGGGGaaaaaaccccccaaaaaaaGGGaeeGGaaaaaaaaaaaaadwwwwllllllllllllwwwlllllllllllllddwiiwddddddddb
bGDGGaaaaGaaaaGGGGaaaaaaaaaaaaGGGGGGGGaGaaaaaaccccccaaaaaaGGaGaeeeGaaaaaaGaaaaaodwwwwllllllllllllwwwlllllllllllllddwiiiiwllllldb
bGGGaaGGaGaaaaaaaaaaaaaaaaaaaaGaaaaaGGaaaaaaaaccccccaaaaaGGGGeeeeeGGaaaaaGaaaaagldwwwllllllllllllwwdlllllllllllllddwiiiiwllllldb
bGGGaaaGGGaaaaaaaaaaaaaaGGGGGaaaaaaaaaaaaaGaaaacccccaaaaaGaGGeeeeeGGaaaaaaGaaaagldwwwllllllllllllwwwlllllllllllllddwwiiiwllllldb
bGGGGaaaaaaaaaaaaaaaaGGGGaaaaaaaaaaGaaaaaaGaaaacccccaaaaaGaGGeeeeGaaaaaaaaGGaaaglddwwwlllllllllddwwwlllllllllllllddwiiiidllllldb
bGGGGaaaaaaaaaaaaaGGGGGGaaaaaaaaaaaGaaaaaaGGGaacccccaaaGeeeeeeeeeGaaaaaaaaaGaaagldwwwwddddddddddddiwddddddddddddlldlliillllllldb
bGGGGaaaaaaaaaaaaaaaaaGGGGaaaaaaaaaGGaaaaaaGGaacccccaaaGeeeeeeGGGGaaaaGaaaaaaaoglwrwrwwwwwwdddddddiwdwwwfdddddddlldlliillllllldb
bGDGGaaaaaaaaaaaaaaaaaaaGGGaaaaaaaaaGaaaaaaaaaaccaaaaaaGeeeeeeGaGaaaaGGaaaaaaaowwwrwrrwwrrrrrwwwdwiwwwwwwwwwdddddlllliillllllldb
bGDGGaaaaaaaaaaaaaaaaaaaaGGGaDDDaaaaGaaaaaaaaaDDDaaaaaaGGGeeeeGGaaaaGGaaaaaaaaodwwrrrrrrrrrrrrwwwwiwwddwwwwiiiiddllllllllllldddb
bGDDGaaaaaaaaaaaaaaaaaaaaaGaaDxDaaaaaaaaaaaaaaDxDaaaaaaGGGGGGGaaaaaGGaaaaaaaaoodwwwwrrrrrrrrrrwwwdiwwdddwwwiiiiddllllllllllldddb
bGDGGaaGGaaaaaaGGGGGaaaaaaGaaDDDaaaaaaaaaaaaaaDDDaaaaGGaaaaGGaaaaaGGaaaaaaaaDooddddwrrrrrrrrrriiiiiiwddwwwwwdddddllllllllllldddb
bGDGGaaGGaaaaaGGGGGGGGGGaaGaaaaaaaaaaaaaaaaGGaaaaaaaaaGGGGGaaaaaGGaaaaDDDaDDDodwwdddrrrrrrrrrriiiiiiwddfwwddddddddlllllllddddddb
bDDDGGGGaaaaaaGGGGGGGGGGaaGaaaaaaaaaaaaaaGGGaaaaaaaaaaaaaaaaaaGGGaaaaaDzDaDDwwwwwwddwrwwwwwrrriiiiiiwwdwwwwdddddldlllllllddddddb
bDxDGGGGaaaaaaaaaaaaaaaaaaGaaaaaaaaaaaGGaGaGaaaaaGGaaaaaaaaaaaaaaaaaaaDDDaaowwwwwwwdllllldwrrriiiiiirwwdwwwwiiddlllllllllddddddb
bDDDGGGaaaaaaaaaaaaaaaaaaaaGGaaaaaaaaaaGGGaGGaaaaaGGaaaaaaaaaaaaaaaaaaaaaooodwwwwwwdlllllwwrrriiiiiirwwdwwwiiiddddlllldddddddddb
bGDGGGGaaaaaaaaaaaaaaaaaaaaaaGaaGGGaGGGGGGGaGaaaaaGGGGaaGaaaaaaaaaaaaaaaaoddwwwwdwwwlllllwwrrrrwddirwwwdwwiiiidddddddldddddddddb
bGDGGGGGaaaaaaaaaaaaaaaaaaaaaGGGGGGaGGaaGGGGGaaaaaaGGGGaGGaaaaaaaaaaaaaooodwwwllllwwwwwwwwwrrrrwwiiwwwddwwdddddddddddddddddddddb
bGGGGGGGGaaaaaaaaaaaaaaaaGaGGGGGGGGGGaGGGGGGGaaaaaaaaGGGGGGaaaaaaaaaaaaoddrwwwllllwwwwrrrrrrrrrwdriwwwwwwwdddddddddddddddddddddb
bGGGGDGGGGDDDDDDDDDGGDDDGGGGGGGGDDDDDDDDDGDDDDDDDDDDDDDDGGGGDDDDDDDDDDoodwwwwwlllldddwwwwwwrwwwwddiwwwwwwwiidddddddddddddddddddb
bGGGDDDGGGGGGGGDGGGGGDGGGGGGGDDDDDDDDDDDDDDDDDDDDDDDDDDDDDDGGGDDDDDDDDodwddwwwlllllllldwwddwwwwldwiwddwwfwwwdddddddddddddddddddb
bGGGGGGGGGGGGGGGGGGGGGGGGGGGGGGGGGGGGGGGGGGGGGGGGGGGGGGGGGGGGGGGGGGGGooddllllllllllllllllllllllliiiddddddddddddddddddddddddddddb
VXoooooooooooooooooooooooooooooooooooooooooooooooooooooooooooooooooooooddlllllddlllllllllllllllddddddddddddddddddddddddddddddddb
bbbbbbbbbbbbbbbbbbbbbbbbbbbbbbbbbbbbbbbbbbbbbbbbbbbbbbbbbbbbbbbbbbbbbbbbbbbbbbbbbbbbbbbbbbbbbbbbbbbbbbbbbbbbbbbbbbbbbbbbbbbbbbbb
bbbbbbbbbbbbbbbbbbbbbbbbbbbbbbbbbbbbbbbbbbbbbbbbbbbbbbbbbbbbbbbbbbbbbbbbbbbbbbbbbbbbbbbbbbbbbbbbbbbbbbbbbbbbbbbbbbbbbbbbbbbbbbbb
"}
