//MAP CONVERTED BY dmm2tgm.py THIS HEADER COMMENT PREVENTS RECONVERSION, DO NOT REMOVE
"al" = (
/obj/machinery/light{
	dir = 4
	},
/obj/effect/landmark/start/job/squadcorpsman,
/turf/open/floor/mainship,
/area/mainship/patrol_base)
"aL" = (
/obj/structure/patrol_point{
	id = "TGMC_24"
	},
/turf/open/floor/mainship,
/area/mainship/patrol_base)
"bg" = (
/turf/closed/wall/r_wall/unmeltable,
/area/mainship/patrol_base/telecomms)
"bz" = (
/obj/effect/landmark/start/job/squadmarine,
/turf/open/floor/mainship,
/area/mainship/patrol_base)
"bX" = (
/obj/machinery/light{
	dir = 8
	},
/obj/effect/landmark/start/job/squadengineer,
/turf/open/floor/mainship,
/area/mainship/patrol_base)
"ch" = (
/obj/structure/patrol_point{
	id = "TGMC_13"
	},
/turf/open/floor/mainship,
/area/mainship/patrol_base)
"cv" = (
/obj/structure/table/mainship,
/obj/item/facepaint/green,
/turf/open/floor/mainship,
/area/mainship/patrol_base/som)
"cU" = (
/obj/structure/patrol_point{
	id = "SOM_22"
	},
/turf/open/floor/mainship,
/area/mainship/patrol_base/som)
"dv" = (
/turf/closed/wall,
/area/mainship/patrol_base/som)
"dJ" = (
/turf/closed/wall,
/area/mainship/patrol_base)
"dP" = (
/obj/machinery/telecomms/server/presets/whiskey,
/turf/open/floor/mainship,
/area/mainship/patrol_base/telecomms)
"fL" = (
/obj/machinery/door/poddoor/timed_late/containment,
/turf/open/floor/mainship,
/area/mainship/patrol_base/som)
"fM" = (
/obj/machinery/telecomms/server/presets/alpha,
/turf/open/floor/mainship,
/area/mainship/patrol_base/telecomms)
"fT" = (
/obj/machinery/telecomms/relay/preset/telecomms,
/turf/open/floor/mainship,
/area/mainship/patrol_base/telecomms)
"gk" = (
/obj/machinery/light,
/turf/open/floor/mainship,
/area/mainship/patrol_base)
"go" = (
/obj/machinery/telecomms/hub/preset/som,
/turf/open/floor/mainship,
/area/mainship/patrol_base/telecomms)
"ik" = (
/obj/structure/table/mainship,
/turf/open/floor/mainship,
/area/mainship/patrol_base/som)
"ir" = (
/turf/closed/wall/r_wall/unmeltable,
/area/mainship/patrol_base/som)
"jp" = (
/obj/structure/patrol_point{
	id = "TGMC_14"
	},
/turf/open/floor/mainship,
/area/mainship/patrol_base)
"jw" = (
/obj/machinery/telecomms/server/presets/xray,
/turf/open/floor/mainship,
/area/mainship/patrol_base/telecomms)
"jG" = (
/obj/machinery/telecomms/server/presets/bravo,
/turf/open/floor/mainship,
/area/mainship/patrol_base/telecomms)
"lu" = (
/obj/machinery/telecomms/hub/preset,
/turf/open/floor/mainship,
/area/mainship/patrol_base/telecomms)
"lH" = (
/obj/machinery/telecomms/bus/preset_one/som,
/turf/open/floor/mainship,
/area/mainship/patrol_base/telecomms)
"lI" = (
/obj/machinery/telecomms/server/presets/yankee,
/turf/open/floor/mainship,
/area/mainship/patrol_base/telecomms)
"mm" = (
/obj/effect/landmark/start/job/som/squadleader,
/turf/open/floor/mainship,
/area/mainship/patrol_base/som)
"nm" = (
/obj/structure/table/mainship,
/turf/open/floor/mainship,
/area/mainship/patrol_base)
"pd" = (
/obj/machinery/light{
	dir = 1
	},
/turf/open/floor/mainship,
/area/mainship/patrol_base/som)
"qb" = (
/obj/machinery/telecomms/server/presets/charlie,
/turf/open/floor/mainship,
/area/mainship/patrol_base/telecomms)
"qe" = (
/obj/machinery/telecomms/bus/preset_one,
/turf/open/floor/mainship,
/area/mainship/patrol_base/telecomms)
"qo" = (
/obj/machinery/telecomms/server/presets/zulu,
/turf/open/floor/mainship,
/area/mainship/patrol_base/telecomms)
"qL" = (
/obj/machinery/telecomms/server/presets/delta,
/turf/open/floor/mainship,
/area/mainship/patrol_base/telecomms)
"rT" = (
/obj/machinery/telecomms/bus/preset_two,
/turf/open/floor/mainship,
/area/mainship/patrol_base/telecomms)
"sR" = (
/obj/structure/patrol_point{
	id = "SOM_14"
	},
/turf/open/floor/mainship,
/area/mainship/patrol_base/som)
"sX" = (
/obj/machinery/vending/marineFood,
/obj/item/reagent_containers/food/snacks/protein_pack,
/obj/item/reagent_containers/food/snacks/protein_pack,
/obj/item/reagent_containers/food/snacks/protein_pack,
/obj/item/reagent_containers/food/snacks/protein_pack,
/obj/item/reagent_containers/food/snacks/protein_pack,
/obj/item/reagent_containers/food/snacks/protein_pack,
/obj/item/reagent_containers/food/snacks/protein_pack,
/obj/item/reagent_containers/food/snacks/protein_pack,
/obj/item/reagent_containers/food/snacks/protein_pack,
/obj/item/reagent_containers/food/snacks/protein_pack,
/obj/item/reagent_containers/food/snacks/protein_pack,
/obj/item/reagent_containers/food/snacks/protein_pack,
/turf/open/floor/mainship,
/area/mainship/patrol_base)
"tq" = (
/obj/machinery/light{
	dir = 4
	},
/turf/open/floor/mainship,
/area/mainship/patrol_base)
"tz" = (
/obj/machinery/telecomms/bus/preset_three/som,
/turf/open/floor/mainship,
/area/mainship/patrol_base/telecomms)
"ud" = (
/obj/structure/patrol_point{
	id = "TGMC_21"
	},
/turf/open/floor/mainship,
/area/mainship/patrol_base)
"vL" = (
/obj/machinery/light{
	dir = 8
	},
/turf/open/floor/mainship,
/area/mainship/patrol_base)
"vW" = (
/obj/machinery/telecomms/server/presets/common/som,
/turf/open/floor/mainship,
/area/mainship/patrol_base/telecomms)
"wg" = (
/obj/machinery/telecomms/server/presets/common,
/turf/open/floor/mainship,
/area/mainship/patrol_base/telecomms)
"xt" = (
/obj/machinery/telecomms/server/presets/command,
/turf/open/floor/mainship,
/area/mainship/patrol_base/telecomms)
"yp" = (
/obj/structure/patrol_point{
	id = "TGMC_23"
	},
/turf/open/floor/mainship,
/area/mainship/patrol_base)
"yx" = (
/obj/machinery/vending/marineFood,
/obj/item/reagent_containers/food/snacks/protein_pack,
/obj/item/reagent_containers/food/snacks/protein_pack,
/obj/item/reagent_containers/food/snacks/protein_pack,
/obj/item/reagent_containers/food/snacks/protein_pack,
/obj/item/reagent_containers/food/snacks/protein_pack,
/obj/item/reagent_containers/food/snacks/protein_pack,
/obj/item/reagent_containers/food/snacks/protein_pack,
/obj/item/reagent_containers/food/snacks/protein_pack,
/obj/item/reagent_containers/food/snacks/protein_pack,
/obj/item/reagent_containers/food/snacks/protein_pack,
/obj/item/reagent_containers/food/snacks/protein_pack,
/turf/open/floor/mainship,
/area/mainship/patrol_base/som)
"yG" = (
/obj/effect/landmark/start/job/som/squadengineer,
/turf/open/floor/mainship,
/area/mainship/patrol_base/som)
"yS" = (
/obj/machinery/telecomms/bus/preset_three,
/turf/open/floor/mainship,
/area/mainship/patrol_base/telecomms)
"AD" = (
/obj/machinery/telecomms/bus/preset_four/som,
/turf/open/floor/mainship,
/area/mainship/patrol_base/telecomms)
"Bm" = (
/obj/machinery/telecomms/server/presets/engineering/som,
/turf/open/floor/mainship,
/area/mainship/patrol_base/telecomms)
"Bs" = (
/obj/structure/patrol_point{
	id = "TGMC_22"
	},
/turf/open/floor/mainship,
/area/mainship/patrol_base)
"BB" = (
/turf/closed/wall/r_wall/unmeltable,
/area/mainship/patrol_base)
"BD" = (
/obj/structure/patrol_point{
	id = "TGMC_11"
	},
/turf/open/floor/mainship,
/area/mainship/patrol_base)
"BI" = (
/obj/machinery/telecomms/server/presets/engineering,
/turf/open/floor/mainship,
/area/mainship/patrol_base/telecomms)
"Co" = (
/turf/open/space/basic{
	dir = 1
	},
/area/space)
"CM" = (
/obj/structure/patrol_point{
	id = "SOM_13"
	},
/turf/open/floor/mainship,
/area/mainship/patrol_base/som)
"CR" = (
/obj/machinery/telecomms/bus/preset_four,
/turf/open/floor/mainship,
/area/mainship/patrol_base/telecomms)
"De" = (
/obj/machinery/telecomms/processor/preset_one/som,
/turf/open/floor/mainship,
/area/mainship/patrol_base/telecomms)
"Dg" = (
/obj/structure/table/mainship,
/obj/item/tool/hand_labeler,
/turf/open/floor/mainship,
/area/mainship/patrol_base)
"Ee" = (
/obj/effect/landmark/start/job/squadcorpsman,
/turf/open/floor/mainship,
/area/mainship/patrol_base)
"Eo" = (
/obj/machinery/light{
	dir = 1
	},
/turf/open/floor/mainship,
/area/mainship/patrol_base)
"Er" = (
/obj/structure/table/mainship,
/obj/item/tool/hand_labeler,
/turf/open/floor/mainship,
/area/mainship/patrol_base/som)
"Fm" = (
/obj/machinery/telecomms/server/presets/medical/som,
/turf/open/floor/mainship,
/area/mainship/patrol_base/telecomms)
"Fw" = (
/obj/structure/patrol_point{
	id = "TGMC_12"
	},
/turf/open/floor/mainship,
/area/mainship/patrol_base)
"Fz" = (
/obj/machinery/telecomms/server/presets/medical,
/turf/open/floor/mainship,
/area/mainship/patrol_base/telecomms)
"FP" = (
/obj/machinery/telecomms/processor/preset_one,
/turf/open/floor/mainship,
/area/mainship/patrol_base/telecomms)
"GM" = (
/obj/machinery/telecomms/processor/preset_two/som,
/turf/open/floor/mainship,
/area/mainship/patrol_base/telecomms)
"HI" = (
/obj/machinery/telecomms/broadcaster/preset_left/som,
/turf/open/floor/mainship,
/area/mainship/patrol_base/telecomms)
"Ic" = (
/obj/machinery/telecomms/broadcaster/preset_left,
/turf/open/floor/mainship,
/area/mainship/patrol_base/telecomms)
"If" = (
/obj/effect/landmark/start/job/som/squadstandard,
/turf/open/floor/mainship,
/area/mainship/patrol_base/som)
"Iu" = (
/obj/machinery/telecomms/processor/preset_two,
/turf/open/floor/mainship,
/area/mainship/patrol_base/telecomms)
"IC" = (
/obj/structure/patrol_point{
	id = "SOM_12"
	},
/turf/open/floor/mainship,
/area/mainship/patrol_base/som)
"Jw" = (
/obj/machinery/telecomms/processor/preset_three/som,
/turf/open/floor/mainship,
/area/mainship/patrol_base/telecomms)
"JF" = (
/obj/machinery/telecomms/receiver/preset_left/som,
/turf/open/floor/mainship,
/area/mainship/patrol_base/telecomms)
"JY" = (
/obj/structure/table/mainship,
/obj/item/facepaint/green,
/turf/open/floor/mainship,
/area/mainship/patrol_base)
"Kz" = (
/obj/machinery/quick_vendor,
/turf/open/floor/mainship,
/area/mainship/patrol_base)
"KF" = (
/obj/machinery/telecomms/receiver/preset_left,
/turf/open/floor/mainship,
/area/mainship/patrol_base/telecomms)
"KI" = (
/obj/machinery/telecomms/processor/preset_three,
/turf/open/floor/mainship,
/area/mainship/patrol_base/telecomms)
"KR" = (
/obj/machinery/telecomms/processor/preset_four/som,
/turf/open/floor/mainship,
/area/mainship/patrol_base/telecomms)
"Lz" = (
/obj/machinery/telecomms/receiver/preset_right/som,
/turf/open/floor/mainship,
/area/mainship/patrol_base/telecomms)
"Mq" = (
/obj/machinery/telecomms/receiver/preset_right,
/turf/open/floor/mainship,
/area/mainship/patrol_base/telecomms)
"Mr" = (
/obj/structure/patrol_point{
	id = "SOM_11"
	},
/turf/open/floor/mainship,
/area/mainship/patrol_base/som)
"MB" = (
/turf/open/floor/mainship,
/area/mainship/patrol_base/telecomms)
"NF" = (
/obj/machinery/telecomms/processor/preset_four,
/turf/open/floor/mainship,
/area/mainship/patrol_base/telecomms)
"NT" = (
/obj/machinery/vending/marineFood,
/obj/item/reagent_containers/food/snacks/protein_pack,
/obj/item/reagent_containers/food/snacks/protein_pack,
/obj/item/reagent_containers/food/snacks/protein_pack,
/obj/item/reagent_containers/food/snacks/protein_pack,
/obj/item/reagent_containers/food/snacks/protein_pack,
/obj/item/reagent_containers/food/snacks/protein_pack,
/obj/item/reagent_containers/food/snacks/protein_pack,
/obj/item/reagent_containers/food/snacks/protein_pack,
/obj/item/reagent_containers/food/snacks/protein_pack,
/obj/item/reagent_containers/food/snacks/protein_pack,
/turf/open/floor/mainship,
/area/mainship/patrol_base)
"Ox" = (
/obj/effect/landmark/start/job/som/squadveteran,
/turf/open/floor/mainship,
/area/mainship/patrol_base/som)
"OM" = (
/obj/effect/landmark/start/job/squadsmartgunner,
/turf/open/floor/mainship,
/area/mainship/patrol_base)
"PQ" = (
/obj/structure/patrol_point{
	id = "SOM_21"
	},
/turf/open/floor/mainship,
/area/mainship/patrol_base/som)
"Qr" = (
/obj/structure/patrol_point{
	id = "SOM_24"
	},
/turf/open/floor/mainship,
/area/mainship/patrol_base/som)
"Rq" = (
/obj/machinery/light{
	dir = 8
	},
/obj/effect/landmark/start/job/som/squadengineer,
/turf/open/floor/mainship,
/area/mainship/patrol_base/som)
"RY" = (
/obj/machinery/telecomms/server/presets/command/som,
/turf/open/floor/mainship,
/area/mainship/patrol_base/telecomms)
"Sg" = (
/obj/effect/landmark/start/latejoinsom,
/turf/open/floor/mainship,
/area/mainship/patrol_base/som)
"Sw" = (
/turf/open/space/basic,
/area/space)
"Sy" = (
/obj/machinery/light{
	dir = 4
	},
/obj/effect/landmark/start/job/som/squadcorpsman,
/turf/open/floor/mainship,
/area/mainship/patrol_base/som)
"TS" = (
/obj/machinery/vending/marineFood,
/obj/item/reagent_containers/food/snacks/protein_pack,
/obj/item/reagent_containers/food/snacks/protein_pack,
/obj/item/reagent_containers/food/snacks/protein_pack,
/obj/item/reagent_containers/food/snacks/protein_pack,
/obj/item/reagent_containers/food/snacks/protein_pack,
/obj/item/reagent_containers/food/snacks/protein_pack,
/obj/item/reagent_containers/food/snacks/protein_pack,
/obj/item/reagent_containers/food/snacks/protein_pack,
/obj/item/reagent_containers/food/snacks/protein_pack,
/obj/item/reagent_containers/food/snacks/protein_pack,
/turf/open/floor/mainship,
/area/mainship/patrol_base/som)
"UL" = (
/obj/machinery/light,
/turf/open/floor/mainship,
/area/mainship/patrol_base/som)
"Vu" = (
/obj/machinery/door/poddoor/timed_late/containment,
/turf/open/floor/mainship,
/area/mainship/patrol_base)
"Vz" = (
/obj/machinery/vending/marineFood,
/obj/item/reagent_containers/food/snacks/protein_pack,
/obj/item/reagent_containers/food/snacks/protein_pack,
/obj/item/reagent_containers/food/snacks/protein_pack,
/obj/item/reagent_containers/food/snacks/protein_pack,
/obj/item/reagent_containers/food/snacks/protein_pack,
/obj/item/reagent_containers/food/snacks/protein_pack,
/obj/item/reagent_containers/food/snacks/protein_pack,
/obj/item/reagent_containers/food/snacks/protein_pack,
/obj/item/reagent_containers/food/snacks/protein_pack,
/obj/item/reagent_containers/food/snacks/protein_pack,
/obj/item/reagent_containers/food/snacks/protein_pack,
/turf/open/floor/mainship,
/area/mainship/patrol_base)
"VE" = (
/obj/machinery/vending/marineFood,
/obj/item/reagent_containers/food/snacks/protein_pack,
/obj/item/reagent_containers/food/snacks/protein_pack,
/obj/item/reagent_containers/food/snacks/protein_pack,
/obj/item/reagent_containers/food/snacks/protein_pack,
/obj/item/reagent_containers/food/snacks/protein_pack,
/obj/item/reagent_containers/food/snacks/protein_pack,
/obj/item/reagent_containers/food/snacks/protein_pack,
/obj/item/reagent_containers/food/snacks/protein_pack,
/obj/item/reagent_containers/food/snacks/protein_pack,
/obj/item/reagent_containers/food/snacks/protein_pack,
/obj/item/reagent_containers/food/snacks/protein_pack,
/obj/item/reagent_containers/food/snacks/protein_pack,
/turf/open/floor/mainship,
/area/mainship/patrol_base/som)
"VI" = (
/obj/effect/landmark/start/job/som/squadcorpsman,
/turf/open/floor/mainship,
/area/mainship/patrol_base/som)
"VY" = (
/turf/open/floor/mainship,
/area/mainship/patrol_base/som)
"Wv" = (
/obj/machinery/quick_vendor/som,
/turf/open/floor/mainship,
/area/mainship/patrol_base/som)
"WN" = (
/obj/effect/landmark/start/job/squadengineer,
/turf/open/floor/mainship,
/area/mainship/patrol_base)
"Xe" = (
/obj/structure/patrol_point{
	id = "SOM_23"
	},
/turf/open/floor/mainship,
/area/mainship/patrol_base/som)
"XE" = (
/obj/effect/landmark/start/job/squadleader,
/turf/open/floor/mainship,
/area/mainship/patrol_base)
"XH" = (
/obj/machinery/light{
	dir = 8
	},
/turf/open/floor/mainship,
/area/mainship/patrol_base/som)
"XJ" = (
/obj/effect/landmark/start/latejoin,
/turf/open/floor/mainship,
/area/mainship/patrol_base)
"YY" = (
/obj/machinery/light{
	dir = 4
	},
/turf/open/floor/mainship,
/area/mainship/patrol_base/som)
"ZD" = (
/turf/open/floor/mainship,
/area/mainship/patrol_base)

(1,1,1) = {"
Sw
Sw
Sw
Sw
Sw
Sw
Sw
Sw
Sw
Sw
Sw
Sw
Sw
Sw
Sw
Sw
Sw
Sw
Sw
Sw
Sw
Sw
Sw
Sw
Sw
Sw
Sw
Sw
Sw
Sw
Sw
Sw
Sw
Sw
Sw
Sw
Sw
Sw
Sw
Sw
ir
ir
ir
ir
ir
ir
ir
ir
ir
ir
ir
ir
ir
ir
ir
ir
ir
ir
ir
ir
"}
(2,1,1) = {"
Sw
Sw
Sw
Sw
Sw
Sw
Sw
Sw
Sw
Sw
Sw
Sw
Sw
Sw
Sw
Sw
Sw
Sw
Sw
Sw
Sw
Sw
Sw
Sw
Sw
Sw
Sw
Sw
Sw
Sw
Sw
Sw
Sw
Sw
Sw
Sw
Sw
Sw
Sw
Sw
ir
VY
fL
VY
Rq
yG
yG
yG
VY
dv
TS
VY
VY
VY
XH
VY
VY
VY
VY
ir
"}
(3,1,1) = {"
Sw
Sw
Sw
Sw
Sw
Sw
Sw
Sw
Sw
Sw
Sw
Sw
Sw
Sw
Sw
Sw
Sw
Sw
Sw
Sw
Sw
Sw
Sw
Sw
Sw
Sw
Sw
Sw
Sw
Sw
Sw
Sw
Sw
Sw
Sw
Sw
Sw
Sw
Sw
Sw
ir
VY
fL
VY
yG
yG
yG
yG
VY
dv
TS
VY
VY
VY
VY
VY
VY
VY
VY
ir
"}
(4,1,1) = {"
Sw
Sw
Sw
Sw
Sw
Sw
Sw
Sw
Sw
Sw
Sw
Sw
Sw
Sw
Sw
Sw
Sw
Sw
Sw
Sw
Sw
Sw
Sw
Sw
Sw
Sw
Sw
Sw
Sw
Sw
Sw
Sw
Sw
Sw
Sw
Sw
Sw
Sw
Sw
Sw
ir
pd
fL
VY
VY
VY
VY
VY
UL
dv
pd
VY
VY
Wv
Wv
VY
Wv
Wv
UL
ir
"}
(5,1,1) = {"
Sw
Sw
Sw
Sw
Sw
Sw
Sw
Sw
Sw
Sw
Sw
Sw
Sw
Sw
Sw
Sw
Sw
Sw
Sw
Sw
Sw
Sw
Sw
Sw
Sw
Sw
Sw
Sw
Sw
Sw
Sw
Sw
Sw
Sw
Sw
Sw
Sw
Sw
Sw
Sw
ir
Mr
fL
VY
If
If
If
If
VY
VY
VY
VY
VY
VY
VY
VY
VY
VY
VY
ir
"}
(6,1,1) = {"
Sw
Sw
Sw
Sw
Sw
Sw
Sw
Sw
Sw
Sw
Sw
Sw
Sw
Sw
Sw
Sw
Sw
Sw
Sw
Sw
Sw
Sw
Sw
Sw
Sw
Sw
Sw
Sw
Sw
Sw
Sw
Sw
Sw
Sw
Sw
Sw
Sw
Sw
Sw
Sw
ir
IC
fL
VY
If
If
If
If
VY
VY
VY
VY
VY
VY
VY
VY
VY
VY
VY
ir
"}
(7,1,1) = {"
Sw
Sw
Sw
Sw
Sw
Sw
Sw
Sw
Sw
Sw
Sw
Sw
Sw
Sw
Sw
Sw
Sw
Sw
Sw
Sw
Sw
Sw
Sw
Sw
Sw
Sw
Sw
Sw
Sw
Sw
Sw
Sw
Sw
Sw
Sw
Sw
Sw
Sw
Sw
Sw
ir
CM
fL
VY
If
If
If
If
VY
VY
VY
VY
VY
VY
VY
VY
VY
VY
VY
ir
"}
(8,1,1) = {"
Sw
Sw
Sw
Sw
Sw
Sw
Sw
Sw
Sw
Sw
Sw
Sw
Sw
Sw
Sw
Sw
Sw
Sw
Sw
Sw
Sw
Sw
Sw
Sw
Sw
Sw
Sw
Sw
Sw
Sw
Sw
Sw
Sw
Sw
Co
Sw
Sw
Sw
Sw
Sw
ir
sR
fL
VY
Sg
Sg
Sg
Sg
VY
VY
VY
VY
VY
Wv
Wv
VY
Wv
Wv
VY
ir
"}
(9,1,1) = {"
Sw
Sw
Sw
Sw
Sw
Sw
Sw
Sw
Sw
Sw
Sw
Sw
Sw
Sw
Sw
Sw
Sw
Sw
Sw
Sw
Sw
Sw
Sw
Sw
Sw
Sw
Sw
Sw
Sw
Sw
Sw
Sw
Sw
Sw
Sw
Sw
Sw
Sw
Sw
Sw
ir
pd
fL
VY
VY
VY
VY
VY
VY
VY
VY
VY
VY
VY
VY
VY
VY
VY
UL
ir
"}
(10,1,1) = {"
Sw
Sw
Sw
Sw
Sw
Sw
Sw
Sw
Sw
Sw
Sw
Sw
Sw
Sw
Sw
Sw
Sw
Sw
Sw
Sw
Sw
Sw
Sw
Sw
Sw
Sw
Sw
Sw
Sw
Sw
Sw
Sw
Sw
Sw
Sw
Sw
Sw
Sw
Sw
Sw
ir
VY
fL
VY
mm
VY
Ox
Ox
UL
dv
pd
VY
VY
VY
VY
VY
VY
VY
VY
ir
"}
(11,1,1) = {"
Sw
Sw
Sw
Sw
Sw
Sw
Sw
Sw
Sw
Sw
Sw
Sw
Sw
Sw
Sw
Sw
Sw
Sw
Sw
Sw
Sw
Sw
Sw
Sw
Sw
Sw
Sw
Sw
Sw
Sw
Sw
Sw
Sw
Sw
Sw
Sw
Sw
Sw
Sw
Sw
ir
VY
fL
VY
mm
VY
Ox
Ox
VY
dv
yx
VY
VY
cv
cv
VY
Er
ik
VY
ir
"}
(12,1,1) = {"
Sw
Sw
Sw
Sw
Sw
Sw
Sw
Sw
Sw
Sw
Sw
Sw
Sw
Sw
Sw
Sw
Sw
Sw
Sw
Sw
Sw
Sw
Sw
Sw
Sw
Sw
Sw
Sw
Sw
Sw
Sw
Sw
Sw
Sw
Sw
Sw
Sw
Sw
Sw
Sw
ir
VY
fL
VY
mm
VY
Ox
Ox
VY
dv
yx
VY
VY
Er
ik
VY
cv
cv
VY
ir
"}
(13,1,1) = {"
Sw
Sw
Sw
Sw
Sw
Sw
Sw
Sw
Sw
Sw
Sw
Sw
Sw
Sw
Sw
Sw
Sw
Sw
Sw
Sw
Sw
Sw
Sw
Sw
Sw
Sw
Sw
Sw
Sw
Sw
Sw
Sw
Sw
Sw
Sw
Sw
Sw
Sw
Sw
Sw
ir
VY
fL
VY
mm
VY
Ox
Ox
UL
dv
pd
VY
VY
VY
VY
VY
VY
VY
VY
ir
"}
(14,1,1) = {"
Sw
Sw
Sw
Sw
Sw
Sw
Sw
Sw
Sw
Sw
Sw
Sw
Sw
Sw
Sw
Sw
Sw
Sw
Sw
Sw
Sw
Sw
Sw
Sw
Sw
Sw
Sw
Sw
Sw
Sw
Sw
Sw
Sw
Sw
Sw
Sw
Sw
Sw
Sw
Sw
ir
pd
fL
VY
VY
VY
VY
VY
VY
VY
VY
VY
VY
VY
VY
VY
VY
VY
UL
ir
"}
(15,1,1) = {"
Sw
Sw
Sw
Sw
Sw
Sw
Sw
Sw
Sw
Sw
Sw
Sw
Sw
Sw
Sw
Sw
Sw
Sw
Sw
Sw
Sw
Sw
Sw
Sw
Sw
Sw
Sw
Sw
Sw
Sw
Sw
Sw
Sw
Sw
Sw
Sw
Sw
Sw
Sw
Sw
ir
PQ
fL
VY
Sg
Sg
Sg
Sg
VY
VY
VY
VY
VY
Wv
Wv
VY
Wv
Wv
VY
ir
"}
(16,1,1) = {"
Sw
Sw
Sw
Sw
Sw
Sw
Sw
Sw
Sw
Sw
Sw
Sw
Sw
Sw
Sw
Sw
Sw
Sw
Sw
Sw
Sw
Sw
Sw
Sw
Sw
Sw
Sw
Sw
Sw
Sw
Sw
Sw
Sw
Sw
Sw
Sw
Sw
Sw
Sw
Sw
ir
cU
fL
VY
If
If
If
If
VY
VY
VY
VY
VY
VY
VY
VY
VY
VY
VY
ir
"}
(17,1,1) = {"
Sw
Sw
Sw
Sw
Sw
Sw
Sw
Sw
Sw
Sw
Sw
Sw
Sw
Sw
Sw
Sw
Sw
Sw
Sw
Sw
Sw
Sw
Sw
Sw
Sw
Sw
Sw
Sw
Sw
Sw
Sw
Sw
Sw
Sw
Sw
Sw
Sw
Sw
Sw
Sw
ir
Xe
fL
VY
If
If
If
If
VY
VY
VY
VY
VY
VY
VY
VY
VY
VY
VY
ir
"}
(18,1,1) = {"
Sw
Sw
Sw
Sw
Sw
Sw
Sw
Sw
Sw
Sw
Sw
Sw
Sw
Sw
Sw
Sw
Sw
Sw
Sw
Sw
Sw
Sw
Sw
Sw
Sw
Sw
Sw
Sw
Sw
Sw
Sw
Sw
Sw
Sw
Sw
Sw
Sw
Sw
Sw
Sw
ir
Qr
fL
VY
If
If
If
If
VY
VY
VY
VY
VY
VY
VY
VY
VY
VY
VY
ir
"}
(19,1,1) = {"
Sw
Sw
Sw
Sw
Sw
Sw
Sw
Sw
Sw
Sw
Sw
Sw
Sw
Sw
Sw
Sw
Sw
Sw
Sw
Sw
Sw
Sw
Sw
Sw
Sw
Sw
Sw
Sw
Sw
Sw
Sw
Sw
Sw
Sw
Sw
Sw
Sw
Sw
Sw
Sw
ir
pd
fL
VY
VY
VY
VY
VY
UL
dv
pd
VY
VY
Wv
Wv
VY
Wv
Wv
UL
ir
"}
(20,1,1) = {"
Sw
Sw
Sw
Sw
Sw
Sw
Sw
Sw
Sw
Sw
Sw
Sw
Sw
Sw
Sw
Sw
Sw
Sw
Sw
Sw
Sw
Sw
Sw
Sw
Sw
Sw
Sw
Sw
Sw
Sw
Sw
Sw
Sw
Sw
Sw
Sw
Sw
Sw
Sw
Sw
ir
VY
fL
VY
VI
VI
VI
VI
VY
dv
yx
VY
VY
VY
VY
VY
VY
VY
VY
ir
"}
(21,1,1) = {"
Sw
Sw
Sw
Sw
Sw
Sw
Sw
Sw
Sw
Sw
Sw
Sw
Sw
Sw
Sw
Sw
Sw
Sw
Sw
Sw
Sw
Sw
Sw
Sw
Sw
Sw
Sw
Sw
Sw
Sw
Sw
Sw
Sw
Sw
Sw
Sw
Sw
Sw
Sw
Sw
ir
VY
fL
VY
Sy
VI
VI
VI
VY
dv
VE
VY
VY
VY
YY
VY
VY
VY
VY
ir
"}
(22,1,1) = {"
Sw
Sw
Sw
Sw
Sw
Sw
Sw
Sw
Sw
Sw
Sw
Sw
Sw
Sw
Sw
Sw
Sw
Sw
Sw
Sw
Sw
Sw
Sw
Sw
Sw
Sw
Sw
Sw
Sw
Sw
Sw
Sw
Sw
Sw
Sw
Sw
Sw
Sw
Sw
Sw
ir
ir
ir
ir
ir
ir
ir
ir
ir
ir
ir
ir
ir
ir
ir
ir
ir
ir
ir
ir
"}
(23,1,1) = {"
bg
bg
bg
bg
bg
bg
bg
bg
bg
bg
bg
bg
Sw
Sw
Sw
Sw
Sw
Sw
Sw
Sw
Sw
Sw
Sw
Sw
Sw
Sw
Sw
Sw
Sw
Sw
Sw
Sw
Sw
Sw
Sw
Sw
Sw
Sw
Sw
Sw
Sw
Sw
Sw
Sw
Sw
Sw
Sw
Sw
Sw
Sw
Sw
Sw
Sw
Sw
Sw
Sw
Sw
Sw
Sw
Sw
"}
(24,1,1) = {"
bg
MB
go
lH
MB
tz
AD
De
GM
Jw
KR
bg
Sw
Sw
Sw
Sw
Sw
Sw
Sw
Sw
Sw
Sw
Sw
Sw
Sw
Sw
Sw
Sw
Sw
Sw
Sw
Sw
Sw
Sw
Sw
Sw
Sw
Sw
Sw
Sw
Sw
Sw
Sw
Sw
Sw
Sw
Sw
Sw
Sw
Sw
Sw
Sw
Sw
Sw
Sw
Sw
Sw
Sw
Sw
Sw
"}
(25,1,1) = {"
bg
MB
MB
MB
MB
MB
MB
MB
MB
MB
MB
bg
Sw
Sw
Sw
Sw
Sw
Sw
Sw
Sw
Sw
Sw
Sw
Sw
Sw
Sw
Sw
Sw
Sw
Sw
Sw
Sw
Sw
Sw
Sw
Sw
Sw
Sw
Sw
Sw
Sw
Sw
Sw
Sw
Sw
Sw
Sw
Sw
Sw
Sw
Sw
Sw
Sw
Sw
Sw
Sw
Sw
Sw
Sw
Sw
"}
(26,1,1) = {"
bg
MB
MB
MB
MB
MB
MB
MB
MB
MB
MB
bg
Sw
Sw
Sw
Sw
Sw
Sw
Sw
Sw
Sw
Sw
Sw
Sw
Sw
Sw
Sw
Sw
Sw
Sw
Sw
Sw
Sw
Sw
Sw
Sw
Sw
Sw
Sw
Sw
Sw
Sw
Sw
Sw
Sw
Sw
Sw
Sw
Sw
Sw
Sw
Sw
Sw
Sw
Sw
Sw
Sw
Sw
Sw
Sw
"}
(27,1,1) = {"
bg
RY
MB
MB
MB
MB
MB
MB
MB
MB
MB
bg
Sw
Sw
Sw
Sw
Sw
Sw
Sw
Sw
Sw
Sw
Sw
Sw
Sw
Sw
Sw
Sw
Sw
Sw
Sw
Sw
Sw
Sw
Sw
Sw
Sw
Sw
Sw
Sw
Sw
Sw
Sw
Sw
Sw
Sw
Sw
Sw
Sw
Sw
Sw
Sw
Sw
Sw
Sw
Sw
Sw
Sw
Sw
Sw
"}
(28,1,1) = {"
bg
MB
MB
MB
MB
MB
MB
MB
MB
MB
MB
bg
Sw
Sw
Sw
Sw
Sw
Sw
Sw
Sw
Sw
Sw
Sw
Sw
Sw
Sw
Sw
Sw
Sw
Sw
Sw
Sw
Sw
Sw
Sw
Sw
Sw
Sw
Sw
Sw
Sw
Sw
Sw
Sw
Sw
Sw
Sw
Sw
Sw
Sw
Sw
Sw
Sw
Sw
Sw
Sw
Sw
Sw
Sw
Sw
"}
(29,1,1) = {"
bg
dP
jw
lI
qo
vW
Bm
Fm
HI
JF
Lz
bg
Sw
Sw
Sw
Sw
Sw
Sw
Sw
Sw
Sw
Sw
Sw
Sw
Sw
Sw
Sw
Sw
Sw
Sw
Sw
Sw
Sw
Sw
Sw
Sw
Sw
Sw
Sw
Sw
Sw
Sw
Sw
Sw
Sw
Sw
Sw
Sw
Sw
Sw
Sw
Sw
Sw
Sw
Sw
Sw
Sw
Sw
Sw
Sw
"}
(30,1,1) = {"
bg
bg
bg
bg
bg
bg
bg
bg
bg
bg
bg
bg
Sw
Sw
Sw
Sw
Sw
Sw
Sw
Sw
Sw
Sw
Sw
Sw
Sw
Sw
Sw
Sw
Sw
Sw
Sw
Sw
Sw
Sw
Sw
Sw
Sw
Sw
Sw
Sw
Sw
Sw
Sw
Sw
Sw
Sw
Sw
Sw
Sw
Sw
Sw
Sw
Sw
Sw
Sw
Sw
Sw
Sw
Sw
Sw
"}
(31,1,1) = {"
bg
fM
jG
qb
qL
wg
BI
Fz
Ic
KF
Mq
bg
Sw
Sw
Sw
Sw
Sw
Sw
Sw
Sw
Sw
Sw
Sw
Sw
Sw
Sw
Sw
Sw
Sw
Sw
Sw
Sw
Sw
Sw
Sw
Sw
Sw
Sw
Sw
Sw
Sw
Sw
Sw
Sw
Sw
Sw
Sw
Sw
Sw
Sw
Sw
Sw
Sw
Sw
Sw
Sw
Sw
Sw
Sw
Sw
"}
(32,1,1) = {"
bg
MB
MB
MB
MB
MB
MB
MB
MB
MB
MB
bg
Sw
Sw
Sw
Sw
Sw
Sw
Sw
Sw
Sw
Sw
Sw
Sw
Sw
Sw
Sw
Sw
Sw
Sw
Sw
Sw
Sw
Sw
Sw
Sw
Sw
Sw
Sw
Sw
Sw
Sw
Sw
Sw
Sw
Sw
Sw
Sw
Sw
Sw
Sw
Sw
Sw
Sw
Sw
Sw
Sw
Sw
Sw
Sw
"}
(33,1,1) = {"
bg
xt
MB
MB
MB
MB
MB
MB
MB
MB
MB
bg
Sw
Sw
Sw
Sw
Sw
Sw
Sw
Sw
Sw
Sw
Sw
Sw
Sw
Sw
Sw
Sw
Sw
Sw
Sw
Sw
Sw
Sw
Sw
Sw
Sw
Sw
Sw
Sw
Sw
Sw
Sw
Sw
Sw
Sw
Sw
Sw
Sw
Sw
Sw
Sw
Sw
Sw
Sw
Sw
Sw
Sw
Sw
Sw
"}
(34,1,1) = {"
bg
MB
MB
MB
MB
MB
MB
MB
MB
MB
MB
bg
Sw
Sw
Sw
Sw
Sw
Sw
Sw
Sw
Sw
Sw
Sw
Sw
Sw
Sw
Sw
Sw
Sw
Sw
Sw
Sw
Sw
Sw
Sw
Sw
Sw
Sw
Sw
Sw
Sw
Sw
Sw
Sw
Sw
Sw
Sw
Sw
Sw
Sw
Sw
Sw
Sw
Sw
Sw
Sw
Sw
Sw
Sw
Sw
"}
(35,1,1) = {"
bg
MB
MB
MB
MB
MB
MB
MB
MB
MB
MB
bg
Sw
Sw
Sw
Sw
Sw
Sw
Sw
Sw
Sw
Sw
Sw
Sw
Sw
Sw
Sw
Sw
Sw
Sw
Sw
Sw
Sw
Sw
Sw
Sw
Sw
Sw
Sw
Sw
Sw
Sw
Sw
Sw
Sw
Sw
Sw
Sw
Sw
Sw
Sw
Sw
Sw
Sw
Sw
Sw
Sw
Sw
Sw
Sw
"}
(36,1,1) = {"
bg
fT
lu
qe
rT
yS
CR
FP
Iu
KI
NF
bg
Sw
Sw
Sw
Sw
Sw
Sw
Sw
Sw
Sw
Sw
Sw
Sw
Sw
Sw
Sw
Sw
Sw
Sw
Sw
Sw
Sw
Sw
Sw
Sw
Sw
Sw
Sw
Sw
Sw
Sw
Sw
Sw
Sw
Sw
Sw
Sw
Sw
Sw
Sw
Sw
Sw
Sw
Sw
Sw
Sw
Sw
Sw
Sw
"}
(37,1,1) = {"
bg
bg
bg
bg
bg
bg
bg
bg
bg
bg
bg
bg
Sw
Sw
Sw
Sw
Sw
Sw
Sw
Sw
Sw
Sw
Sw
Sw
Sw
Sw
Sw
Sw
Sw
Sw
Sw
Sw
Sw
Sw
Sw
Sw
Sw
Sw
Sw
Sw
Sw
Sw
Sw
Sw
Sw
Sw
Sw
Sw
Sw
Sw
Sw
Sw
Sw
Sw
Sw
Sw
Sw
Sw
Sw
Sw
"}
(38,1,1) = {"
Sw
Sw
Sw
Sw
Sw
Sw
Sw
Sw
Sw
Sw
Sw
Sw
Sw
Sw
Sw
Sw
Sw
Sw
Sw
Sw
Sw
Sw
Sw
Sw
Sw
Sw
Sw
Sw
Sw
Sw
Sw
Sw
Sw
Sw
Sw
Sw
Sw
Sw
Sw
Sw
Sw
Sw
Sw
Sw
Sw
Sw
Sw
Sw
Sw
Sw
Sw
Sw
Sw
Sw
Sw
Sw
Sw
Sw
Sw
Sw
"}
(39,1,1) = {"
Sw
Sw
Sw
Sw
Sw
Sw
Sw
Sw
Sw
Sw
Sw
Sw
Sw
Sw
Sw
Sw
Sw
Sw
Sw
Sw
Sw
Sw
Sw
Sw
Sw
Sw
Sw
Sw
Sw
Sw
Sw
Sw
Sw
Sw
Sw
Sw
Sw
Sw
Sw
Sw
BB
BB
BB
BB
BB
BB
BB
BB
BB
BB
BB
BB
BB
BB
BB
BB
BB
BB
BB
BB
"}
(40,1,1) = {"
Sw
Sw
Sw
Sw
Sw
Sw
Sw
Sw
Sw
Sw
Sw
Sw
Sw
Sw
Sw
Sw
Sw
Sw
Sw
Sw
Sw
Sw
Sw
Sw
Sw
Sw
Sw
Sw
Sw
Sw
Sw
Sw
Sw
Sw
Sw
Sw
Sw
Sw
Sw
Sw
BB
ZD
Vu
ZD
bX
WN
WN
WN
ZD
dJ
NT
ZD
ZD
ZD
vL
ZD
ZD
ZD
ZD
BB
"}
(41,1,1) = {"
Sw
Sw
Sw
Sw
Sw
Sw
Sw
Sw
Sw
Sw
Sw
Sw
Sw
Sw
Sw
Sw
Sw
Sw
Sw
Sw
Sw
Sw
Sw
Sw
Sw
Sw
Sw
Sw
Sw
Sw
Sw
Sw
Sw
Sw
Sw
Sw
Sw
Sw
Sw
Sw
BB
ZD
Vu
ZD
WN
WN
WN
WN
ZD
dJ
NT
ZD
ZD
ZD
ZD
ZD
ZD
ZD
ZD
BB
"}
(42,1,1) = {"
Sw
Sw
Sw
Sw
Sw
Sw
Sw
Sw
Sw
Sw
Sw
Sw
Sw
Sw
Sw
Sw
Sw
Sw
Sw
Sw
Sw
Sw
Sw
Sw
Sw
Sw
Sw
Sw
Sw
Sw
Sw
Sw
Sw
Sw
Sw
Sw
Sw
Sw
Sw
Sw
BB
Eo
Vu
ZD
ZD
ZD
ZD
ZD
gk
dJ
Eo
ZD
ZD
Kz
Kz
ZD
Kz
Kz
gk
BB
"}
(43,1,1) = {"
Sw
Sw
Sw
Sw
Sw
Sw
Sw
Sw
Sw
Sw
Sw
Sw
Sw
Sw
Sw
Sw
Sw
Sw
Sw
Sw
Sw
Sw
Sw
Sw
Sw
Sw
Sw
Sw
Sw
Sw
Sw
Sw
Sw
Sw
Sw
Sw
Sw
Sw
Sw
Sw
BB
BD
Vu
ZD
bz
bz
bz
bz
ZD
ZD
ZD
ZD
ZD
ZD
ZD
ZD
ZD
ZD
ZD
BB
"}
(44,1,1) = {"
Sw
Sw
Sw
Sw
Sw
Sw
Sw
Sw
Sw
Sw
Sw
Sw
Sw
Sw
Sw
Sw
Sw
Sw
Sw
Sw
Sw
Sw
Sw
Sw
Sw
Sw
Sw
Sw
Sw
Sw
Sw
Sw
Sw
Sw
Sw
Sw
Sw
Sw
Sw
Sw
BB
Fw
Vu
ZD
bz
bz
bz
bz
ZD
ZD
ZD
ZD
ZD
ZD
ZD
ZD
ZD
ZD
ZD
BB
"}
(45,1,1) = {"
Sw
Sw
Sw
Sw
Sw
Sw
Sw
Sw
Sw
Sw
Sw
Sw
Sw
Sw
Sw
Sw
Sw
Sw
Sw
Sw
Sw
Sw
Sw
Sw
Sw
Sw
Sw
Sw
Sw
Sw
Sw
Sw
Sw
Sw
Sw
Sw
Sw
Sw
Sw
Sw
BB
ch
Vu
ZD
bz
bz
bz
bz
ZD
ZD
ZD
ZD
ZD
ZD
ZD
ZD
ZD
ZD
ZD
BB
"}
(46,1,1) = {"
Sw
Sw
Sw
Sw
Sw
Sw
Sw
Sw
Sw
Sw
Sw
Sw
Sw
Sw
Sw
Sw
Sw
Sw
Sw
Sw
Sw
Sw
Sw
Sw
Sw
Sw
Sw
Sw
Sw
Sw
Sw
Sw
Sw
Sw
Sw
Sw
Sw
Sw
Sw
Sw
BB
jp
Vu
ZD
XJ
XJ
XJ
XJ
ZD
ZD
ZD
ZD
ZD
Kz
Kz
ZD
Kz
Kz
ZD
BB
"}
(47,1,1) = {"
Sw
Sw
Sw
Sw
Sw
Sw
Sw
Sw
Sw
Sw
Sw
Sw
Sw
Sw
Sw
Sw
Sw
Sw
Sw
Sw
Sw
Sw
Sw
Sw
Sw
Sw
Sw
Sw
Sw
Sw
Sw
Sw
Sw
Sw
Sw
Sw
Sw
Sw
Sw
Sw
BB
Eo
Vu
ZD
ZD
ZD
ZD
ZD
ZD
ZD
ZD
ZD
ZD
ZD
ZD
ZD
ZD
ZD
gk
BB
"}
(48,1,1) = {"
Sw
Sw
Sw
Sw
Sw
Sw
Sw
Sw
Sw
Sw
Sw
Sw
Sw
Sw
Sw
Sw
Sw
Sw
Sw
Sw
Sw
Sw
Sw
Sw
Sw
Sw
Sw
Sw
Sw
Sw
Sw
Sw
Sw
Sw
Sw
Sw
Sw
Sw
Sw
Sw
BB
ZD
Vu
ZD
XE
ZD
ZD
OM
gk
dJ
Eo
ZD
ZD
ZD
ZD
ZD
ZD
ZD
ZD
BB
"}
(49,1,1) = {"
Sw
Sw
Sw
Sw
Sw
Sw
Sw
Sw
Sw
Sw
Sw
Sw
Sw
Sw
Sw
Sw
Sw
Sw
Sw
Sw
Sw
Sw
Sw
Sw
Sw
Sw
Sw
Sw
Sw
Sw
Sw
Sw
Sw
Sw
Sw
Sw
Sw
Sw
Sw
Sw
BB
ZD
Vu
ZD
XE
ZD
ZD
OM
ZD
dJ
Vz
ZD
ZD
JY
JY
ZD
Dg
nm
ZD
BB
"}
(50,1,1) = {"
Sw
Sw
Sw
Sw
Sw
Sw
Sw
Sw
Sw
Sw
Sw
Sw
Sw
Sw
Sw
Sw
Sw
Sw
Sw
Sw
Sw
Sw
Sw
Sw
Sw
Sw
Sw
Sw
Sw
Sw
Sw
Sw
Sw
Sw
Sw
Sw
Sw
Sw
Sw
Sw
BB
ZD
Vu
ZD
XE
ZD
ZD
OM
ZD
dJ
Vz
ZD
ZD
Dg
nm
ZD
JY
JY
ZD
BB
"}
(51,1,1) = {"
Sw
Sw
Sw
Sw
Sw
Sw
Sw
Sw
Sw
Sw
Sw
Sw
Sw
Sw
Sw
Sw
Sw
Sw
Sw
Sw
Sw
Sw
Sw
Sw
Sw
Sw
Sw
Sw
Sw
Sw
Sw
Sw
Sw
Sw
Sw
Sw
Sw
Sw
Sw
Sw
BB
ZD
Vu
ZD
XE
ZD
ZD
OM
gk
dJ
Eo
ZD
ZD
ZD
ZD
ZD
ZD
ZD
ZD
BB
"}
(52,1,1) = {"
Sw
Sw
Sw
Sw
Sw
Sw
Sw
Sw
Sw
Sw
Sw
Sw
Sw
Sw
Sw
Sw
Sw
Sw
Sw
Sw
Sw
Sw
Sw
Sw
Sw
Sw
Sw
Sw
Sw
Sw
Sw
Sw
Sw
Sw
Sw
Sw
Sw
Sw
Sw
Sw
BB
Eo
Vu
ZD
ZD
ZD
ZD
ZD
ZD
ZD
ZD
ZD
ZD
ZD
ZD
ZD
ZD
ZD
gk
BB
"}
(53,1,1) = {"
Sw
Sw
Sw
Sw
Sw
Sw
Sw
Sw
Sw
Sw
Sw
Sw
Sw
Sw
Sw
Sw
Sw
Sw
Sw
Sw
Sw
Sw
Sw
Sw
Sw
Sw
Sw
Sw
Sw
Sw
Sw
Sw
Sw
Sw
Sw
Sw
Sw
Sw
Sw
Sw
BB
ud
Vu
ZD
XJ
XJ
XJ
XJ
ZD
ZD
ZD
ZD
ZD
Kz
Kz
ZD
Kz
Kz
ZD
BB
"}
(54,1,1) = {"
Sw
Sw
Sw
Sw
Sw
Sw
Sw
Sw
Sw
Sw
Sw
Sw
Sw
Sw
Sw
Sw
Sw
Sw
Sw
Sw
Sw
Sw
Sw
Sw
Sw
Sw
Sw
Sw
Sw
Sw
Sw
Sw
Sw
Sw
Sw
Sw
Sw
Sw
Sw
Sw
BB
Bs
Vu
ZD
bz
bz
bz
bz
ZD
ZD
ZD
ZD
ZD
ZD
ZD
ZD
ZD
ZD
ZD
BB
"}
(55,1,1) = {"
Sw
Sw
Sw
Sw
Sw
Sw
Sw
Sw
Sw
Sw
Sw
Sw
Sw
Sw
Sw
Sw
Sw
Sw
Sw
Sw
Sw
Sw
Sw
Sw
Sw
Sw
Sw
Sw
Sw
Sw
Sw
Sw
Sw
Sw
Sw
Sw
Sw
Sw
Sw
Sw
BB
yp
Vu
ZD
bz
bz
bz
bz
ZD
ZD
ZD
ZD
ZD
ZD
ZD
ZD
ZD
ZD
ZD
BB
"}
(56,1,1) = {"
Sw
Sw
Sw
Sw
Sw
Sw
Sw
Sw
Sw
Sw
Sw
Sw
Sw
Sw
Sw
Sw
Sw
Sw
Sw
Sw
Sw
Sw
Sw
Sw
Sw
Sw
Sw
Sw
Sw
Sw
Sw
Sw
Sw
Sw
Sw
Sw
Sw
Sw
Sw
Sw
BB
aL
Vu
ZD
bz
bz
bz
bz
ZD
ZD
ZD
ZD
ZD
ZD
ZD
ZD
ZD
ZD
ZD
BB
"}
(57,1,1) = {"
Sw
Sw
Sw
Sw
Sw
Sw
Sw
Sw
Sw
Sw
Sw
Sw
Sw
Sw
Sw
Sw
Sw
Sw
Sw
Sw
Sw
Sw
Sw
Sw
Sw
Sw
Sw
Sw
Sw
Sw
Sw
Sw
Sw
Sw
Sw
Sw
Sw
Sw
Sw
Sw
BB
Eo
Vu
ZD
ZD
ZD
ZD
ZD
gk
dJ
Eo
ZD
ZD
Kz
Kz
ZD
Kz
Kz
gk
BB
"}
(58,1,1) = {"
Sw
Sw
Sw
Sw
Sw
Sw
Sw
Sw
Sw
Sw
Sw
Sw
Sw
Sw
Sw
Sw
Sw
Sw
Sw
Sw
Sw
Sw
Sw
Sw
Sw
Sw
Sw
Sw
Sw
Sw
Sw
Sw
Sw
Sw
Sw
Sw
Sw
Sw
Sw
Sw
BB
ZD
Vu
ZD
Ee
Ee
Ee
Ee
ZD
dJ
Vz
ZD
ZD
ZD
ZD
ZD
ZD
ZD
ZD
BB
"}
(59,1,1) = {"
Sw
Sw
Sw
Sw
Sw
Sw
Sw
Sw
Sw
Sw
Sw
Sw
Sw
Sw
Sw
Sw
Sw
Sw
Sw
Sw
Sw
Sw
Sw
Sw
Sw
Sw
Sw
Sw
Sw
Sw
Sw
Sw
Sw
Sw
Sw
Sw
Sw
Sw
Sw
Sw
BB
ZD
Vu
ZD
al
Ee
Ee
Ee
ZD
dJ
sX
ZD
ZD
ZD
tq
ZD
ZD
ZD
ZD
BB
"}
(60,1,1) = {"
Sw
Sw
Sw
Sw
Sw
Sw
Sw
Sw
Sw
Sw
Sw
Sw
Sw
Sw
Sw
Sw
Sw
Sw
Sw
Sw
Sw
Sw
Sw
Sw
Sw
Sw
Sw
Sw
Sw
Sw
Sw
Sw
Sw
Sw
Sw
Sw
Sw
Sw
Sw
Sw
BB
BB
BB
BB
BB
BB
BB
BB
BB
BB
BB
BB
BB
BB
BB
BB
BB
BB
BB
BB
"}
