//MAP CONVERTED BY dmm2tgm.py THIS HEADER COMMENT PREVENTS RECONVERSION, DO NOT REMOVE
"aa" = (
/obj/structure/dropship_piece/one/front/left,
/turf/template_noop,
/area/shuttle/dropship/alamo)
"ab" = (
/obj/structure/dropship_piece/one/front,
/turf/template_noop,
/area/shuttle/dropship/alamo)
"ac" = (
/obj/machinery/door/poddoor/shutters/transit{
	dir = 8
	},
/obj/machinery/door/airlock/dropship_hatch/left,
/turf/open/shuttle/dropship/floor,
/area/shuttle/dropship/alamo)
"ad" = (
/obj/structure/dropship_piece/one/front/right,
/turf/template_noop,
/area/shuttle/dropship/alamo)
"ae" = (
/obj/structure/dropship_piece/one/cockpit/left,
/turf/template_noop,
/area/shuttle/dropship/alamo)
"af" = (
/turf/closed/shuttle/dropship1/window,
/area/shuttle/dropship/alamo)
"ag" = (
/turf/closed/shuttle/dropship1/window{
	dir = 1
	},
/area/shuttle/dropship/alamo)
"ah" = (
/turf/closed/shuttle/dropship1/window{
	dir = 8
	},
/area/shuttle/dropship/alamo)
"ai" = (
/obj/structure/dropship_piece/one/cockpit/right,
/turf/template_noop,
/area/shuttle/dropship/alamo)
"aj" = (
/turf/closed/shuttle/dropship1/cornersalt{
	dir = 4
	},
/area/shuttle/dropship/alamo)
"ak" = (
/obj/machinery/computer/security/dropship/one,
/turf/closed/shuttle/dropship1/panel,
/area/shuttle/dropship/alamo)
"al" = (
/turf/open/shuttle/dropship/floor,
/area/shuttle/dropship/alamo)
"am" = (
/obj/machinery/computer/dropship_weapons/dropship1,
/turf/closed/shuttle/dropship1/panel{
	dir = 4
	},
/area/shuttle/dropship/alamo)
"an" = (
/turf/closed/shuttle/dropship1/cornersalt{
	dir = 8
	},
/area/shuttle/dropship/alamo)
"ao" = (
/turf/template_noop,
/area/template_noop)
"ap" = (
/obj/effect/attach_point/weapon/dropship1{
	dir = 1
	},
/obj/structure/dropship_piece/one/weapon/leftleft,
/turf/template_noop,
/area/shuttle/dropship/alamo)
"aq" = (
/obj/effect/attach_point/electronics/dropship1{
	dir = 1
	},
/obj/structure/dropship_piece/one/weapon/leftright,
/turf/template_noop,
/area/shuttle/dropship/alamo)
"ar" = (
/turf/closed/shuttle/dropship1/interiorwindow,
/area/shuttle/dropship/alamo)
"as" = (
/obj/structure/bed/chair/dropship/pilot{
	dir = 1
	},
/obj/machinery/light,
/turf/open/shuttle/dropship/floor,
/area/shuttle/dropship/alamo)
"at" = (
/obj/item/radio/intercom/dropship{
	pixel_x = 21;
	pixel_y = 16
	},
/turf/open/shuttle/dropship/floor,
/area/shuttle/dropship/alamo)
"au" = (
/obj/structure/bed/chair/dropship/pilot{
	dir = 1
	},
/obj/machinery/camera/autoname/mainship/dropship_one{
	pixel_x = -6;
	pixel_y = -16
	},
/turf/open/shuttle/dropship/floor,
/area/shuttle/dropship/alamo)
"av" = (
/turf/closed/shuttle/dropship1/interiorwindow{
	dir = 1
	},
/area/shuttle/dropship/alamo)
"aw" = (
/obj/effect/attach_point/electronics/dropship1{
	dir = 1
	},
/obj/structure/dropship_piece/one/weapon/rightleft,
/turf/template_noop,
/area/shuttle/dropship/alamo)
"ax" = (
/obj/effect/attach_point/weapon/dropship1{
	dir = 1
	},
/obj/structure/dropship_piece/one/weapon/rightright,
/turf/template_noop,
/area/shuttle/dropship/alamo)
"ay" = (
/turf/closed/shuttle/dropship1/cornersalt2,
/area/shuttle/dropship/alamo)
"aB" = (
/turf/closed/shuttle/dropship1/interiormisc{
	dir = 4
	},
/area/shuttle/dropship/alamo)
"aC" = (
/obj/machinery/door/airlock/hatch/cockpit,
/turf/open/shuttle/dropship/floor,
/area/shuttle/dropship/alamo)
"aD" = (
/turf/closed/shuttle/dropship1/interiormisc{
	dir = 8
	},
/area/shuttle/dropship/alamo)
"aE" = (
/turf/closed/shuttle/dropship1/edge,
/area/shuttle/dropship/alamo)
"aF" = (
/turf/closed/shuttle/dropship1/cornersalt2{
	dir = 1
	},
/area/shuttle/dropship/alamo)
"aG" = (
/obj/structure/dropship_piece/one/wing/left/top,
/turf/template_noop,
/area/shuttle/dropship/alamo)
"aH" = (
/turf/closed/shuttle/dropship1/finleft{
	dir = 4
	},
/area/shuttle/dropship/alamo)
"aI" = (
/obj/structure/bed/chair/dropship/passenger{
	dir = 4
	},
/turf/open/shuttle/dropship/floor,
/area/shuttle/dropship/alamo)
"aJ" = (
/obj/item/radio/intercom/dropship,
/turf/open/shuttle/dropship/six,
/area/shuttle/dropship/alamo)
"aK" = (
/turf/open/shuttle/dropship/five,
/area/shuttle/dropship/alamo)
"aM" = (
/obj/item/radio/intercom/dropship,
/turf/open/shuttle/dropship/seven,
/area/shuttle/dropship/alamo)
"aN" = (
/obj/structure/bed/chair/dropship/passenger{
	dir = 8
	},
/turf/open/shuttle/dropship/floor,
/area/shuttle/dropship/alamo)
"aO" = (
/turf/closed/shuttle/dropship1/finright{
	dir = 4
	},
/area/shuttle/dropship/alamo)
"aP" = (
/obj/structure/dropship_piece/one/wing/right/top,
/turf/template_noop,
/area/shuttle/dropship/alamo)
"aQ" = (
/turf/closed/shuttle/dropship1/finleft{
	dir = 8
	},
/area/shuttle/dropship/alamo)
"aR" = (
/turf/closed/shuttle/dropship1/finleft{
	dir = 1
	},
/area/shuttle/dropship/alamo)
"aS" = (
/turf/open/shuttle/dropship/three,
/area/shuttle/dropship/alamo)
"aT" = (
/turf/closed/shuttle/dropship1/aisle,
/area/shuttle/dropship/alamo)
"aU" = (
/obj/structure/bed/chair/dropship/passenger{
	dir = 8
	},
/obj/machinery/camera/autoname/mainship/dropship_one{
	dir = 8;
	pixel_x = 16
	},
/turf/open/shuttle/dropship/floor,
/area/shuttle/dropship/alamo)
"aV" = (
/turf/closed/shuttle/dropship1/finright{
	dir = 1
	},
/area/shuttle/dropship/alamo)
"aW" = (
/turf/closed/shuttle/dropship1/finright{
	dir = 8
	},
/area/shuttle/dropship/alamo)
"aX" = (
/obj/effect/attach_point/weapon/dropship1{
	dir = 8;
	},
/obj/structure/dropship_piece/one/wing/left/bottom,
/turf/template_noop,
/area/shuttle/dropship/alamo)
"aY" = (
/turf/closed/shuttle/dropship1/finleft,
/area/shuttle/dropship/alamo)
"aZ" = (
/turf/closed/shuttle/dropship1/aisle{
	dir = 4
	},
/area/shuttle/dropship/alamo)
"ba" = (
/turf/closed/shuttle/dropship1/finright,
/area/shuttle/dropship/alamo)
"bb" = (
/obj/effect/attach_point/weapon/dropship1{
	dir = 4;
	},
/obj/structure/dropship_piece/one/wing/right/bottom,
/turf/template_noop,
/area/shuttle/dropship/alamo)
"bc" = (
/obj/machinery/door/poddoor/shutters/transit,
/obj/machinery/door/airlock/dropship_hatch/right,
/turf/open/shuttle/dropship/floor,
/area/shuttle/dropship/alamo)
"bd" = (
/obj/structure/bed/chair/dropship/passenger{
	dir = 8
	},
/obj/machinery/vending/nanomed{
	dir = 8
	},
/turf/open/shuttle/dropship/floor,
/area/shuttle/dropship/alamo)
"be" = (
/obj/structure/bed/chair/dropship/passenger{
	dir = 4
	},
/obj/machinery/vending/nanomed{
	dir = 4
	},
/turf/open/shuttle/dropship/floor,
/area/shuttle/dropship/alamo)
"bg" = (
/obj/docking_port/mobile/marine_dropship/one,
/turf/closed/shuttle/dropship1/aisle{
	dir = 4
	},
/area/shuttle/dropship/alamo)
"bi" = (
/turf/closed/shuttle/dropship1/edge{
	dir = 4
	},
/area/shuttle/dropship/alamo)
"bj" = (
/obj/structure/bed/chair/dropship/passenger{
	dir = 8
	},
/obj/machinery/light{
	dir = 4
	},
/turf/open/shuttle/dropship/floor,
/area/shuttle/dropship/alamo)
"bk" = (
/turf/closed/shuttle/dropship1/aisle{
	dir = 8
	},
/area/shuttle/dropship/alamo)
"bl" = (
/obj/structure/bed/chair/dropship/passenger{
	dir = 4
	},
/obj/machinery/light{
	dir = 8
	},
/turf/open/shuttle/dropship/floor,
/area/shuttle/dropship/alamo)
"bm" = (
/turf/closed/shuttle/dropship1/edge{
	dir = 8
	},
/area/shuttle/dropship/alamo)
"bn" = (
/obj/machinery/telecomms/relay/preset/telecomms/onboard,
/turf/closed/shuttle/dropship1/aisle{
	dir = 4
	},
/area/shuttle/dropship/alamo)
"bo" = (
/turf/open/shuttle/dropship/four,
/area/shuttle/dropship/alamo)
"bp" = (
/obj/item/radio/intercom/dropship,
/obj/machinery/holopad,
/turf/open/shuttle/dropship/five,
/area/shuttle/dropship/alamo)
"bq" = (
/turf/open/shuttle/dropship/eight,
/area/shuttle/dropship/alamo)
"br" = (
/turf/closed/shuttle/dropship1/cornersalt,
/area/shuttle/dropship/alamo)
"bs" = (
/obj/structure/dropship_piece/one/corner/middleright,
/turf/template_noop,
/area/shuttle/dropship/alamo)
"bt" = (
/obj/structure/dropship_piece/one/corner/middleleft,
/turf/template_noop,
/area/shuttle/dropship/alamo)
"bu" = (
/turf/closed/shuttle/dropship1/edge/alt{
	dir = 1
	},
/area/shuttle/dropship/alamo)
"bv" = (
/turf/closed/shuttle/dropship1/cornersalt{
	dir = 1
	},
/area/shuttle/dropship/alamo)
"bw" = (
/obj/structure/bed/chair/dropship/passenger,
/turf/open/shuttle/dropship/floor,
/area/shuttle/dropship/alamo)
"bx" = (
/obj/structure/bed/chair/dropship/passenger{
	dir = 4
	},
/obj/machinery/camera/autoname/mainship/dropship_one{
	dir = 4;
	pixel_x = -16
	},
/obj/machinery/vending/nanomed{
	dir = 4
	},
/turf/open/shuttle/dropship/floor,
/area/shuttle/dropship/alamo)
"by" = (
/turf/closed/shuttle/dropship1/edge/alt,
/area/shuttle/dropship/alamo)
"bD" = (
/obj/structure/bed/chair/dropship/passenger{
	dir = 4
	},
/obj/machinery/camera/autoname/mainship/dropship_one{
	dir = 4;
	pixel_x = -16
	},
/turf/open/shuttle/dropship/floor,
/area/shuttle/dropship/alamo)
"bE" = (
/obj/structure/dropship_piece/one/engine/lefttop,
/turf/template_noop,
/area/shuttle/dropship/alamo)
"bF" = (
/obj/structure/dropship_piece/one/engine/righttop,
/turf/template_noop,
/area/shuttle/dropship/alamo)
"bG" = (
/turf/closed/shuttle/dropship1/enginefour,
/area/shuttle/dropship/alamo)
"bH" = (
/turf/closed/shuttle/dropship1/enginefour{
	dir = 1
	},
/area/shuttle/dropship/alamo)
"bI" = (
/obj/effect/attach_point/crew_weapon/dropship1,
/turf/open/shuttle/dropship/floor,
/area/shuttle/dropship/alamo)
"bJ" = (
/turf/closed/shuttle/dropship1/wall,
/area/shuttle/dropship/alamo)
"bK" = (
/turf/closed/shuttle/dropship1/enginefour{
	dir = 4
	},
/area/shuttle/dropship/alamo)
"bL" = (
/turf/closed/shuttle/dropship1/enginefour{
	dir = 8
	},
/area/shuttle/dropship/alamo)
"bM" = (
/turf/closed/shuttle/dropship1/enginethree,
/area/shuttle/dropship/alamo)
"bN" = (
/turf/closed/shuttle/dropship1/enginethree{
	dir = 1
	},
/area/shuttle/dropship/alamo)
"bO" = (
/turf/closed/shuttle/dropship1/wall{
	dir = 4
	},
/area/shuttle/dropship/alamo)
"bP" = (
/turf/closed/shuttle/dropship1/wall{
	dir = 8
	},
/area/shuttle/dropship/alamo)
"bQ" = (
/turf/closed/shuttle/dropship1/enginethree{
	dir = 8
	},
/area/shuttle/dropship/alamo)
"bR" = (
/turf/closed/shuttle/dropship1/enginethree{
	dir = 4
	},
/area/shuttle/dropship/alamo)
"bS" = (
/turf/closed/shuttle/dropship1/enginetwo,
/area/shuttle/dropship/alamo)
"bT" = (
/turf/closed/shuttle/dropship1/enginetwo{
	dir = 1
	},
/area/shuttle/dropship/alamo)
"bW" = (
/obj/structure/dropship_piece/one/corner/rearleft,
/turf/template_noop,
/area/shuttle/dropship/alamo)
"bX" = (
/turf/closed/shuttle/dropship1/interiormisc,
/area/shuttle/dropship/alamo)
"bY" = (
/obj/machinery/door/airlock/multi_tile/mainship/dropshiprear/ds1,
/obj/machinery/door/poddoor/shutters/transit{
	dir = 1
	},
/turf/open/shuttle/dropship/floor,
/area/shuttle/dropship/alamo)
"bZ" = (
/obj/machinery/door/poddoor/shutters/transit{
	dir = 1
	},
/turf/open/shuttle/dropship/floor,
/area/shuttle/dropship/alamo)
"ca" = (
/turf/closed/shuttle/dropship1/interiormisc{
	dir = 1
	},
/area/shuttle/dropship/alamo)
"cb" = (
/obj/structure/dropship_piece/one/corner/rearright,
/turf/template_noop,
/area/shuttle/dropship/alamo)
"cc" = (
/obj/structure/dropship_piece/one/rearwing/lefttop,
/turf/template_noop,
/area/shuttle/dropship/alamo)
"cd" = (
/obj/structure/dropship_piece/one/rearwing/righttop,
/turf/template_noop,
/area/shuttle/dropship/alamo)
"ce" = (
/obj/structure/dropship_piece/one/rearwing/leftllbottom,
/turf/template_noop,
/area/shuttle/dropship/alamo)
"cf" = (
/obj/structure/dropship_piece/one/rearwing/leftlbottom,
/turf/template_noop,
/area/shuttle/dropship/alamo)
"cg" = (
/obj/structure/dropship_piece/one/rearwing/leftbottom,
/turf/template_noop,
/area/shuttle/dropship/alamo)
"ci" = (
/obj/structure/dropship_piece/one/rearwing/rightbottom,
/turf/template_noop,
/area/shuttle/dropship/alamo)
"cj" = (
/obj/structure/dropship_piece/one/rearwing/rightrbottom,
/turf/template_noop,
/area/shuttle/dropship/alamo)
"ck" = (
/obj/structure/dropship_piece/one/rearwing/rightrrbottom,
/turf/template_noop,
/area/shuttle/dropship/alamo)
"dS" = (
/turf/closed/shuttle/dropship1/enginetwo{
	dir = 4
	},
/area/shuttle/dropship/alamo)
"gB" = (
/turf/closed/shuttle/dropship1/edge/alt{
	dir = 4
	},
/area/shuttle/dropship/alamo)
"iV" = (
/obj/structure/bed/chair/dropship/passenger{
	dir = 4
	},
/obj/structure/closet/walllocker/hydrant/extinguisher{
	dir = 4
	},
/turf/open/shuttle/dropship/floor,
/area/shuttle/dropship/alamo)
"vw" = (
/obj/structure/dropship_piece/one/engine/leftbottom,
/turf/template_noop,
/area/shuttle/dropship/alamo)
"yA" = (
/obj/structure/bed/chair/dropship/passenger{
	dir = 8
	},
/obj/structure/closet/walllocker/hydrant/extinguisher{
	dir = 8
	},
/turf/open/shuttle/dropship/floor,
/area/shuttle/dropship/alamo)
"Dp" = (
/turf/open/shuttle/dropship/ten,
/area/shuttle/dropship/alamo)
"FA" = (
/turf/closed/shuttle/dropship1/enginetwo{
	dir = 8
	},
/area/shuttle/dropship/alamo)
"Ki" = (
/obj/machinery/computer/shuttle/marine_dropship/one,
/turf/closed/shuttle/dropship1/panel{
	dir = 1
	},
/area/shuttle/dropship/alamo)
"QK" = (
/obj/structure/dropship_piece/one/engine/rightbottom,
/turf/template_noop,
/area/shuttle/dropship/alamo)
"Zx" = (
/turf/closed/shuttle/dropship1/wall{
	dir = 1
	},
/area/shuttle/dropship/alamo)

(1,1,1) = {"
ao
ao
ao
ao
ao
aG
aQ
aX
ao
ao
ao
ao
ao
ao
bE
bG
bM
bS
vw
ao
ao
"}
(2,1,1) = {"
ao
ao
ao
ap
ay
aH
aR
aY
ac
ac
bu
bi
bu
bt
bF
bH
bN
bT
QK
ao
ce
"}
(3,1,1) = {"
ao
ao
ao
aq
aE
aI
bD
aI
al
al
aI
aI
aI
br
bu
bu
bO
bJ
bW
ao
cf
"}
(4,1,1) = {"
aa
ae
aj
ar
aE
aJ
aS
aS
aS
aS
aS
aS
bo
aI
bx
iV
bl
aI
bX
cc
cg
"}
(5,1,1) = {"
ab
af
ak
as
aB
aK
bj
aN
bd
yA
aN
bj
Dp
aS
aS
aS
aS
aS
bY
ao
ao
"}
(6,1,1) = {"
ab
ag
Ki
at
aC
aK
aT
bn
aZ
aZ
bg
bk
bp
bw
bI
al
al
al
bZ
ao
ao
"}
(7,1,1) = {"
ab
ah
am
au
aD
aK
bl
aI
be
iV
aI
bl
Dp
aS
aS
aS
aS
aS
bZ
ao
ao
"}
(8,1,1) = {"
ad
ai
an
av
aE
aM
aS
aS
aS
aS
aS
aS
bq
aN
bd
yA
bj
aN
ca
cd
ci
"}
(9,1,1) = {"
ao
ao
ao
aw
aE
aN
aU
aN
al
al
aN
aN
aN
bv
by
by
bP
Zx
cb
ao
cj
"}
(10,1,1) = {"
ao
ao
ao
ax
aF
aO
aV
ba
bc
bc
gB
bm
by
bs
bE
bK
bQ
dS
vw
ao
ck
"}
(11,1,1) = {"
ao
ao
ao
ao
ao
aP
aW
bb
ao
ao
ao
ao
ao
ao
bF
bL
bR
FA
QK
ao
ao
"}
