//MAP CONVERTED BY dmm2tgm.py THIS HEADER COMMENT PREVENTS RECONVERSION, DO NOT REMOVE
"a" = (
/turf/template_noop,
/area/template_noop)
"b" = (
/turf/closed/shuttle/dropship_regular/top_corner/alt{
	dir = 1
	},
/area/shuttle/ert)
"c" = (
/obj/docking_port/mobile/ert,
/turf/closed/shuttle/dropship_regular/cockpit_window,
/area/shuttle/ert)
"d" = (
/turf/closed/shuttle/dropship_regular/top_corner/alt,
/area/shuttle/ert)
"e" = (
/turf/closed/shuttle/dropship_regular/backwall,
/area/shuttle/ert)
"f" = (
/turf/closed/shuttle/dropship_regular/interior_corner,
/area/shuttle/ert)
"g" = (
/turf/open/shuttle/dropship/floor,
/area/shuttle/ert)
"h" = (
/turf/closed/shuttle/dropship_regular/interior_corner{
	dir = 1
	},
/area/shuttle/ert)
"i" = (
/turf/closed/shuttle/dropship_regular/interior_wall,
/area/shuttle/ert)
"j" = (
/obj/structure/rack,
/obj/effect/landmark/distress_item,
/obj/item/storage/toolbox/mechanical,
/obj/item/tool/multitool,
/turf/open/shuttle/dropship/floor,
/area/shuttle/ert)
"k" = (
/obj/machinery/light{
	dir = 1
	},
/turf/open/shuttle/dropship/six,
/area/shuttle/ert)
"l" = (
/turf/open/shuttle/dropship/five,
/area/shuttle/ert)
"m" = (
/obj/machinery/light{
	dir = 1
	},
/turf/open/shuttle/dropship/seven,
/area/shuttle/ert)
"n" = (
/obj/structure/rack,
/obj/effect/landmark/distress_item,
/obj/item/storage/firstaid/adv,
/turf/open/shuttle/dropship/floor,
/area/shuttle/ert)
"o" = (
/turf/closed/shuttle/dropship_regular/interior_wall{
	dir = 1
	},
/area/shuttle/ert)
"p" = (
/obj/machinery/door/poddoor/shutters/transit/open,
/obj/machinery/door/airlock/mainship/generic/ert,
/turf/open/shuttle/dropship/three,
/area/shuttle/ert)
"q" = (
/obj/effect/landmark/distress,
/turf/open/shuttle/dropship/three,
/area/shuttle/ert)
"r" = (
/obj/structure/bed/chair/dropship/passenger,
/obj/effect/landmark/distress,
/turf/open/shuttle/dropship/floor,
/area/shuttle/ert)
"s" = (
/obj/structure/bed/chair/dropship/passenger{
	dir = 4
	},
/obj/effect/landmark/distress,
/turf/open/shuttle/dropship/floor,
/area/shuttle/ert)
"t" = (
/obj/structure/bed/chair/dropship/passenger{
	dir = 8
	},
/obj/effect/landmark/distress,
/turf/open/shuttle/dropship/floor,
/area/shuttle/ert)
"u" = (
/obj/structure/rack,
/obj/effect/landmark/distress_item,
/obj/item/storage/firstaid/regular,
/obj/item/storage/belt/lifesaver/full,
/turf/open/shuttle/dropship/floor,
/area/shuttle/ert)
"v" = (
/obj/effect/ai_node,
/turf/open/shuttle/dropship/four,
/area/shuttle/ert)
"w" = (
/obj/effect/ai_node,
/turf/open/shuttle/dropship/eight,
/area/shuttle/ert)
"x" = (
/turf/closed/shuttle/dropship_regular/engine_corner,
/area/shuttle/ert)
"y" = (
/turf/closed/shuttle/dropship_regular/top_corner,
/area/shuttle/ert)
"z" = (
/turf/open/shuttle/dropship/three,
/area/shuttle/ert)
"A" = (
/turf/closed/shuttle/dropship_regular/top_corner{
	dir = 1
	},
/area/shuttle/ert)
"B" = (
/turf/closed/shuttle/dropship_regular/engine_corner{
	dir = 1
	},
/area/shuttle/ert)
"C" = (
/obj/machinery/computer/shuttle/ert,
/turf/open/shuttle/dropship/floor,
/area/shuttle/ert)
"D" = (
/obj/machinery/light{
	dir = 8
	},
/turf/open/shuttle/dropship/floor,
/area/shuttle/ert)
"E" = (
/obj/machinery/light{
	dir = 4
	},
/turf/open/shuttle/dropship/floor,
/area/shuttle/ert)
"G" = (
/turf/closed/shuttle/ert/engines/left/three{
	dir = 1
	},
/area/shuttle/ert)
"H" = (
/turf/closed/shuttle/dropship_regular/backhatch,
/area/shuttle/ert)
"I" = (
/obj/machinery/door/poddoor/shutters/transit/open{
	dir = 2
	},
/obj/machinery/door/airlock/mainship/generic/ert{
	dir = 2
	},
/turf/open/shuttle/dropship/floor,
/area/shuttle/ert)
"J" = (
/turf/closed/shuttle/dropship_regular/backhatch{
	dir = 1
	},
/area/shuttle/ert)
"K" = (
/turf/closed/shuttle/dropship_regular/backhatch{
	dir = 4
	},
/area/shuttle/ert)
"N" = (
/turf/closed/shuttle/ert/engines/right/three{
	dir = 1
	},
/area/shuttle/ert)
"O" = (
/turf/closed/shuttle/ert/engines/left{
	dir = 1
	},
/area/shuttle/ert)
"R" = (
/obj/structure/barricade/folding{
	dir = 4
	},
/obj/effect/mapping_helpers/barricade/closed,
/turf/open/shuttle/dropship/floor,
/area/shuttle/ert)
"S" = (
/turf/closed/shuttle/ert/engines/right{
	dir = 1
	},
/area/shuttle/ert)
"U" = (
/obj/structure/barricade/folding,
/obj/effect/mapping_helpers/barricade/closed,
/turf/open/shuttle/dropship/floor,
/area/shuttle/ert)
"V" = (
/obj/structure/bed/chair/dropship/passenger,
/obj/effect/landmark/distress,
/obj/effect/ai_node,
/turf/open/shuttle/dropship/floor,
/area/shuttle/ert)
"W" = (
/obj/structure/barricade/folding{
	dir = 8
	},
/obj/effect/mapping_helpers/barricade/closed,
/turf/open/shuttle/dropship/floor,
/area/shuttle/ert)
"X" = (
/turf/closed/shuttle/ert/engines/right/two{
	dir = 1
	},
/area/shuttle/ert)
"Y" = (
/turf/closed/shuttle/ert/engines/left/two{
	dir = 1
	},
/area/shuttle/ert)

(1,1,1) = {"
a
b
i
p
i
i
i
p
i
x
G
Y
O
"}
(2,1,1) = {"
a
e
j
W
s
s
s
W
u
y
i
i
H
"}
(3,1,1) = {"
b
f
k
q
q
q
q
q
v
g
D
U
I
"}
(4,1,1) = {"
c
C
l
V
r
r
r
V
l
z
z
z
J
"}
(5,1,1) = {"
d
h
m
q
q
q
q
q
w
g
E
U
I
"}
(6,1,1) = {"
a
e
n
R
t
t
t
R
u
A
o
o
K
"}
(7,1,1) = {"
a
d
o
p
o
o
o
p
o
B
N
X
S
"}
