//MAP CONVERTED BY dmm2tgm.py THIS HEADER COMMENT PREVENTS RECONVERSION, DO NOT REMOVE
"an" = (
/obj/structure/prop/holidays/string_lights/corner{
	dir = 8
	},
/turf/closed/shuttle/dropship_white/interior_wall{
	dir = 8
	},
/area/shuttle/ert/pmc)
"bb" = (
/obj/structure/prop/holidays/string_lights/corner{
	dir = 4
	},
/turf/closed/shuttle/dropship_white/interior_wall,
/area/shuttle/ert/pmc)
"bO" = (
/turf/template_noop,
/area/template_noop)
"ch" = (
/turf/closed/shuttle/ert/engines/left/three{
	dir = 1
	},
/area/shuttle/ert/pmc)
"cX" = (
/obj/structure/prop/holidays/string_lights{
	dir = 8
	},
/turf/closed/shuttle/dropship_white/logo_wall/three{
	dir = 1
	},
/area/shuttle/ert/pmc)
"es" = (
/obj/structure/prop/holidays/string_lights{
	dir = 8
	},
/turf/closed/shuttle/dropship_white/logo_wall{
	dir = 1
	},
/area/shuttle/ert/pmc)
"eA" = (
/obj/machinery/door/poddoor/shutters/transit/open,
/obj/machinery/door/airlock/mainship/generic/ert,
/turf/open/shuttle/dropship/three,
/area/shuttle/ert/pmc)
"eT" = (
/obj/machinery/light{
	dir = 1
	},
/turf/open/shuttle/dropship/six,
/area/shuttle/ert/pmc)
"fg" = (
/obj/structure/rack,
/obj/effect/landmark/distress_item,
/obj/item/storage/toolbox/mechanical,
/obj/item/tool/multitool,
/turf/open/shuttle/dropship/floor,
/area/shuttle/ert/pmc)
"fQ" = (
/turf/closed/shuttle/dropship_white/backhatch,
/area/shuttle/ert/pmc)
"gK" = (
/obj/structure/prop/holidays/string_lights{
	dir = 4
	},
/turf/closed/shuttle/dropship_white/logo_wall/three{
	dir = 4
	},
/area/shuttle/ert/pmc)
"jj" = (
/turf/closed/shuttle/ert/engines/right{
	dir = 1
	},
/area/shuttle/ert/pmc)
"kq" = (
/obj/structure/bed/chair/dropship/passenger{
	dir = 8
	},
/obj/effect/landmark/distress,
/turf/open/shuttle/dropship/floor,
/area/shuttle/ert/pmc)
"nh" = (
/obj/structure/prop/holidays/string_lights/corner,
/turf/closed/shuttle/dropship_white/top_corner/alt{
	dir = 1
	},
/area/shuttle/ert/pmc)
"on" = (
/turf/open/shuttle/dropship/five,
/area/shuttle/ert/pmc)
"oX" = (
/obj/machinery/light{
	dir = 8
	},
/turf/open/shuttle/dropship/floor,
/area/shuttle/ert/pmc)
"qg" = (
/turf/closed/shuttle/dropship_white/backhatch{
	dir = 1
	},
/area/shuttle/ert/pmc)
"rH" = (
/turf/closed/shuttle/dropship_white/backhatch{
	dir = 4
	},
/area/shuttle/ert/pmc)
"tq" = (
/turf/open/shuttle/dropship/three,
/area/shuttle/ert/pmc)
"tX" = (
/turf/open/shuttle/dropship/eight,
/area/shuttle/ert/pmc)
"uR" = (
/turf/closed/shuttle/ert/engines/left/two{
	dir = 1
	},
/area/shuttle/ert/pmc)
"wa" = (
/obj/effect/landmark/distress,
/turf/open/shuttle/dropship/three,
/area/shuttle/ert/pmc)
"wM" = (
/obj/structure/prop/holidays/string_lights{
	dir = 4
	},
/turf/closed/shuttle/dropship_white/logo_wall/two,
/area/shuttle/ert/pmc)
"wZ" = (
/turf/closed/shuttle/ert/engines/right/three{
	dir = 1
	},
/area/shuttle/ert/pmc)
"xe" = (
/obj/structure/rack,
/obj/effect/landmark/distress_item,
/obj/item/storage/firstaid/regular,
/obj/item/storage/belt/lifesaver/full,
/obj/structure/prop/holidays/string_lights{
	dir = 9
	},
/turf/open/shuttle/dropship/floor,
/area/shuttle/ert/pmc)
"xf" = (
/obj/machinery/door/poddoor/shutters/transit/open{
	dir = 2
	},
/obj/machinery/door/airlock/mainship/generic/ert{
	dir = 2
	},
/turf/open/shuttle/dropship/floor,
/area/shuttle/ert/pmc)
"xS" = (
/turf/closed/shuttle/ert/engines/right/two{
	dir = 1
	},
/area/shuttle/ert/pmc)
"xZ" = (
/turf/closed/shuttle/dropship_white/engine_corner,
/area/shuttle/ert/pmc)
"yD" = (
/obj/structure/prop/holidays/string_lights/corner{
	dir = 1
	},
/turf/closed/shuttle/dropship_white/top_corner/alt,
/area/shuttle/ert/pmc)
"zl" = (
/obj/machinery/light{
	dir = 1
	},
/turf/open/shuttle/dropship/seven,
/area/shuttle/ert/pmc)
"Be" = (
/obj/structure/bed/chair/dropship/passenger,
/obj/effect/landmark/distress,
/turf/open/shuttle/dropship/floor,
/area/shuttle/ert/pmc)
"DC" = (
/turf/closed/shuttle/ert/engines/left{
	dir = 1
	},
/area/shuttle/ert/pmc)
"ES" = (
/obj/structure/prop/holidays/string_lights{
	dir = 8
	},
/turf/closed/shuttle/dropship_white/interior_wall{
	dir = 8
	},
/area/shuttle/ert/pmc)
"Fu" = (
/obj/structure/prop/holidays/string_lights{
	dir = 4
	},
/turf/closed/shuttle/dropship_white/logo_wall,
/area/shuttle/ert/pmc)
"FY" = (
/obj/structure/prop/holidays/string_lights{
	dir = 10
	},
/turf/closed/shuttle/dropship_white/interior_corner{
	dir = 1
	},
/area/shuttle/ert/pmc)
"Hv" = (
/obj/structure/rack,
/obj/effect/landmark/distress_item,
/obj/item/storage/firstaid/regular,
/obj/item/storage/belt/lifesaver/full,
/obj/structure/prop/holidays/string_lights{
	dir = 5
	},
/turf/open/shuttle/dropship/floor,
/area/shuttle/ert/pmc)
"HU" = (
/obj/structure/prop/holidays/string_lights{
	dir = 6
	},
/turf/closed/shuttle/dropship_white/interior_corner,
/area/shuttle/ert/pmc)
"IE" = (
/obj/structure/rack,
/obj/effect/landmark/distress_item,
/obj/item/storage/firstaid/adv,
/turf/open/shuttle/dropship/floor,
/area/shuttle/ert/pmc)
"Ka" = (
/obj/structure/prop/holidays/string_lights{
	dir = 4
	},
/turf/closed/shuttle/dropship_white/top_corner,
/area/shuttle/ert/pmc)
"Mh" = (
/obj/structure/prop/holidays/string_lights{
	dir = 8
	},
/turf/closed/shuttle/dropship_white/logo_wall/two{
	dir = 8
	},
/area/shuttle/ert/pmc)
"Ni" = (
/turf/open/shuttle/dropship/four,
/area/shuttle/ert/pmc)
"NA" = (
/obj/machinery/light{
	dir = 4
	},
/turf/open/shuttle/dropship/floor,
/area/shuttle/ert/pmc)
"ND" = (
/obj/structure/prop/holidays/string_lights{
	dir = 4
	},
/turf/closed/shuttle/dropship_white/logo_wall/four,
/area/shuttle/ert/pmc)
"NQ" = (
/obj/docking_port/mobile/ert,
/obj/structure/prop/holidays/string_lights,
/turf/closed/shuttle/dropship_white/cockpit_window,
/area/shuttle/ert/pmc)
"Ru" = (
/obj/structure/prop/holidays/string_lights,
/turf/closed/shuttle/dropship_white/backwall,
/area/shuttle/ert/pmc)
"RK" = (
/obj/structure/prop/holidays/string_lights{
	dir = 4
	},
/turf/closed/shuttle/dropship_white/interior_wall,
/area/shuttle/ert/pmc)
"Ti" = (
/obj/structure/prop/holidays/string_lights{
	dir = 8
	},
/turf/closed/shuttle/dropship_white/top_corner{
	dir = 1
	},
/area/shuttle/ert/pmc)
"Wq" = (
/turf/closed/shuttle/dropship_white/engine_corner{
	dir = 1
	},
/area/shuttle/ert/pmc)
"Wx" = (
/obj/machinery/computer/shuttle/ert,
/turf/open/shuttle/dropship/floor,
/area/shuttle/ert/pmc)
"Xi" = (
/obj/structure/bed/chair/dropship/passenger{
	dir = 4
	},
/obj/effect/landmark/distress,
/turf/open/shuttle/dropship/floor,
/area/shuttle/ert/pmc)
"XN" = (
/obj/structure/prop/holidays/string_lights{
	dir = 8
	},
/turf/closed/shuttle/dropship_white/logo_wall/four{
	dir = 1
	},
/area/shuttle/ert/pmc)
"Yg" = (
/obj/structure/prop/holidays/string_lights{
	dir = 1
	},
/turf/open/shuttle/dropship/three,
/area/shuttle/ert/pmc)
"ZU" = (
/turf/open/shuttle/dropship/floor,
/area/shuttle/ert/pmc)

(1,1,1) = {"
bO
nh
ND
eA
gK
wM
Fu
eA
bb
Wq
ch
uR
DC
"}
(2,1,1) = {"
bO
Ru
fg
ZU
Xi
Xi
Xi
ZU
Hv
Ka
RK
bb
fQ
"}
(3,1,1) = {"
nh
HU
eT
wa
wa
wa
wa
wa
Ni
ZU
oX
ZU
xf
"}
(4,1,1) = {"
NQ
Wx
on
Be
Be
Be
Be
Be
on
tq
tq
Yg
qg
"}
(5,1,1) = {"
yD
FY
zl
wa
wa
wa
wa
wa
tX
ZU
NA
ZU
xf
"}
(6,1,1) = {"
bO
Ru
IE
ZU
kq
kq
kq
ZU
xe
Ti
ES
an
rH
"}
(7,1,1) = {"
bO
yD
XN
eA
cX
Mh
es
eA
an
xZ
wZ
xS
jj
"}
