//MAP CONVERTED BY dmm2tgm.py THIS HEADER COMMENT PREVENTS RECONVERSION, DO NOT REMOVE
"aD" = (
/obj/structure/prop/holidays/string_lights{
	dir = 8
	},
/turf/closed/shuttle/ert{
	icon_state = "nt5"
	},
/area/shuttle/ert/pmc)
"aV" = (
/obj/machinery/light{
	dir = 4
	},
/turf/open/shuttle/dropship/floor,
/area/shuttle/ert/pmc)
"bL" = (
/obj/structure/prop/holidays/string_lights{
	dir = 4
	},
/turf/closed/shuttle/ert{
	icon_state = "nt8"
	},
/area/shuttle/ert/pmc)
"cy" = (
/turf/closed/shuttle/ert{
	icon_state = "nt1"
	},
/area/shuttle/ert/pmc)
"dH" = (
/obj/structure/prop/holidays/string_lights/corner{
	dir = 4
	},
/turf/closed/shuttle/ert{
	icon_state = "nt4"
	},
/area/shuttle/ert/pmc)
"eo" = (
/obj/structure/prop/holidays/string_lights{
	dir = 8
	},
/turf/closed/shuttle/ert{
	icon_state = "nt17"
	},
/area/shuttle/ert/pmc)
"gk" = (
/turf/open/shuttle/dropship{
	icon_state = "rasputin4"
	},
/area/shuttle/ert/pmc)
"hD" = (
/turf/open/shuttle/dropship/three,
/area/shuttle/ert/pmc)
"jA" = (
/turf/open/shuttle/dropship/eight,
/area/shuttle/ert/pmc)
"kc" = (
/turf/closed/shuttle/ert{
	icon_state = "rightengine_2";
	opacity = 0
	},
/area/shuttle/ert/pmc)
"le" = (
/obj/structure/prop/holidays/string_lights{
	dir = 4
	},
/turf/closed/shuttle/ert{
	icon_state = "nt12"
	},
/area/shuttle/ert/pmc)
"oN" = (
/obj/structure/prop/holidays/string_lights{
	dir = 4
	},
/turf/closed/shuttle/ert{
	icon_state = "nt14"
	},
/area/shuttle/ert/pmc)
"rE" = (
/turf/closed/shuttle/ert{
	icon_state = "leftengine_1";
	opacity = 0
	},
/area/shuttle/ert/pmc)
"rO" = (
/obj/docking_port/mobile/ert,
/obj/structure/prop/holidays/string_lights,
/turf/closed/shuttle/ert{
	icon_state = "nt27"
	},
/area/shuttle/ert/pmc)
"rU" = (
/turf/template_noop,
/area/template_noop)
"sV" = (
/obj/structure/prop/holidays/string_lights{
	dir = 10
	},
/turf/closed/shuttle/ert{
	icon_state = "nt23"
	},
/area/shuttle/ert/pmc)
"uo" = (
/obj/structure/rack,
/obj/effect/landmark/distress_item,
/obj/item/storage/firstaid/regular,
/obj/item/storage/belt/lifesaver/full,
/obj/structure/prop/holidays/string_lights{
	dir = 9
	},
/turf/open/shuttle/dropship/floor,
/area/shuttle/ert/pmc)
"uR" = (
/obj/structure/prop/holidays/string_lights{
	dir = 4
	},
/turf/closed/shuttle/ert{
	icon_state = "nt18"
	},
/area/shuttle/ert/pmc)
"vI" = (
/turf/closed/shuttle/ert{
	icon_state = "rightengine_1";
	opacity = 0
	},
/area/shuttle/ert/pmc)
"wu" = (
/obj/structure/prop/holidays/string_lights{
	dir = 4
	},
/turf/closed/shuttle/ert{
	icon_state = "nt16"
	},
/area/shuttle/ert/pmc)
"xd" = (
/obj/machinery/light{
	dir = 1
	},
/turf/open/shuttle/dropship{
	icon_state = "rasputin6"
	},
/area/shuttle/ert/pmc)
"xo" = (
/obj/effect/landmark/distress,
/turf/open/shuttle/dropship/three,
/area/shuttle/ert/pmc)
"xy" = (
/turf/closed/shuttle/ert{
	icon_state = "leftengine_2";
	opacity = 0
	},
/area/shuttle/ert/pmc)
"ye" = (
/turf/closed/shuttle/ert{
	icon_state = "nt_rightengine"
	},
/area/shuttle/ert/pmc)
"zI" = (
/turf/closed/shuttle/ert{
	icon_state = "nt2"
	},
/area/shuttle/ert/pmc)
"AY" = (
/obj/structure/prop/holidays/string_lights{
	dir = 8
	},
/turf/closed/shuttle/ert{
	icon_state = "nt13"
	},
/area/shuttle/ert/pmc)
"BI" = (
/obj/structure/prop/holidays/string_lights,
/turf/closed/shuttle/ert{
	icon_state = "nt21"
	},
/area/shuttle/ert/pmc)
"BY" = (
/obj/structure/prop/holidays/string_lights/corner{
	dir = 8
	},
/turf/closed/shuttle/ert{
	icon_state = "nt5"
	},
/area/shuttle/ert/pmc)
"Cs" = (
/obj/machinery/computer/shuttle/ert,
/turf/open/shuttle/dropship/floor,
/area/shuttle/ert/pmc)
"Du" = (
/obj/structure/prop/holidays/string_lights{
	dir = 1
	},
/turf/open/shuttle/dropship/three,
/area/shuttle/ert/pmc)
"Ea" = (
/obj/structure/prop/holidays/string_lights{
	dir = 8
	},
/turf/closed/shuttle/ert{
	icon_state = "nt19"
	},
/area/shuttle/ert/pmc)
"FA" = (
/obj/structure/bed/chair/dropship/passenger{
	dir = 8
	},
/obj/effect/landmark/distress,
/turf/open/shuttle/dropship/floor,
/area/shuttle/ert/pmc)
"Hp" = (
/obj/structure/prop/holidays/string_lights{
	dir = 6
	},
/turf/closed/shuttle/ert{
	icon_state = "nt22"
	},
/area/shuttle/ert/pmc)
"Jk" = (
/obj/machinery/door/poddoor/shutters/transit/open,
/obj/machinery/door/airlock/mainship/generic/ert,
/turf/open/shuttle/dropship/three,
/area/shuttle/ert/pmc)
"Nl" = (
/obj/machinery/light{
	dir = 8
	},
/turf/open/shuttle/dropship/floor,
/area/shuttle/ert/pmc)
"Np" = (
/obj/structure/prop/holidays/string_lights{
	dir = 4
	},
/turf/closed/shuttle/ert{
	icon_state = "nt4"
	},
/area/shuttle/ert/pmc)
"Ok" = (
/turf/closed/shuttle/ert{
	icon_state = "leftengine_3";
	opacity = 0
	},
/area/shuttle/ert/pmc)
"Ol" = (
/turf/closed/shuttle/ert{
	icon_state = "nt_leftengine"
	},
/area/shuttle/ert/pmc)
"OQ" = (
/turf/closed/shuttle/ert{
	icon_state = "nt3"
	},
/area/shuttle/ert/pmc)
"OS" = (
/obj/structure/bed/chair/dropship/passenger,
/obj/effect/landmark/distress,
/turf/open/shuttle/dropship/floor,
/area/shuttle/ert/pmc)
"Py" = (
/obj/structure/prop/holidays/string_lights{
	dir = 8
	},
/turf/closed/shuttle/ert{
	icon_state = "nt9"
	},
/area/shuttle/ert/pmc)
"QV" = (
/obj/structure/prop/holidays/string_lights/corner,
/turf/closed/shuttle/ert{
	icon_state = "nt20"
	},
/area/shuttle/ert/pmc)
"Ro" = (
/obj/machinery/light{
	dir = 1
	},
/turf/open/shuttle/dropship/seven,
/area/shuttle/ert/pmc)
"Sk" = (
/obj/structure/rack,
/obj/effect/landmark/distress_item,
/obj/item/storage/toolbox/mechanical,
/obj/item/multitool,
/turf/open/shuttle/dropship/floor,
/area/shuttle/ert/pmc)
"Tb" = (
/obj/structure/prop/holidays/string_lights/corner{
	dir = 1
	},
/turf/closed/shuttle/ert{
	icon_state = "nt25"
	},
/area/shuttle/ert/pmc)
"TH" = (
/obj/structure/bed/chair/dropship/passenger{
	dir = 4
	},
/obj/effect/landmark/distress,
/turf/open/shuttle/dropship/floor,
/area/shuttle/ert/pmc)
"UM" = (
/turf/closed/shuttle/ert{
	icon_state = "rightengine_3";
	opacity = 0
	},
/area/shuttle/ert/pmc)
"Va" = (
/obj/structure/prop/holidays/string_lights{
	dir = 8
	},
/turf/closed/shuttle/ert{
	icon_state = "nt15"
	},
/area/shuttle/ert/pmc)
"VP" = (
/obj/structure/rack,
/obj/effect/landmark/distress_item,
/obj/item/storage/firstaid/regular,
/obj/item/storage/belt/lifesaver/full,
/obj/structure/prop/holidays/string_lights{
	dir = 5
	},
/turf/open/shuttle/dropship/floor,
/area/shuttle/ert/pmc)
"XQ" = (
/turf/open/shuttle/dropship{
	icon_state = "floor8"
	},
/area/shuttle/ert/pmc)
"XV" = (
/obj/machinery/door/poddoor/shutters/transit/open{
	dir = 2
	},
/obj/machinery/door/airlock/mainship/generic/ert{
	dir = 2
	},
/turf/open/shuttle/dropship/floor,
/area/shuttle/ert/pmc)
"Zb" = (
/turf/open/shuttle/dropship/floor,
/area/shuttle/ert/pmc)
"ZS" = (
/obj/structure/rack,
/obj/effect/landmark/distress_item,
/obj/item/storage/firstaid/adv,
/turf/open/shuttle/dropship/floor,
/area/shuttle/ert/pmc)

(1,1,1) = {"
rU
QV
uR
Jk
wu
oN
le
Jk
dH
Ol
Ok
xy
rE
"}
(2,1,1) = {"
rU
BI
Sk
Zb
TH
TH
TH
Zb
VP
bL
Np
dH
cy
"}
(3,1,1) = {"
QV
Hp
xd
xo
xo
xo
xo
xo
gk
Zb
Nl
Zb
XV
"}
(4,1,1) = {"
rO
Cs
XQ
OS
OS
OS
OS
OS
XQ
hD
hD
Du
zI
"}
(5,1,1) = {"
Tb
sV
Ro
xo
xo
xo
xo
xo
jA
Zb
aV
Zb
XV
"}
(6,1,1) = {"
rU
BI
ZS
Zb
FA
FA
FA
Zb
uo
Py
aD
BY
OQ
"}
(7,1,1) = {"
rU
Tb
Ea
Jk
eo
Va
AY
Jk
BY
ye
UM
kc
vI
"}
