//MAP CONVERTED BY dmm2tgm.py THIS HEADER COMMENT PREVENTS RECONVERSION, DO NOT REMOVE
"a" = (
/turf/template_noop,
/area/template_noop)
"b" = (
/obj/structure/prop/holidays/string_lights/corner,
/turf/closed/shuttle/dropship_regular/top_corner/alt{
	dir = 1
	},
/area/shuttle/ert)
"c" = (
/obj/structure/prop/holidays/string_lights,
/turf/closed/shuttle/dropship_regular/backwall,
/area/shuttle/ert)
"d" = (
/obj/docking_port/mobile/ert,
/obj/structure/prop/holidays/string_lights,
/turf/closed/shuttle/dropship_regular/cockpit_window,
/area/shuttle/ert)
"e" = (
/obj/structure/prop/holidays/string_lights/corner{
	dir = 1
	},
/turf/closed/shuttle/dropship_regular/top_corner/alt,
/area/shuttle/ert)
"f" = (
/obj/structure/prop/holidays/string_lights{
	dir = 6
	},
/turf/closed/shuttle/dropship_regular/interior_corner,
/area/shuttle/ert)
"g" = (
/obj/structure/bed/chair/dropship/passenger,
/obj/effect/landmark/distress_item,
/turf/open/floor/light,
/area/shuttle/ert)
"h" = (
/obj/structure/bed/chair/dropship/passenger,
/obj/effect/landmark/distress_item,
/turf/open/floor/podhatch/floor,
/area/shuttle/ert)
"i" = (
/obj/structure/prop/holidays/string_lights{
	dir = 10
	},
/turf/closed/shuttle/dropship_regular/interior_corner{
	dir = 1
	},
/area/shuttle/ert)
"j" = (
/obj/structure/prop/holidays/string_lights{
	dir = 4
	},
/turf/closed/shuttle/dropship_regular/interior_wall,
/area/shuttle/ert)
"k" = (
/obj/structure/bed/chair/dropship/passenger{
	dir = 4
	},
/obj/effect/landmark/distress_item,
/turf/open/floor/light,
/area/shuttle/ert)
"l" = (
/obj/effect/landmark/distress_item,
/turf/open/floor/podhatch/floor,
/area/shuttle/ert)
"m" = (
/obj/effect/landmark/distress_item,
/turf/open/shuttle/brig,
/area/shuttle/ert)
"n" = (
/obj/structure/bed/chair/dropship/passenger{
	dir = 8
	},
/obj/effect/landmark/distress_item,
/turf/open/floor/light,
/area/shuttle/ert)
"o" = (
/obj/structure/prop/holidays/string_lights{
	dir = 8
	},
/turf/closed/shuttle/dropship_regular/interior_wall{
	dir = 1
	},
/area/shuttle/ert)
"p" = (
/obj/structure/bed/chair/dropship/passenger{
	dir = 4
	},
/obj/effect/landmark/distress_item,
/turf/open/floor/podhatch/floor,
/area/shuttle/ert)
"q" = (
/obj/effect/landmark/distress,
/turf/open/shuttle/brig,
/area/shuttle/ert)
"r" = (
/obj/machinery/computer/shuttle/ert,
/turf/open/shuttle/brig,
/area/shuttle/ert)
"s" = (
/obj/structure/bed/chair/dropship/passenger{
	dir = 8
	},
/obj/effect/landmark/distress_item,
/turf/open/floor/podhatch/floor,
/area/shuttle/ert)
"t" = (
/turf/open/shuttle/brig,
/area/shuttle/ert)
"u" = (
/turf/closed/shuttle/dropship_regular/backhatch,
/area/shuttle/ert)
"v" = (
/obj/structure/prop/holidays/string_lights/corner{
	dir = 4
	},
/turf/closed/shuttle/dropship_regular/top_corner,
/area/shuttle/ert)
"w" = (
/obj/structure/bed/chair/dropship/passenger{
	dir = 4
	},
/obj/structure/prop/holidays/string_lights{
	dir = 1
	},
/turf/open/floor/light,
/area/shuttle/ert)
"x" = (
/turf/open/floor/podhatch/floor,
/area/shuttle/ert)
"y" = (
/obj/structure/bed/chair/dropship/passenger{
	dir = 8
	},
/obj/structure/prop/holidays/string_lights{
	dir = 1
	},
/turf/open/floor/light,
/area/shuttle/ert)
"z" = (
/obj/structure/prop/holidays/string_lights/corner{
	dir = 8
	},
/turf/closed/shuttle/dropship_regular/top_corner{
	dir = 1
	},
/area/shuttle/ert)
"A" = (
/turf/closed/shuttle/dropship_regular/backhatch{
	dir = 4
	},
/area/shuttle/ert)
"B" = (
/turf/closed/shuttle/dropship_regular/backhatch{
	dir = 1
	},
/area/shuttle/ert)
"C" = (
/obj/machinery/door/poddoor/shutters/transit/open{
	dir = 2
	},
/obj/machinery/door/airlock/mainship/generic/ert{
	dir = 2
	},
/turf/open/shuttle/dropship/floor,
/area/shuttle/ert)
"G" = (
/obj/structure/prop/holidays/string_lights/corner{
	dir = 4
	},
/turf/closed/shuttle/dropship_regular/interior_wall,
/area/shuttle/ert)
"I" = (
/obj/structure/bed/chair/dropship/passenger{
	dir = 8
	},
/obj/effect/landmark/distress_item,
/obj/structure/prop/holidays/string_lights{
	dir = 9
	},
/turf/open/floor/light,
/area/shuttle/ert)
"O" = (
/obj/structure/prop/holidays/string_lights/corner{
	dir = 8
	},
/turf/closed/shuttle/dropship_regular/interior_wall{
	dir = 1
	},
/area/shuttle/ert)
"V" = (
/obj/structure/bed/chair/dropship/passenger{
	dir = 4
	},
/obj/effect/landmark/distress_item,
/obj/structure/prop/holidays/string_lights{
	dir = 5
	},
/turf/open/floor/light,
/area/shuttle/ert)

(1,1,1) = {"
a
b
j
j
G
u
a
"}
(2,1,1) = {"
b
f
k
p
V
v
u
"}
(3,1,1) = {"
c
g
l
q
l
w
B
"}
(4,1,1) = {"
d
h
m
r
t
x
C
"}
(5,1,1) = {"
c
g
l
q
l
y
B
"}
(6,1,1) = {"
e
i
n
s
I
z
A
"}
(7,1,1) = {"
a
e
o
o
O
A
a
"}
