//MAP CONVERTED BY dmm2tgm.py THIS HEADER COMMENT PREVENTS RECONVERSION, DO NOT REMOVE
"a" = (
/turf/template_noop,
/area/template_noop)
"b" = (
/turf/closed/shuttle/dropship_white/top_corner/alt{
	dir = 1
	},
/area/shuttle/ert/pmc)
"c" = (
/obj/docking_port/mobile/ert,
/turf/closed/shuttle/dropship_white/cockpit_window,
/area/shuttle/ert/pmc)
"d" = (
/turf/closed/shuttle/dropship_white/top_corner/alt,
/area/shuttle/ert/pmc)
"e" = (
/turf/closed/shuttle/dropship_white/backwall,
/area/shuttle/ert/pmc)
"f" = (
/turf/closed/shuttle/dropship_white/interior_corner,
/area/shuttle/ert/pmc)
"g" = (
/turf/open/shuttle/dropship/floor,
/area/shuttle/ert/pmc)
"h" = (
/turf/closed/shuttle/dropship_white/interior_corner{
	dir = 1
	},
/area/shuttle/ert/pmc)
"i" = (
/turf/closed/shuttle/dropship_white/logo_wall/four,
/area/shuttle/ert/pmc)
"j" = (
/obj/structure/rack,
/obj/effect/landmark/distress_item,
/obj/item/storage/toolbox/mechanical,
/obj/item/tool/multitool,
/turf/open/shuttle/dropship/floor,
/area/shuttle/ert/pmc)
"k" = (
/obj/machinery/light{
	dir = 1
	},
/turf/open/shuttle/dropship/six,
/area/shuttle/ert/pmc)
"l" = (
/turf/open/shuttle/dropship/five,
/area/shuttle/ert/pmc)
"m" = (
/obj/machinery/light{
	dir = 1
	},
/turf/open/shuttle/dropship/seven,
/area/shuttle/ert/pmc)
"n" = (
/obj/structure/rack,
/obj/effect/landmark/distress_item,
/obj/item/storage/firstaid/adv,
/turf/open/shuttle/dropship/floor,
/area/shuttle/ert/pmc)
"o" = (
/turf/closed/shuttle/dropship_white/logo_wall/four{
	dir = 1
	},
/area/shuttle/ert/pmc)
"p" = (
/obj/machinery/door/poddoor/shutters/transit/open,
/obj/machinery/door/airlock/mainship/generic/ert,
/turf/open/shuttle/dropship/three,
/area/shuttle/ert/pmc)
"q" = (
/obj/effect/landmark/distress,
/turf/open/shuttle/dropship/three,
/area/shuttle/ert/pmc)
"r" = (
/obj/structure/bed/chair/dropship/passenger,
/obj/effect/landmark/distress,
/turf/open/shuttle/dropship/floor,
/area/shuttle/ert/pmc)
"s" = (
/turf/closed/shuttle/dropship_white/logo_wall/three{
	dir = 4
	},
/area/shuttle/ert/pmc)
"t" = (
/obj/structure/bed/chair/dropship/passenger{
	dir = 4
	},
/obj/effect/landmark/distress,
/turf/open/shuttle/dropship/floor,
/area/shuttle/ert/pmc)
"u" = (
/obj/structure/bed/chair/dropship/passenger{
	dir = 8
	},
/obj/effect/landmark/distress,
/turf/open/shuttle/dropship/floor,
/area/shuttle/ert/pmc)
"v" = (
/turf/open/shuttle/dropship/four,
/area/shuttle/ert/pmc)
"w" = (
/turf/open/shuttle/dropship/eight,
/area/shuttle/ert/pmc)
"x" = (
/turf/closed/shuttle/dropship_white/logo_wall/three{
	dir = 1
	},
/area/shuttle/ert/pmc)
"y" = (
/turf/closed/shuttle/dropship_white/logo_wall/two,
/area/shuttle/ert/pmc)
"z" = (
/turf/open/shuttle/dropship/three,
/area/shuttle/ert/pmc)
"A" = (
/turf/closed/shuttle/dropship_white/logo_wall/two{
	dir = 8
	},
/area/shuttle/ert/pmc)
"B" = (
/turf/closed/shuttle/dropship_white/logo_wall,
/area/shuttle/ert/pmc)
"C" = (
/obj/machinery/computer/shuttle/ert,
/turf/open/shuttle/dropship/floor,
/area/shuttle/ert/pmc)
"D" = (
/turf/closed/shuttle/dropship_white/logo_wall{
	dir = 1
	},
/area/shuttle/ert/pmc)
"E" = (
/obj/machinery/light{
	dir = 8
	},
/turf/open/shuttle/dropship/floor,
/area/shuttle/ert/pmc)
"F" = (
/turf/closed/shuttle/dropship_white/interior_wall,
/area/shuttle/ert/pmc)
"G" = (
/obj/machinery/light{
	dir = 4
	},
/turf/open/shuttle/dropship/floor,
/area/shuttle/ert/pmc)
"H" = (
/obj/structure/rack,
/obj/effect/landmark/distress_item,
/obj/item/storage/firstaid/regular,
/obj/item/storage/belt/lifesaver/full,
/turf/open/shuttle/dropship/floor,
/area/shuttle/ert/pmc)
"I" = (
/obj/machinery/door/poddoor/shutters/transit/open{
	dir = 2
	},
/obj/machinery/door/airlock/mainship/generic/ert{
	dir = 2
	},
/turf/open/shuttle/dropship/floor,
/area/shuttle/ert/pmc)
"J" = (
/turf/closed/shuttle/dropship_white/interior_wall{
	dir = 8
	},
/area/shuttle/ert/pmc)
"K" = (
/turf/closed/shuttle/dropship_white/engine_corner{
	dir = 1
	},
/area/shuttle/ert/pmc)
"L" = (
/turf/closed/shuttle/dropship_white/top_corner,
/area/shuttle/ert/pmc)
"M" = (
/turf/closed/shuttle/dropship_white/top_corner{
	dir = 1
	},
/area/shuttle/ert/pmc)
"N" = (
/turf/closed/shuttle/dropship_white/engine_corner,
/area/shuttle/ert/pmc)
"O" = (
/obj/effect/mapping_helpers/barricade/closed,
/obj/structure/barricade/plasteel{
	dir = 4
	},
/turf/open/shuttle/dropship/floor,
/area/shuttle/ert/pmc)
"P" = (
/turf/closed/shuttle/ert/engines/right/two{
	dir = 1
	},
/area/shuttle/ert/pmc)
"Q" = (
/turf/closed/shuttle/dropship_white/backhatch,
/area/shuttle/ert/pmc)
"R" = (
/turf/closed/shuttle/dropship_white/backhatch{
	dir = 1
	},
/area/shuttle/ert/pmc)
"S" = (
/turf/closed/shuttle/dropship_white/backhatch{
	dir = 4
	},
/area/shuttle/ert/pmc)
"T" = (
/obj/effect/mapping_helpers/barricade/closed,
/obj/structure/barricade/plasteel{
	dir = 8
	},
/turf/open/shuttle/dropship/floor,
/area/shuttle/ert/pmc)
"U" = (
/turf/closed/shuttle/ert/engines/right/three{
	dir = 1
	},
/area/shuttle/ert/pmc)
"V" = (
/turf/closed/shuttle/ert/engines/left{
	dir = 1
	},
/area/shuttle/ert/pmc)
"W" = (
/turf/closed/shuttle/ert/engines/right{
	dir = 1
	},
/area/shuttle/ert/pmc)
"X" = (
/turf/closed/shuttle/ert/engines/left/three{
	dir = 1
	},
/area/shuttle/ert/pmc)
"Y" = (
/turf/closed/shuttle/ert/engines/left/two{
	dir = 1
	},
/area/shuttle/ert/pmc)
"Z" = (
/obj/effect/mapping_helpers/barricade/closed,
/obj/structure/barricade/plasteel,
/turf/open/shuttle/dropship/floor,
/area/shuttle/ert/pmc)

(1,1,1) = {"
a
b
i
p
s
y
B
p
F
K
X
Y
V
"}
(2,1,1) = {"
a
e
j
T
t
t
t
T
H
L
F
F
Q
"}
(3,1,1) = {"
b
f
k
q
q
q
q
q
v
g
E
Z
I
"}
(4,1,1) = {"
c
C
l
r
r
r
r
r
l
z
z
z
R
"}
(5,1,1) = {"
d
h
m
q
q
q
q
q
w
g
G
Z
I
"}
(6,1,1) = {"
a
e
n
O
u
u
u
O
H
M
J
J
S
"}
(7,1,1) = {"
a
d
o
p
x
A
D
p
J
N
U
P
W
"}
