//MAP CONVERTED BY dmm2tgm.py THIS HEADER COMMENT PREVENTS RECONVERSION, DO NOT REMOVE
"ds" = (
/obj/machinery/computer/shuttle/ert,
/turf/open/shuttle/dropship/floor,
/area/shuttle/ert/pmc)
"gj" = (
/turf/closed/shuttle/ert/engines/left/three{
	dir = 1
	},
/area/shuttle/ert/pmc)
"gu" = (
/turf/closed/shuttle/dropship_white/top_corner,
/area/shuttle/ert/pmc)
"hB" = (
/turf/closed/shuttle/dropship_white/logo_wall/four,
/area/shuttle/ert/pmc)
"kf" = (
/turf/closed/shuttle/dropship_white/logo_wall/three{
	dir = 1
	},
/area/shuttle/ert/pmc)
"la" = (
/turf/closed/shuttle/dropship_white/backwall,
/area/shuttle/ert/pmc)
"mk" = (
/turf/closed/shuttle/ert/engines/right/two{
	dir = 1
	},
/area/shuttle/ert/pmc)
"oa" = (
/obj/machinery/light{
	dir = 1
	},
/turf/open/shuttle/dropship/six,
/area/shuttle/ert/pmc)
"oV" = (
/turf/closed/shuttle/dropship_white/interior_corner,
/area/shuttle/ert/pmc)
"pm" = (
/obj/structure/bed/chair/dropship/passenger{
	dir = 8
	},
/obj/effect/landmark/distress,
/turf/open/shuttle/dropship/floor,
/area/shuttle/ert/pmc)
"pL" = (
/turf/closed/shuttle/ert/engines/right/three{
	dir = 1
	},
/area/shuttle/ert/pmc)
"pR" = (
/turf/open/shuttle/dropship/floor,
/area/shuttle/ert/pmc)
"qb" = (
/turf/closed/shuttle/dropship_white/logo_wall/two{
	dir = 8
	},
/area/shuttle/ert/pmc)
"qs" = (
/obj/effect/mapping_helpers/barricade/closed,
/obj/structure/barricade/folding{
	dir = 4
	},
/turf/open/shuttle/dropship/floor,
/area/shuttle/ert/pmc)
"rF" = (
/turf/closed/shuttle/dropship_white/backhatch{
	dir = 4
	},
/area/shuttle/ert/pmc)
"rK" = (
/obj/structure/rack,
/obj/effect/landmark/distress_item,
/obj/item/storage/firstaid/regular,
/obj/item/storage/belt/lifesaver/full,
/turf/open/shuttle/dropship/floor,
/area/shuttle/ert/pmc)
"wk" = (
/obj/effect/mapping_helpers/barricade/closed,
/obj/structure/barricade/folding,
/turf/open/shuttle/dropship/floor,
/area/shuttle/ert/pmc)
"wx" = (
/obj/effect/landmark/distress,
/turf/open/shuttle/dropship/three,
/area/shuttle/ert/pmc)
"wF" = (
/turf/closed/shuttle/dropship_white/backhatch,
/area/shuttle/ert/pmc)
"yK" = (
/turf/closed/shuttle/dropship_white/logo_wall,
/area/shuttle/ert/pmc)
"zk" = (
/turf/closed/shuttle/dropship_white/interior_wall{
	dir = 8
	},
/area/shuttle/ert/pmc)
"zE" = (
/turf/closed/shuttle/dropship_white/interior_corner{
	dir = 1
	},
/area/shuttle/ert/pmc)
"CJ" = (
/obj/effect/ai_node,
/turf/open/shuttle/dropship/four,
/area/shuttle/ert/pmc)
"Da" = (
/obj/machinery/door/poddoor/shutters/transit/open,
/obj/machinery/door/airlock/mainship/generic/ert,
/turf/open/shuttle/dropship/three,
/area/shuttle/ert/pmc)
"Dj" = (
/obj/machinery/light{
	dir = 1
	},
/turf/open/shuttle/dropship/seven,
/area/shuttle/ert/pmc)
"EJ" = (
/obj/structure/bed/chair/dropship/passenger{
	dir = 4
	},
/obj/effect/landmark/distress,
/turf/open/shuttle/dropship/floor,
/area/shuttle/ert/pmc)
"Fm" = (
/obj/machinery/door/poddoor/shutters/transit/open{
	dir = 2
	},
/obj/machinery/door/airlock/mainship/generic/ert{
	dir = 2
	},
/turf/open/shuttle/dropship/floor,
/area/shuttle/ert/pmc)
"GQ" = (
/obj/structure/bed/chair/dropship/passenger,
/obj/effect/landmark/distress,
/turf/open/shuttle/dropship/floor,
/area/shuttle/ert/pmc)
"Hr" = (
/turf/closed/shuttle/ert/engines/left{
	dir = 1
	},
/area/shuttle/ert/pmc)
"It" = (
/obj/structure/rack,
/obj/effect/landmark/distress_item,
/obj/item/storage/toolbox/mechanical,
/obj/item/tool/multitool,
/turf/open/shuttle/dropship/floor,
/area/shuttle/ert/pmc)
"Iy" = (
/turf/closed/shuttle/dropship_white/engine_corner{
	dir = 1
	},
/area/shuttle/ert/pmc)
"IN" = (
/obj/docking_port/mobile/ert,
/turf/closed/shuttle/dropship_white/cockpit_window,
/area/shuttle/ert/pmc)
"Jw" = (
/turf/closed/shuttle/dropship_white/top_corner/alt{
	dir = 1
	},
/area/shuttle/ert/pmc)
"JC" = (
/turf/closed/shuttle/dropship_white/engine_corner,
/area/shuttle/ert/pmc)
"Ki" = (
/turf/closed/shuttle/ert/engines/right{
	dir = 1
	},
/area/shuttle/ert/pmc)
"Kz" = (
/turf/closed/shuttle/dropship_white/logo_wall/three{
	dir = 4
	},
/area/shuttle/ert/pmc)
"KE" = (
/obj/machinery/light{
	dir = 4
	},
/turf/open/shuttle/dropship/floor,
/area/shuttle/ert/pmc)
"LP" = (
/obj/structure/rack,
/obj/effect/landmark/distress_item,
/obj/item/storage/firstaid/adv,
/turf/open/shuttle/dropship/floor,
/area/shuttle/ert/pmc)
"Mo" = (
/obj/effect/mapping_helpers/barricade/closed,
/obj/structure/barricade/folding{
	dir = 8
	},
/turf/open/shuttle/dropship/floor,
/area/shuttle/ert/pmc)
"Oj" = (
/obj/effect/ai_node,
/turf/open/shuttle/dropship/eight,
/area/shuttle/ert/pmc)
"Ot" = (
/turf/closed/shuttle/dropship_white/interior_wall,
/area/shuttle/ert/pmc)
"Sp" = (
/turf/closed/shuttle/ert/engines/left/two{
	dir = 1
	},
/area/shuttle/ert/pmc)
"Sr" = (
/turf/closed/shuttle/dropship_white/backhatch{
	dir = 1
	},
/area/shuttle/ert/pmc)
"Tc" = (
/turf/template_noop,
/area/template_noop)
"Ue" = (
/turf/closed/shuttle/dropship_white/top_corner{
	dir = 1
	},
/area/shuttle/ert/pmc)
"Uy" = (
/turf/closed/shuttle/dropship_white/logo_wall/two,
/area/shuttle/ert/pmc)
"UR" = (
/turf/open/shuttle/dropship/five,
/area/shuttle/ert/pmc)
"VH" = (
/turf/closed/shuttle/dropship_white/logo_wall{
	dir = 1
	},
/area/shuttle/ert/pmc)
"VM" = (
/turf/closed/shuttle/dropship_white/top_corner/alt,
/area/shuttle/ert/pmc)
"YI" = (
/turf/closed/shuttle/dropship_white/logo_wall/four{
	dir = 1
	},
/area/shuttle/ert/pmc)
"YT" = (
/turf/open/shuttle/dropship/three,
/area/shuttle/ert/pmc)
"ZD" = (
/obj/structure/bed/chair/dropship/passenger,
/obj/effect/landmark/distress,
/obj/effect/ai_node,
/turf/open/shuttle/dropship/floor,
/area/shuttle/ert/pmc)
"ZN" = (
/obj/machinery/light{
	dir = 8
	},
/turf/open/shuttle/dropship/floor,
/area/shuttle/ert/pmc)

(1,1,1) = {"
Tc
Jw
hB
Da
Kz
Uy
yK
Da
Ot
Iy
gj
Sp
Hr
"}
(2,1,1) = {"
Tc
la
It
Mo
EJ
EJ
EJ
Mo
rK
gu
Ot
Ot
wF
"}
(3,1,1) = {"
Jw
oV
oa
wx
wx
wx
wx
wx
CJ
pR
ZN
wk
Fm
"}
(4,1,1) = {"
IN
ds
UR
ZD
GQ
GQ
GQ
ZD
UR
YT
YT
YT
Sr
"}
(5,1,1) = {"
VM
zE
Dj
wx
wx
wx
wx
wx
Oj
pR
KE
wk
Fm
"}
(6,1,1) = {"
Tc
la
LP
qs
pm
pm
pm
qs
rK
Ue
zk
zk
rF
"}
(7,1,1) = {"
Tc
VM
YI
Da
kf
qb
VH
Da
zk
JC
pL
mk
Ki
"}
