//MAP CONVERTED BY dmm2tgm.py THIS HEADER COMMENT PREVENTS RECONVERSION, DO NOT REMOVE
"a" = (
/turf/template_noop,
/area/template_noop)
"b" = (
/obj/structure/prop/holidays/string_lights/corner,
/turf/closed/shuttle/dropship_dark/top_corner/alt{
	dir = 8
	},
/area/shuttle/ert/upp)
"c" = (
/obj/docking_port/mobile/ert,
/obj/structure/prop/holidays/string_lights,
/turf/closed/shuttle/dropship_dark/cockpit_window,
/area/shuttle/ert/upp)
"d" = (
/obj/structure/prop/holidays/string_lights/corner{
	dir = 1
	},
/turf/closed/shuttle/dropship_dark/top_corner/alt,
/area/shuttle/ert/upp)
"e" = (
/obj/structure/prop/holidays/string_lights,
/turf/closed/shuttle/dropship_dark/backwall,
/area/shuttle/ert/upp)
"f" = (
/obj/structure/prop/holidays/string_lights{
	dir = 6
	},
/turf/closed/shuttle/dropship_dark/interior_corner,
/area/shuttle/ert/upp)
"g" = (
/turf/open/shuttle/dropship/floor,
/area/shuttle/ert/upp)
"h" = (
/obj/structure/prop/holidays/string_lights{
	dir = 10
	},
/turf/closed/shuttle/dropship_dark/interior_corner{
	dir = 1
	},
/area/shuttle/ert/upp)
"i" = (
/turf/closed/shuttle/ert/engines/left/two{
	dir = 1
	},
/area/shuttle/ert/upp)
"j" = (
/obj/structure/rack,
/obj/effect/landmark/distress_item,
/obj/item/storage/toolbox/mechanical,
/obj/item/tool/multitool,
/turf/open/shuttle/dropship/floor,
/area/shuttle/ert/upp)
"k" = (
/obj/machinery/light{
	dir = 1
	},
/turf/open/shuttle/dropship/six,
/area/shuttle/ert/upp)
"l" = (
/turf/open/shuttle/dropship/five,
/area/shuttle/ert/upp)
"m" = (
/obj/machinery/light{
	dir = 1
	},
/turf/open/shuttle/dropship/seven,
/area/shuttle/ert/upp)
"n" = (
/obj/structure/rack,
/obj/item/storage/firstaid/adv,
/obj/effect/landmark/distress_item,
/turf/open/shuttle/dropship/floor,
/area/shuttle/ert/upp)
"o" = (
/obj/structure/prop/holidays/string_lights{
	dir = 8
	},
/turf/closed/shuttle/dropship_dark/interior_wall{
	dir = 1
	},
/area/shuttle/ert/upp)
"p" = (
/obj/machinery/door/poddoor/shutters/transit/open,
/obj/machinery/door/airlock/mainship/generic/ert,
/turf/open/shuttle/dropship/three,
/area/shuttle/ert/upp)
"q" = (
/obj/effect/landmark/distress,
/turf/open/shuttle/dropship/three,
/area/shuttle/ert/upp)
"r" = (
/obj/structure/bed/chair/dropship/passenger,
/obj/effect/landmark/distress,
/turf/open/shuttle/dropship/floor,
/area/shuttle/ert/upp)
"s" = (
/obj/structure/prop/holidays/string_lights{
	dir = 4
	},
/turf/closed/shuttle/dropship_dark/logo_wall,
/area/shuttle/ert/upp)
"t" = (
/obj/structure/bed/chair/dropship/passenger{
	dir = 4
	},
/obj/effect/landmark/distress,
/turf/open/shuttle/dropship/floor,
/area/shuttle/ert/upp)
"u" = (
/obj/structure/bed/chair/dropship/passenger{
	dir = 8
	},
/obj/effect/landmark/distress,
/turf/open/shuttle/dropship/floor,
/area/shuttle/ert/upp)
"v" = (
/turf/open/shuttle/dropship/four,
/area/shuttle/ert/upp)
"w" = (
/turf/open/shuttle/dropship/eight,
/area/shuttle/ert/upp)
"x" = (
/obj/structure/rack,
/obj/effect/landmark/distress_item,
/obj/item/storage/firstaid/regular,
/obj/item/storage/belt/lifesaver/full,
/obj/structure/prop/holidays/string_lights{
	dir = 5
	},
/turf/open/shuttle/dropship/floor,
/area/shuttle/ert/upp)
"y" = (
/obj/structure/rack,
/obj/item/storage/firstaid/regular,
/obj/item/storage/belt/lifesaver/full,
/obj/effect/landmark/distress_item,
/obj/structure/prop/holidays/string_lights{
	dir = 9
	},
/turf/open/shuttle/dropship/floor,
/area/shuttle/ert/upp)
"z" = (
/turf/open/shuttle/dropship/three,
/area/shuttle/ert/upp)
"A" = (
/turf/closed/shuttle/dropship_dark/engine_corner,
/area/shuttle/ert/upp)
"B" = (
/obj/structure/prop/holidays/string_lights{
	dir = 4
	},
/turf/closed/shuttle/dropship_dark/top_corner,
/area/shuttle/ert/upp)
"C" = (
/obj/machinery/computer/shuttle/ert,
/turf/open/shuttle/dropship/floor,
/area/shuttle/ert/upp)
"D" = (
/obj/structure/prop/holidays/string_lights{
	dir = 8
	},
/turf/closed/shuttle/dropship_dark/top_corner{
	dir = 1
	},
/area/shuttle/ert/upp)
"E" = (
/obj/machinery/light{
	dir = 8
	},
/turf/open/shuttle/dropship/floor,
/area/shuttle/ert/upp)
"F" = (
/turf/closed/shuttle/dropship_dark/engine_corner{
	dir = 1
	},
/area/shuttle/ert/upp)
"G" = (
/obj/machinery/light{
	dir = 4
	},
/turf/open/shuttle/dropship/floor,
/area/shuttle/ert/upp)
"I" = (
/obj/machinery/door/poddoor/shutters/transit/open{
	dir = 2
	},
/obj/machinery/door/airlock/mainship/generic/ert{
	dir = 2
	},
/turf/open/shuttle/dropship/floor,
/area/shuttle/ert/upp)
"K" = (
/turf/closed/shuttle/dropship_dark/backhatch,
/area/shuttle/ert/upp)
"L" = (
/turf/closed/shuttle/dropship_dark/backhatch{
	dir = 1
	},
/area/shuttle/ert/upp)
"M" = (
/turf/closed/shuttle/dropship_dark/backhatch{
	dir = 4
	},
/area/shuttle/ert/upp)
"N" = (
/turf/closed/shuttle/ert/engines/left{
	dir = 1
	},
/area/shuttle/ert/upp)
"O" = (
/turf/closed/shuttle/ert/engines/right/two{
	dir = 1
	},
/area/shuttle/ert/upp)
"Q" = (
/turf/closed/shuttle/ert/engines/left/three{
	dir = 1
	},
/area/shuttle/ert/upp)
"S" = (
/obj/structure/prop/holidays/string_lights/corner{
	dir = 4
	},
/turf/closed/shuttle/dropship_dark/interior_wall,
/area/shuttle/ert/upp)
"V" = (
/turf/closed/shuttle/ert/engines/right/three{
	dir = 1
	},
/area/shuttle/ert/upp)
"W" = (
/obj/structure/prop/holidays/string_lights{
	dir = 4
	},
/turf/closed/shuttle/dropship_dark/interior_wall,
/area/shuttle/ert/upp)
"X" = (
/obj/structure/prop/holidays/string_lights{
	dir = 1
	},
/turf/open/shuttle/dropship/three,
/area/shuttle/ert/upp)
"Y" = (
/obj/structure/prop/holidays/string_lights/corner{
	dir = 8
	},
/turf/closed/shuttle/dropship_dark/interior_wall{
	dir = 1
	},
/area/shuttle/ert/upp)
"Z" = (
/turf/closed/shuttle/ert/engines/right{
	dir = 1
	},
/area/shuttle/ert/upp)

(1,1,1) = {"
a
b
s
p
s
W
W
p
S
A
Q
i
N
"}
(2,1,1) = {"
a
e
j
g
t
t
t
g
x
B
W
S
K
"}
(3,1,1) = {"
b
f
k
q
q
q
q
q
v
g
E
g
I
"}
(4,1,1) = {"
c
C
l
r
r
r
r
r
l
z
z
X
L
"}
(5,1,1) = {"
d
h
m
q
q
q
q
q
w
g
G
g
I
"}
(6,1,1) = {"
a
e
n
g
u
u
u
g
y
D
o
Y
M
"}
(7,1,1) = {"
a
d
o
p
o
o
o
p
Y
F
V
O
Z
"}
