//MAP CONVERTED BY dmm2tgm.py THIS HEADER COMMENT PREVENTS RECONVERSION, DO NOT REMOVE
"a" = (
/turf/template_noop,
/area/template_noop)
"b" = (
/turf/closed/shuttle/dropship_white/top_corner/alt{
	dir = 1
	},
/area/shuttle/ert/pmc)
"c" = (
/obj/docking_port/mobile/ert,
/turf/closed/shuttle/dropship_white/cockpit_window,
/area/shuttle/ert/pmc)
"d" = (
/turf/closed/shuttle/dropship_white/top_corner/alt,
/area/shuttle/ert/pmc)
"e" = (
/turf/closed/shuttle/dropship_white/backwall,
/area/shuttle/ert/pmc)
"f" = (
/turf/closed/shuttle/dropship_white/interior_corner,
/area/shuttle/ert/pmc)
"gk" = (
/turf/open/shuttle/dropship{
	icon_state = "rasputin4"
	},
/area/shuttle/ert/pmc)
"h" = (
/turf/closed/shuttle/dropship_white/interior_corner{
	dir = 1
	},
/area/shuttle/ert/pmc)
"i" = (
/turf/closed/shuttle/dropship_white/logo_wall/four,
/area/shuttle/ert/pmc)
"j" = (
/obj/structure/rack,
/obj/effect/landmark/distress_item,
/obj/item/storage/toolbox/mechanical,
/obj/item/tool/multitool,
/turf/open/shuttle/dropship/floor,
/area/shuttle/ert/pmc)
"rE" = (
/turf/closed/shuttle/ert{
	icon_state = "leftengine_1";
	opacity = 0
	},
/area/shuttle/ert/pmc)
"l" = (
/turf/open/shuttle/dropship/five,
/area/shuttle/ert/pmc)
"rU" = (
/turf/template_noop,
/area/template_noop)
"sV" = (
/obj/structure/prop/holidays/string_lights{
	dir = 10
	},
/turf/closed/shuttle/ert{
	icon_state = "nt23"
	},
/area/shuttle/ert/pmc)
"uo" = (
/obj/structure/rack,
/obj/effect/landmark/distress_item,
/obj/item/storage/firstaid/regular,
/obj/item/storage/belt/lifesaver/full,
/obj/structure/prop/holidays/string_lights{
	dir = 9
	},
/turf/open/shuttle/dropship/floor,
/area/shuttle/ert/pmc)
"o" = (
/turf/closed/shuttle/dropship_white/logo_wall/four{
	dir = 1
	},
/area/shuttle/ert/pmc)
"vI" = (
/turf/closed/shuttle/ert{
	icon_state = "rightengine_1";
	opacity = 0
	},
/area/shuttle/ert/pmc)
"q" = (
/obj/effect/landmark/distress,
/turf/open/shuttle/dropship/three,
/area/shuttle/ert/pmc)
"r" = (
/obj/structure/bed/chair/dropship/passenger,
/obj/effect/landmark/distress,
/turf/open/shuttle/dropship/floor,
/area/shuttle/ert/pmc)
"s" = (
/turf/closed/shuttle/dropship_white/logo_wall/three{
	dir = 4
	},
/area/shuttle/ert/pmc)
"xd" = (
/obj/machinery/light{
	dir = 1
	},
/turf/open/shuttle/dropship{
	icon_state = "rasputin6"
	},
/area/shuttle/ert/pmc)
"xo" = (
/obj/effect/landmark/distress,
/turf/open/shuttle/dropship/three,
/area/shuttle/ert/pmc)
"xy" = (
/turf/closed/shuttle/ert{
	icon_state = "leftengine_2";
	opacity = 0
	},
/area/shuttle/ert/pmc)
"ye" = (
/turf/closed/shuttle/ert{
	icon_state = "nt_rightengine"
	},
/area/shuttle/ert/pmc)
"w" = (
/turf/open/shuttle/dropship/eight,
/area/shuttle/ert/pmc)
"x" = (
/turf/closed/shuttle/dropship_white/logo_wall/three{
	dir = 1
	},
/area/shuttle/ert/pmc)
"y" = (
/turf/closed/shuttle/dropship_white/logo_wall/two,
/area/shuttle/ert/pmc)
"z" = (
/turf/open/shuttle/dropship/three,
/area/shuttle/ert/pmc)
"A" = (
/turf/closed/shuttle/dropship_white/logo_wall/two{
	dir = 8
	},
/area/shuttle/ert/pmc)
"B" = (
/turf/closed/shuttle/dropship_white/logo_wall,
/area/shuttle/ert/pmc)
"Cs" = (
/obj/machinery/computer/shuttle/ert,
/turf/open/shuttle/dropship/floor,
/area/shuttle/ert/pmc)
"D" = (
/turf/closed/shuttle/dropship_white/logo_wall{
	dir = 1
	},
/area/shuttle/ert/pmc)
"FA" = (
/obj/structure/bed/chair/dropship/passenger{
	dir = 8
	},
/obj/effect/landmark/distress,
/turf/open/shuttle/dropship/floor,
/area/shuttle/ert/pmc)
"F" = (
/turf/closed/shuttle/dropship_white/interior_wall,
/area/shuttle/ert/pmc)
"Jk" = (
/obj/machinery/door/poddoor/shutters/transit/open,
/obj/machinery/door/airlock/mainship/generic/ert,
/turf/open/shuttle/dropship/three,
/area/shuttle/ert/pmc)
"Nl" = (
/obj/machinery/light{
	dir = 8
	},
/turf/open/shuttle/dropship/floor,
/area/shuttle/ert/pmc)
"Np" = (
/obj/structure/prop/holidays/string_lights{
	dir = 4
	},
/turf/closed/shuttle/ert{
	icon_state = "nt4"
	},
/area/shuttle/ert/pmc)
"J" = (
/turf/closed/shuttle/dropship_white/interior_wall{
	dir = 8
	},
/area/shuttle/ert/pmc)
"K" = (
/turf/closed/shuttle/dropship_white/engine_corner{
	dir = 1
	},
/area/shuttle/ert/pmc)
"L" = (
/turf/closed/shuttle/dropship_white/top_corner,
/area/shuttle/ert/pmc)
"M" = (
/turf/closed/shuttle/dropship_white/top_corner{
	dir = 1
	},
/area/shuttle/ert/pmc)
"N" = (
/turf/closed/shuttle/dropship_white/engine_corner,
/area/shuttle/ert/pmc)
"P" = (
/turf/closed/shuttle/ert/engines/right/two{
	dir = 1
	},
/turf/open/shuttle/dropship/seven,
/area/shuttle/ert/pmc)
"Q" = (
/turf/closed/shuttle/dropship_white/backhatch,
/area/shuttle/ert/pmc)
"R" = (
/turf/closed/shuttle/dropship_white/backhatch{
	dir = 1
	},
/area/shuttle/ert/pmc)
"S" = (
/turf/closed/shuttle/dropship_white/backhatch{
	dir = 4
	},
/area/shuttle/ert/pmc)
"U" = (
/turf/closed/shuttle/ert/engines/right/three{
	dir = 1
	},
/area/shuttle/ert/pmc)
"V" = (
/turf/closed/shuttle/ert/engines/left{
	dir = 1
	},
/turf/closed/shuttle/ert{
	icon_state = "nt15"
	},
/area/shuttle/ert/pmc)
"W" = (
/turf/closed/shuttle/ert/engines/right{
	dir = 1
	},
/turf/open/shuttle/dropship/floor,
/area/shuttle/ert/pmc)
"X" = (
/turf/closed/shuttle/ert/engines/left/three{
	dir = 1
	},
/area/shuttle/ert/pmc)
"Y" = (
/turf/closed/shuttle/ert/engines/left/two{
	dir = 1
	},
/area/shuttle/ert/pmc)

(1,1,1) = {"
a
b
i
p
s
y
B
p
F
K
X
Y
V
"}
(2,1,1) = {"
rU
BI
Sk
Zb
TH
TH
TH
Zb
VP
bL
Np
dH
cy
"}
(3,1,1) = {"
QV
Hp
xd
xo
xo
xo
xo
xo
gk
Zb
Nl
Zb
XV
"}
(4,1,1) = {"
rO
Cs
XQ
OS
OS
OS
OS
OS
XQ
hD
hD
Du
zI
"}
(5,1,1) = {"
Tb
sV
Ro
xo
xo
xo
xo
xo
jA
Zb
aV
Zb
XV
"}
(6,1,1) = {"
rU
BI
ZS
Zb
FA
FA
FA
Zb
uo
Py
aD
BY
OQ
"}
(7,1,1) = {"
a
d
o
p
x
A
D
p
J
N
U
P
W
"}
