//MAP CONVERTED BY dmm2tgm.py THIS HEADER COMMENT PREVENTS RECONVERSION, DO NOT REMOVE
"aB" = (
/obj/machinery/vending/snack/alamo,
/obj/structure/prop/mainship/railing{
	dir = 4
	},
/turf/open/floor/plating/mainship,
/area/shuttle/dropship/alamo)
"aK" = (
/turf/open/floor/iron/half{
	dir = 4;
	color = "#444444"
	},
/area/shuttle/dropship/alamo)
"bk" = (
/obj/effect/turf_decal/warning_stripes/thin{
	dir = 6
	},
/turf/open/floor/plating/mainship,
/area/shuttle/dropship/alamo)
"cM" = (
/obj/machinery/door/airlock/dropship_hatch/left/two{
	dir = 8
	},
/obj/machinery/door/poddoor/shutters/transit/open{
	dir = 8
	},
/turf/open/floor/plating/mainship,
/area/shuttle/dropship/alamo)
"ek" = (
/turf/open/floor/plating/mainship,
/area/shuttle/dropship/alamo)
"eD" = (
/obj/structure/sign/directions/command{
	dir = 4
	},
/turf/closed/wall/shuttle,
/area/shuttle/dropship/alamo)
"ga" = (
/obj/machinery/light{
	dir = 8
	},
/obj/structure/bed/chair/dropship/doublewide/left,
/obj/structure/bed/chair/dropship/doublewide/right,
/turf/open/floor/plating/mainship,
/area/shuttle/dropship/alamo)
"it" = (
/obj/structure/prop/mainship/railing{
	dir = 4
	},
/obj/machinery/vending/cola/alamo,
/turf/open/floor/plating/mainship,
/area/shuttle/dropship/alamo)
"iu" = (
/obj/structure/engine/thruster{
	dir = 1
	},
/turf/template_noop,
/area/shuttle/dropship/alamo)
"jf" = (
/obj/structure/catwalk,
/obj/machinery/light,
/turf/open/floor/plating,
/area/shuttle/dropship/alamo)
"jl" = (
/obj/effect/turf_decal/loading_area/white{
	dir = 8
	},
/obj/machinery/door/poddoor/shutters/transit/open,
/turf/open/floor/iron/corner{
	dir = 8;
	color = "#444444"
	},
/area/shuttle/dropship/alamo)
"jw" = (
/obj/machinery/light{
	dir = 4
	},
/obj/structure/bed/chair/dropship/doublewide/left,
/obj/structure/bed/chair/dropship/doublewide/right,
/obj/item/radio/intercom/dropship,
/turf/open/floor/plating/mainship,
/area/shuttle/dropship/alamo)
"lD" = (
/obj/structure/bed/chair/dropship/doublewide/left,
/obj/structure/bed/chair/dropship/doublewide/right,
/turf/open/floor/plating/mainship,
/area/shuttle/dropship/alamo)
"mX" = (
/obj/structure/table/mainship/nometal,
/obj/machinery/camera/autoname/mainship/dropship_one{
	dir = 8
	},
/turf/open/floor/iron/smooth,
/area/shuttle/dropship/alamo)
"nF" = (
/obj/machinery/computer/camera_advanced/shuttle_docker/flyable/dropship,
/obj/structure/bed/chair/dropship/pilot{
	dir = 1
	},
/turf/open/floor/iron/smooth,
/area/shuttle/dropship/alamo)
"oD" = (
/obj/structure/bed/chair/dropship/doublewide/left/charlie,
/obj/structure/bed/chair/dropship/doublewide/right/delta,
/turf/open/floor/plating/mainship,
/area/shuttle/dropship/alamo)
"rS" = (
/obj/machinery/computer/camera_advanced{
	dir = 1
	},
/obj/structure/table/mainship/nometal,
/turf/open/floor/iron/smooth,
/area/shuttle/dropship/alamo)
"sj" = (
/obj/structure/engine/right{
	dir = 1
	},
/turf/template_noop,
/area/shuttle/dropship/alamo)
"sp" = (
/obj/machinery/vending/nanomed{
	dir = 4
	},
/turf/open/floor/plating/mainship,
/area/shuttle/dropship/alamo)
"sL" = (
/obj/vehicle/sealed/armored/turret{
	dir = 4
	},
/turf/open/floor/plating,
/area/shuttle/dropship/alamo)
"sM" = (
/obj/machinery/computer/camera_advanced/overwatch/main,
/obj/machinery/light{
	dir = 8
	},
/turf/open/floor/mainship/blue{
	dir = 9
	},
/area/shuttle/dropship/alamo)
"ve" = (
/obj/effect/turf_decal/warning_stripes/thin{
	dir = 6
	},
/obj/structure/bed/chair/dropship/doublewide/left,
/obj/structure/bed/chair/dropship/doublewide/right,
/turf/open/floor/plating/mainship,
/area/shuttle/dropship/alamo)
"yY" = (
/obj/machinery/door/poddoor/shutters/transit/open{
	dir = 8
	},
/obj/structure/window/framed/shuttle,
/turf/open/floor/plating/mainship,
/area/shuttle/dropship/alamo)
"zg" = (
/obj/structure/catwalk,
/obj/machinery/camera/autoname/mainship/dropship_one{
	dir = 1
	},
/turf/open/floor/plating,
/area/shuttle/dropship/alamo)
"zF" = (
/obj/vehicle/sealed/armored/turret{
	dir = 8
	},
/turf/open/floor/plating,
/area/shuttle/dropship/alamo)
"zV" = (
/turf/template_noop,
/area/template_noop)
"BN" = (
/obj/structure/bed/chair/dropship/doublewide/right,
/obj/structure/bed/chair/dropship/doublewide/left,
/turf/open/floor/plating/mainship,
/area/shuttle/dropship/alamo)
"Ci" = (
/turf/open/floor/iron/large{
	color = "#444444"
	},
/area/shuttle/dropship/alamo)
"Db" = (
/obj/structure/engine/thruster/right{
	dir = 1
	},
/turf/template_noop,
/area/shuttle/dropship/alamo)
"DZ" = (
/turf/open/floor/iron/corner{
	color = "#444444"
	},
/area/shuttle/dropship/alamo)
"EH" = (
/obj/machinery/door/airlock/mainship/command{
	dir = 1
	},
/turf/open/floor/iron/smooth,
/area/shuttle/dropship/alamo)
"Gj" = (
/obj/machinery/cic_maptable/drawable,
/obj/item/radio/intercom/dropship{
	dir = 4
	},
/turf/open/floor/mainship/blue{
	dir = 10
	},
/area/shuttle/dropship/alamo)
"Ha" = (
/turf/open/floor/mainship/blue{
	dir = 6
	},
/area/shuttle/dropship/alamo)
"HE" = (
/turf/closed/wall/shuttle,
/area/shuttle/dropship/alamo)
"IP" = (
/obj/effect/turf_decal/warning_stripes/thin{
	dir = 1;
	pixel_y = 1
	},
/turf/open/floor/plating/mainship/striped,
/area/shuttle/dropship/alamo)
"IY" = (
/obj/machinery/holopad,
/turf/open/floor/iron/smooth,
/area/shuttle/dropship/alamo)
"Js" = (
/obj/effect/turf_decal/warning_stripes/thin,
/obj/structure/prop/mainship/railing,
/turf/open/floor/plating/mainship,
/area/shuttle/dropship/alamo)
"JC" = (
/obj/structure/engine{
	dir = 1
	},
/turf/template_noop,
/area/shuttle/dropship/alamo)
"KL" = (
/turf/open/floor/iron/corner{
	dir = 4;
	color = "#444444"
	},
/area/shuttle/dropship/alamo)
"KM" = (
/obj/structure/window/framed/mainship/canterbury/dropship/reinforced,
/turf/open/floor/iron/smooth,
/area/shuttle/dropship/alamo)
"Mt" = (
/turf/open/floor/iron/smooth,
/area/shuttle/dropship/alamo)
"MS" = (
/obj/structure/bed/chair/dropship/doublewide/left/alpha,
/obj/structure/bed/chair/dropship/doublewide/right/bravo,
/turf/open/floor/plating/mainship,
/area/shuttle/dropship/alamo)
"MU" = (
/obj/machinery/light{
	dir = 1
	},
/turf/open/floor/iron/half{
	dir = 4;
	color = "#444444"
	},
/area/shuttle/dropship/alamo)
"OH" = (
/obj/effect/turf_decal/warning_stripes/thin{
	dir = 1;
	pixel_y = 1
	},
/obj/structure/prop/mainship/railing{
	dir = 1
	},
/turf/open/floor/plating/mainship/striped,
/area/shuttle/dropship/alamo)
"OM" = (
/turf/open/floor/iron/half{
	dir = 1;
	color = "#444444"
	},
/area/shuttle/dropship/alamo)
"PF" = (
/obj/structure/bed/chair/dropship/doublewide/fieldcommander,
/obj/item/radio/intercom/dropship,
/obj/machinery/light{
	dir = 1
	},
/turf/open/floor/plating/mainship,
/area/shuttle/dropship/alamo)
"Qv" = (
/obj/effect/turf_decal/warning_stripes/thin{
	dir = 1;
	pixel_y = 1
	},
/obj/machinery/power/apc{
	dir = 8
	},
/turf/open/floor/plating/mainship/striped,
/area/shuttle/dropship/alamo)
"QU" = (
/obj/structure/window/framed/shuttle,
/turf/open/floor/plating,
/area/shuttle/dropship/alamo)
"RE" = (
/obj/effect/turf_decal/warning_stripes/thin,
/obj/machinery/vending/nanomed{
	dir = 8
	},
/turf/open/floor/plating/mainship,
/area/shuttle/dropship/alamo)
"Sa" = (
/obj/effect/turf_decal/warning_stripes/thin,
/obj/machinery/telecomms/relay/preset/telecomms/onboard/nondense,
/obj/docking_port/mobile/marine_dropship/one,
/turf/open/floor/plating/mainship,
/area/shuttle/dropship/alamo)
"TG" = (
/obj/structure/bed/chair/office/dark{
	dir = 8
	},
/turf/open/floor/mainship/blue{
	dir = 5
	},
/area/shuttle/dropship/alamo)
"Vj" = (
/obj/structure/engine/atmosphere{
	dir = 1
	},
/turf/template_noop,
/area/shuttle/dropship/alamo)
"Vw" = (
/obj/machinery/vending/cigarette,
/obj/structure/prop/mainship/railing{
	dir = 4
	},
/turf/open/floor/plating/mainship,
/area/shuttle/dropship/alamo)
"VZ" = (
/obj/effect/turf_decal/loading_area/white{
	dir = 8
	},
/obj/machinery/door/poddoor/shutters/transit/open,
/turf/open/floor/iron/corner{
	dir = 1;
	color = "#444444"
	},
/area/shuttle/dropship/alamo)
"XP" = (
/obj/machinery/camera/autoname/mainship/dropship_one{
	dir = 4
	},
/turf/open/floor/plating/mainship,
/area/shuttle/dropship/alamo)
"Yx" = (
/obj/structure/catwalk,
/turf/open/floor/plating,
/area/shuttle/dropship/alamo)
"YY" = (
/obj/effect/turf_decal/loading_area/white{
	dir = 8
	},
/obj/machinery/door/poddoor/shutters/transit/open,
/turf/open/floor/iron/half{
	dir = 1;
	color = "#444444"
	},
/area/shuttle/dropship/alamo)
"Zg" = (
/turf/open/floor/plating/mainship/striped,
/area/shuttle/dropship/alamo)
"Zq" = (
/obj/machinery/door/airlock/dropship_hatch/left/two,
/obj/machinery/door/poddoor/shutters/transit/open,
/turf/open/floor/plating/mainship,
/area/shuttle/dropship/alamo)
"Zy" = (
/obj/effect/turf_decal/warning_stripes/thin{
	dir = 5
	},
/turf/open/floor/plating/mainship/striped,
/area/shuttle/dropship/alamo)

(1,1,1) = {"
zV
zV
zV
zF
zV
zV
zV
zV
HE
yY
yY
yY
HE
Vj
zV
zV
zV
zV
"}
(2,1,1) = {"
zV
zV
Vj
HE
HE
cM
cM
HE
HE
PF
MS
oD
HE
HE
HE
zV
zV
zV
"}
(3,1,1) = {"
HE
HE
HE
eD
ga
ek
ek
XP
sp
ek
ek
ek
Zg
jf
HE
HE
zV
zV
"}
(4,1,1) = {"
QU
sM
Gj
KM
lD
ek
lD
lD
bk
it
aB
Vw
Zy
Yx
Yx
HE
HE
zV
"}
(5,1,1) = {"
QU
TG
Ha
KM
lD
ek
lD
ve
Js
DZ
OM
KL
OH
Yx
Yx
HE
JC
iu
"}
(6,1,1) = {"
QU
Mt
IY
EH
ek
ek
lD
lD
Sa
aK
Ci
aK
IP
Yx
zg
HE
HE
zV
"}
(7,1,1) = {"
QU
nF
Mt
KM
lD
ek
lD
lD
Js
aK
Ci
aK
OH
Yx
Yx
HE
sj
Db
"}
(8,1,1) = {"
QU
rS
mX
KM
lD
ek
BN
BN
Js
aK
Ci
aK
OH
Yx
Yx
HE
HE
zV
"}
(9,1,1) = {"
HE
HE
HE
HE
jw
ek
ek
ek
RE
aK
Ci
aK
Qv
jf
HE
HE
zV
zV
"}
(10,1,1) = {"
zV
zV
Vj
HE
HE
Zq
Zq
HE
HE
MU
Ci
aK
HE
HE
HE
zV
zV
zV
"}
(11,1,1) = {"
zV
zV
zV
sL
zV
zV
zV
zV
HE
jl
YY
VZ
HE
Vj
zV
zV
zV
zV
"}
