//MAP CONVERTED BY dmm2tgm.py THIS HEADER COMMENT PREVENTS RECONVERSION, DO NOT REMOVE
"aA" = (
/obj/structure/bed/chair/dropship/doublewide/left,
/obj/structure/bed/chair/dropship/doublewide/right,
/obj/machinery/light/small,
/turf/open/floor/plating,
/area/shuttle/dropship/alamo)
"aD" = (
/obj/effect/turf_decal/warning_stripes/thick{
	dir = 1
	},
/obj/effect/turf_decal/warning_stripes/thin{
	dir = 6
	},
/turf/open/floor/iron/smooth_large,
/area/shuttle/dropship/alamo)
"be" = (
/obj/effect/turf_decal/warning_stripes/thin{
	dir = 4
	},
/obj/effect/turf_decal/warning_stripes/thin{
	dir = 9
	},
/turf/open/floor/iron/smooth_large,
/area/shuttle/dropship/alamo)
"bj" = (
/obj/effect/turf_decal/warning_stripes/thick{
	dir = 1
	},
/obj/effect/turf_decal/warning_stripes/thin{
	dir = 10
	},
/turf/open/floor/iron/smooth_large,
/area/shuttle/dropship/alamo)
"dg" = (
/obj/effect/turf_decal/warning_stripes/thin{
	dir = 4
	},
/obj/effect/turf_decal/warning_stripes/thin{
	dir = 10
	},
/turf/open/floor/iron/smooth_large,
/area/shuttle/dropship/alamo)
"gE" = (
/obj/effect/turf_decal/warning_stripes/thin{
	dir = 5
	},
/obj/machinery/door/airlock/dropship_hatch/left/two{
	dir = 2
	},
/obj/machinery/door/poddoor/shutters/transit/open{
	dir = 2
	},
/turf/open/floor/iron/smooth_large,
/area/shuttle/dropship/alamo)
"gK" = (
/obj/effect/turf_decal/warning_stripes/thin{
	dir = 1;
	pixel_y = 1
	},
/obj/item/radio/intercom/dropship{
	dir = 1
	},
/turf/open/floor/iron/smooth_large,
/area/shuttle/dropship/alamo)
"gX" = (
/obj/effect/turf_decal/loading_area/white,
/obj/machinery/door/poddoor/shutters/transit/open{
	dir = 2
	},
/obj/machinery/light/small{
	dir = 4
	},
/turf/open/floor/iron/textured{
	color = "#555555"
	},
/area/shuttle/dropship/alamo)
"mB" = (
/turf/closed/wall/mainship,
/area/shuttle/dropship/alamo)
"mM" = (
/obj/effect/turf_decal/warning_stripes/thin,
/turf/open/floor/iron/smooth_large,
/area/shuttle/dropship/alamo)
"nY" = (
/obj/effect/turf_decal/loading_area/white,
/obj/machinery/door/poddoor/shutters/transit/open{
	dir = 2
	},
/turf/open/floor/iron/textured{
	color = "#555555"
	},
/area/shuttle/dropship/alamo)
"os" = (
/obj/effect/turf_decal/warning_stripes/thin{
	dir = 8
	},
/obj/effect/turf_decal/warning_stripes/thin{
	dir = 4
	},
/turf/open/floor/iron/smooth_large,
/area/shuttle/dropship/alamo)
"pg" = (
/obj/structure/supply_drop,
/turf/open/floor/plating,
/area/shuttle/dropship/alamo)
"pU" = (
/obj/structure/table/mainship,
/obj/machinery/computer/emails,
/turf/open/floor/iron/smooth_large,
/area/shuttle/dropship/alamo)
"qO" = (
/obj/effect/turf_decal/warning_stripes/thin{
	dir = 4
	},
/turf/open/floor/iron/smooth_large,
/area/shuttle/dropship/alamo)
"so" = (
/obj/structure/prop/mainship/massdiver,
/turf/open/floor/plating,
/area/shuttle/dropship/alamo)
"sx" = (
/turf/open/space/basic,
/area/template_noop)
"uE" = (
/obj/effect/turf_decal/loading_area/white,
/obj/machinery/door/poddoor/shutters/transit/open{
	dir = 2
	},
/obj/machinery/light/small{
	dir = 8
	},
/turf/open/floor/iron/textured{
	color = "#555555"
	},
/area/shuttle/dropship/alamo)
"xo" = (
/obj/structure/engine/thruster{
	dir = 1
	},
/turf/template_noop,
/area/shuttle/dropship/alamo)
"yj" = (
/obj/structure/bed/chair/dropship/pilot{
	dir = 1
	},
/obj/machinery/computer/camera_advanced/shuttle_docker/flyable/dropship,
/turf/open/floor/iron/smooth_large,
/area/shuttle/dropship/alamo)
"AE" = (
/turf/open/floor/plating,
/area/shuttle/dropship/alamo)
"AP" = (
/obj/effect/turf_decal/warning_stripes/thin{
	dir = 8
	},
/turf/open/floor/iron/smooth_large,
/area/shuttle/dropship/alamo)
"Bf" = (
/obj/effect/turf_decal/warning_stripes/thin{
	dir = 8
	},
/obj/effect/turf_decal/warning_stripes/thin{
	dir = 6
	},
/turf/open/floor/iron/smooth_large,
/area/shuttle/dropship/alamo)
"BF" = (
/obj/effect/turf_decal/warning_stripes/thin{
	dir = 9
	},
/obj/machinery/door/airlock/dropship_hatch/left/two{
	dir = 2
	},
/obj/machinery/door/poddoor/shutters/transit/open{
	dir = 2
	},
/turf/open/floor/iron/smooth_large,
/area/shuttle/dropship/alamo)
"BT" = (
/obj/machinery/telecomms/relay/preset/telecomms/onboard/nondense,
/obj/docking_port/mobile/marine_dropship/one,
/obj/effect/turf_decal/warning_stripes/thin,
/obj/machinery/holopad,
/turf/open/floor/iron/smooth_large,
/area/shuttle/dropship/alamo)
"Ea" = (
/obj/structure/catwalk,
/turf/open/floor/plating,
/area/shuttle/dropship/alamo)
"Eo" = (
/obj/effect/turf_decal/warning_stripes/thick{
	dir = 1
	},
/obj/effect/turf_decal/warning_stripes/thin,
/obj/machinery/camera/autoname/mainship/dropship_one{
	dir = 4
	},
/obj/machinery/light/small{
	dir = 8
	},
/turf/open/floor/iron/smooth_large,
/area/shuttle/dropship/alamo)
"Hp" = (
/obj/structure/engine{
	dir = 1
	},
/turf/template_noop,
/area/shuttle/dropship/alamo)
"HX" = (
/obj/structure/bed/chair/dropship/doublewide/left,
/obj/structure/bed/chair/dropship/doublewide/right,
/turf/open/floor/plating,
/area/shuttle/dropship/alamo)
"Jw" = (
/obj/effect/turf_decal/warning_stripes/thin{
	dir = 8
	},
/obj/effect/turf_decal/warning_stripes/thin{
	dir = 5
	},
/turf/open/floor/iron/smooth_large,
/area/shuttle/dropship/alamo)
"MH" = (
/obj/structure/bed/chair/dropship/doublewide/left,
/obj/structure/bed/chair/dropship/doublewide/right,
/obj/machinery/light/small{
	dir = 8
	},
/turf/open/floor/plating,
/area/shuttle/dropship/alamo)
"Nk" = (
/obj/structure/engine/thruster/right{
	dir = 1
	},
/turf/template_noop,
/area/shuttle/dropship/alamo)
"PM" = (
/obj/structure/bed/chair/dropship/doublewide/left,
/obj/structure/bed/chair/dropship/doublewide/right,
/obj/machinery/light/small{
	dir = 4
	},
/turf/open/floor/plating,
/area/shuttle/dropship/alamo)
"Qi" = (
/obj/structure/table/mainship,
/turf/open/floor/iron/smooth_large,
/area/shuttle/dropship/alamo)
"Qm" = (
/obj/effect/turf_decal/warning_stripes/thick{
	dir = 1
	},
/turf/open/floor/iron/smooth_large,
/area/shuttle/dropship/alamo)
"QW" = (
/obj/effect/turf_decal/warning_stripes/thick{
	dir = 1
	},
/obj/effect/turf_decal/warning_stripes/thin,
/obj/machinery/vending/nanomed{
	dir = 8
	},
/obj/machinery/light/small{
	dir = 4
	},
/turf/open/floor/iron/smooth_large,
/area/shuttle/dropship/alamo)
"Re" = (
/obj/structure/window/framed/shuttle,
/turf/open/floor/plating,
/area/shuttle/dropship/alamo)
"RP" = (
/obj/effect/turf_decal/warning_stripes/thin{
	dir = 1;
	pixel_y = 1
	},
/obj/machinery/power/apc{
	dir = 1
	},
/turf/open/floor/iron/smooth_large,
/area/shuttle/dropship/alamo)
"Su" = (
/obj/effect/turf_decal/warning_stripes/thin{
	dir = 1;
	pixel_y = 1
	},
/obj/machinery/vending/nanomed{
	dir = 1
	},
/turf/open/floor/iron/smooth_large,
/area/shuttle/dropship/alamo)
"TN" = (
/obj/structure/engine/right{
	dir = 1
	},
/turf/template_noop,
/area/shuttle/dropship/alamo)
"VL" = (
/obj/structure/engine/atmosphere{
	dir = 1
	},
/turf/template_noop,
/area/shuttle/dropship/alamo)
"Xe" = (
/obj/structure/bed/chair/dropship/doublewide/left,
/obj/structure/bed/chair/dropship/doublewide/right,
/obj/machinery/camera/autoname/mainship/dropship_one{
	dir = 4
	},
/turf/open/floor/plating,
/area/shuttle/dropship/alamo)
"ZR" = (
/turf/closed/wall/shuttle,
/area/shuttle/dropship/alamo)

(1,1,1) = {"
ZR
ZR
ZR
ZR
ZR
ZR
VL
sx
sx
sx
sx
VL
ZR
Hp
xo
sx
"}
(2,1,1) = {"
nY
Ea
Ea
Ea
Ea
ZR
ZR
ZR
ZR
ZR
ZR
ZR
ZR
ZR
ZR
ZR
"}
(3,1,1) = {"
nY
Ea
Ea
Ea
Ea
Eo
HX
HX
MH
HX
HX
MH
Xe
HX
aA
ZR
"}
(4,1,1) = {"
nY
Ea
Ea
Ea
Ea
bj
AP
AP
Bf
os
os
os
os
os
Jw
BF
"}
(5,1,1) = {"
gX
Ea
Ea
Ea
Ea
Qm
pU
pU
mM
AE
AE
AE
AE
AE
gK
ZR
"}
(6,1,1) = {"
mB
Re
Re
Re
Re
Qm
Qi
yj
BT
AE
AE
AE
AE
AE
RP
ZR
"}
(7,1,1) = {"
uE
Ea
Ea
Ea
Ea
Qm
so
pg
mM
AE
AE
AE
AE
AE
Su
ZR
"}
(8,1,1) = {"
nY
Ea
Ea
Ea
Ea
aD
qO
qO
dg
os
os
os
os
os
be
gE
"}
(9,1,1) = {"
nY
Ea
Ea
Ea
Ea
QW
HX
HX
PM
HX
HX
PM
HX
HX
aA
ZR
"}
(10,1,1) = {"
nY
Ea
Ea
Ea
Ea
ZR
ZR
ZR
ZR
ZR
ZR
ZR
ZR
ZR
ZR
ZR
"}
(11,1,1) = {"
ZR
ZR
ZR
ZR
ZR
ZR
VL
sx
sx
sx
sx
VL
ZR
TN
Nk
sx
"}
