//MAP CONVERTED BY dmm2tgm.py THIS HEADER COMMENT PREVENTS RECONVERSION, DO NOT REMOVE
"c" = (
/turf/open/space/basic,
/area/template_noop)
"A" = (
/turf/open/space/basic,
/area/shuttle/dropship/alamo)

(1,1,1) = {"
c
c
c
c
A
c
c
c
c
c
c
A
A
A
A
A
"}
(2,1,1) = {"
c
c
A
A
A
A
A
A
A
A
A
A
A
A
A
c
"}
(3,1,1) = {"
c
c
A
A
A
A
A
A
A
A
A
A
A
A
A
c
"}
(4,1,1) = {"
c
A
A
A
A
A
A
A
A
A
A
A
A
A
A
c
"}
(5,1,1) = {"
A
A
A
A
A
A
A
A
A
A
A
A
A
A
A
c
"}
(6,1,1) = {"
A
A
A
A
A
A
A
A
A
A
A
A
A
A
A
c
"}
(7,1,1) = {"
A
A
A
A
A
A
A
A
A
A
A
A
A
A
A
c
"}
(8,1,1) = {"
c
A
A
A
A
A
A
A
A
A
A
A
A
A
A
c
"}
(9,1,1) = {"
c
c
A
A
A
A
A
A
A
A
A
A
A
A
A
c
"}
(10,1,1) = {"
c
c
A
A
A
A
A
A
A
A
A
A
A
A
A
c
"}
(11,1,1) = {"
c
c
c
c
A
c
c
c
c
c
c
A
A
A
A
A
"}
