//MAP CONVERTED BY dmm2tgm.py THIS HEADER COMMENT PREVENTS RECONVERSION, DO NOT REMOVE
"a" = (
/turf/open/shuttle/elevator/grating,
/area/shuttle/dropship/minielevator{
	ceiling = 2
	})
"c" = (
/obj/machinery/door/poddoor/shutters/transit/nonsmoothing{
	dir = 2
	},
/turf/open/shuttle/elevator/grating,
/area/shuttle/dropship/minielevator{
	ceiling = 2
	})
"d" = (
/obj/machinery/door/poddoor/shutters/transit/nonsmoothing,
/turf/open/shuttle/elevator/grating,
/area/shuttle/dropship/minielevator{
	ceiling = 2
	})
"i" = (
/obj/machinery/door/poddoor/shutters/transit/nonsmoothing,
/turf/open/floor/mainship/stripesquare,
/area/shuttle/dropship/minielevator{
	ceiling = 2
	})
"t" = (
/obj/docking_port/mobile/shuttle/elevator,
/turf/open/shuttle/elevator/grating,
/area/shuttle/dropship/minielevator{
	ceiling = 2
	})
"B" = (
/turf/closed/wall/mainship,
/area/shuttle/dropship/minielevator{
	ceiling = 2
	})
"C" = (
/obj/machinery/door/poddoor/shutters/transit/nonsmoothing{
	dir = 2
	},
/turf/open/floor/mainship/stripesquare,
/area/shuttle/dropship/minielevator{
	ceiling = 2
	})
"G" = (
/obj/machinery/computer/shuttle/shuttle_control/elevator{
	pixel_y = 15;
	density = 0;
	max_integrity = 5000
	},
/turf/open/shuttle/elevator/grating,
/area/shuttle/dropship/minielevator{
	ceiling = 2
	})
"S" = (
/obj/machinery/status_display,
/turf/closed/wall/mainship,
/area/shuttle/dropship/minielevator{
	ceiling = 2
	})
"U" = (
/obj/effect/soundplayer,
/turf/closed/wall/mainship,
/area/shuttle/dropship/minielevator{
	ceiling = 2
	})

(1,1,1) = {"
U
i
d
i
C
"}
(2,1,1) = {"
S
a
a
a
C
"}
(3,1,1) = {"
B
G
t
a
c
"}
(4,1,1) = {"
B
a
a
a
C
"}
(5,1,1) = {"
B
B
d
B
B
"}
