//MAP CONVERTED BY dmm2tgm.py THIS HEADER COMMENT PREVENTS RECONVERSION, DO NOT REMOVE
"a" = (
/turf/open/space/basic,
/area/space)
"c" = (
/obj/structure/barricade/plasteel{
	dir = 4
	},
/obj/machinery/light{
	dir = 1
	},
/turf/open/floor/mainship/mono,
/area/shuttle/minidropship)
"d" = (
/obj/structure/bed/chair/dropship/passenger{
	dir = 1
	},
/obj/machinery/vending/nanomed/tadpolemed{
	dir = 4;
	pixel_x = -15
	},
/turf/open/floor/mainship/mono,
/area/shuttle/minidropship)
"e" = (
/obj/structure/dropship_piece/two/weapon/rightright{
	dir = 1;
	pixel_y = 32
	},
/obj/effect/attach_point/weapon/minidropship{
	equipment_offset_y = 25
	},
/obj/structure/dropship_piece/tadpole/engine{
	dir = 1;
	pixel_x = 23
	},
/turf/closed/shuttle/dropship2/rearcorner/tadpole{
	dir = 1
	},
/area/shuttle/minidropship)
"g" = (
/obj/structure/dropship_piece/tadpole/rearleft{
	dir = 1
	},
/turf/template_noop,
/area/shuttle/minidropship)
"j" = (
/obj/docking_port/mobile/marine_dropship/minidropship,
/obj/structure/bed/chair/dropship/pilot{
	dir = 1
	},
/turf/open/floor/mainship/mono,
/area/shuttle/minidropship)
"m" = (
/obj/effect/attach_point/crew_weapon/minidropship{
	pixel_x = -21
	},
/turf/open/floor/mainship/mono,
/area/shuttle/minidropship)
"n" = (
/turf/closed/wall/mainship/outer/canterbury,
/area/space)
"p" = (
/obj/structure/dropship_piece/tadpole/rearright{
	dir = 1
	},
/turf/template_noop,
/area/shuttle/minidropship)
"q" = (
/obj/effect/attach_point/crew_weapon/minidropship{
	pixel_x = 23
	},
/turf/open/floor/mainship/mono,
/area/shuttle/minidropship)
"r" = (
/obj/machinery/computer/camera_advanced/shuttle_docker/minidropship,
/turf/open/floor/plating/plating_catwalk,
/area/shuttle/minidropship)
"s" = (
/obj/structure/barricade/plasteel{
	dir = 8
	},
/obj/structure/barricade/plasteel,
/obj/structure/barricade/plasteel{
	dir = 1
	},
/turf/open/floor/mainship/mono,
/area/shuttle/minidropship)
"w" = (
/obj/structure/barricade/plasteel{
	dir = 8
	},
/obj/machinery/light{
	dir = 1
	},
/turf/open/floor/mainship/mono,
/area/shuttle/minidropship)
"G" = (
/obj/structure/dropship_piece/tadpole/engine{
	dir = 1;
	pixel_x = 23;
	pixel_y = -14
	},
/obj/structure/barricade/plasteel{
	dir = 4
	},
/obj/machinery/light,
/turf/open/floor/mainship/mono,
/area/shuttle/minidropship)
"J" = (
/obj/structure/dropship_piece/tadpole/engine{
	dir = 1;
	pixel_x = -24;
	pixel_y = -14
	},
/obj/structure/barricade/plasteel{
	dir = 8
	},
/obj/machinery/light,
/turf/open/floor/mainship/mono,
/area/shuttle/minidropship)
"O" = (
/obj/structure/dropship_piece/two/weapon/leftleft{
	dir = 1;
	pixel_y = 32
	},
/obj/structure/dropship_piece/tadpole/engine{
	dir = 1;
	pixel_x = -23
	},
/obj/effect/attach_point/weapon/minidropship{
	equipment_offset_y = 25
	},
/turf/closed/shuttle/dropship2/rearcorner/alt/tadpole{
	dir = 1
	},
/area/shuttle/minidropship)
"P" = (
/obj/structure/barricade/plasteel{
	dir = 4
	},
/obj/structure/barricade/plasteel{
	dir = 1
	},
/obj/structure/barricade/plasteel,
/turf/open/floor/mainship/mono,
/area/shuttle/minidropship)
"R" = (
/obj/structure/bed/chair/dropship/passenger{
	dir = 1;
	pixel_x = -7
	},
/obj/structure/bed/chair/dropship/passenger{
	dir = 1;
	pixel_x = 8
	},
/turf/open/floor/mainship/mono,
/area/shuttle/minidropship)
"U" = (
/obj/machinery/telecomms/relay/preset/telecomms/onboard,
/turf/closed/wall/mainship/outer/canterbury,
/area/space)
"V" = (
/obj/structure/bed/chair/dropship/passenger{
	dir = 1
	},
/obj/docking_port/mobile/marine_dropship/minidropship,
/turf/open/floor/mainship/mono,
/area/shuttle/minidropship)
"X" = (
/obj/structure/window/framed/mainship/canterbury/dropship/reinforced,
/turf/open/floor/mainship/mono,
/area/shuttle/minidropship)

(1,1,1) = {"
a
a
a
s
a
a
a
a
a
"}
(2,1,1) = {"
a
O
w
m
J
g
a
a
n
"}
(3,1,1) = {"
X
r
j
R
V
d
U
n
n
"}
(4,1,1) = {"
a
e
c
q
G
p
a
a
n
"}
(5,1,1) = {"
a
a
a
P
a
a
a
a
a
"}
