//MAP CONVERTED BY dmm2tgm.py THIS HEADER COMMENT PREVENTS RECONVERSION, DO NOT REMOVE
"a" = (
/obj/structure/shuttle/engine/propulsion/burst/right,
/turf/open/shuttle/dropship/three,
/area/shuttle/minidropship)
"b" = (
/obj/structure/window/framed/mainship/spaceworthy{
	icon_state = "col_window10"
	},
/turf/open/floor/mainship_hull,
/area/shuttle/minidropship)
"e" = (
/obj/structure/barricade/plasteel{
	dir = 4
	},
/turf/open/floor/mainship_hull,
/area/shuttle/minidropship)
"h" = (
/obj/structure/window/framed/mainship/spaceworthy{
	icon_state = "col_window1"
	},
/turf/open/floor/mainship_hull,
/area/shuttle/minidropship)
"k" = (
/turf/open/shuttle/dropship/grating,
/area/shuttle/minidropship)
"n" = (
/obj/structure/bed/chair/dropship/pilot{
	dir = 1
	},
/turf/open/floor/mainship_hull,
/area/shuttle/minidropship)
"p" = (
/obj/structure/bed/chair/dropship/passenger{
	dir = 4
	},
/turf/open/floor/mainship_hull,
/area/shuttle/minidropship)
"r" = (
/turf/open/floor/mainship_hull,
/area/shuttle/minidropship)
"s" = (
/obj/structure/window/framed/mainship/spaceworthy{
	icon_state = "col_window6"
	},
/turf/open/floor/mainship_hull,
/area/shuttle/minidropship)
"t" = (
/obj/structure/bed/chair/dropship/passenger{
	dir = 1
	},
/obj/machinery/light,
/obj/structure/barricade/plasteel{
	dir = 4
	},
/turf/open/floor/mainship_hull,
/area/shuttle/minidropship)
"v" = (
/obj/machinery/door/poddoor/mainship/open{
	dir = 2;
	id = "minidropship_podlock"
	},
/obj/machinery/door/poddoor/shutters/transit{
	dir = 2
	},
/obj/structure/barricade/plasteel,
/turf/open/shuttle/dropship/five,
/area/shuttle/minidropship)
"B" = (
/obj/structure/bed/chair/dropship/passenger{
	dir = 1
	},
/obj/machinery/light,
/obj/structure/barricade/plasteel{
	dir = 8
	},
/turf/open/floor/mainship_hull,
/area/shuttle/minidropship)
"E" = (
/turf/template_noop,
/area/space)
"F" = (
/obj/docking_port/mobile/marine_dropship/minidropship,
/turf/open/shuttle/dropship/grating,
/area/shuttle/minidropship)
"H" = (
/obj/structure/barricade/plasteel{
	dir = 8
	},
/turf/open/floor/mainship_hull,
/area/shuttle/minidropship)
"I" = (
/obj/effect/attach_point/weapon/minidropship,
/turf/closed/wall/mainship/outer/reinforced,
/area/shuttle/minidropship)
"K" = (
/obj/machinery/door_control{
	id = "minidropship_podlock";
	name = "outer door-control";
	pixel_y = 32
	},
/obj/structure/bed/chair/dropship/passenger{
	dir = 8
	},
/turf/open/floor/mainship_hull,
/area/shuttle/minidropship)
"L" = (
/obj/machinery/computer/camera_advanced/shuttle_docker/minidropship,
/turf/open/floor/mainship_hull,
/area/shuttle/minidropship)
"N" = (
/obj/structure/window/framed/mainship/spaceworthy{
	icon_state = "col_window12"
	},
/turf/open/floor/mainship_hull,
/area/shuttle/minidropship)
"O" = (
/obj/structure/bed/chair/dropship/passenger,
/obj/machinery/light{
	dir = 1
	},
/obj/structure/barricade/plasteel{
	dir = 8
	},
/turf/open/floor/mainship_hull,
/area/shuttle/minidropship)
"R" = (
/obj/structure/shuttle/engine/propulsion/burst/left,
/turf/open/shuttle/dropship/three,
/area/shuttle/minidropship)
"S" = (
/turf/closed/wall/mainship/outer/reinforced,
/area/shuttle/minidropship)
"T" = (
/obj/structure/bed/chair/dropship/passenger,
/obj/machinery/light{
	dir = 1
	},
/obj/structure/barricade/plasteel{
	dir = 4
	},
/turf/open/floor/mainship_hull,
/area/shuttle/minidropship)
"U" = (
/obj/machinery/door/poddoor/mainship/open{
	id = "minidropship_podlock"
	},
/obj/machinery/door/poddoor/shutters/transit,
/turf/open/shuttle/dropship/three,
/area/shuttle/minidropship)
"Y" = (
/obj/effect/attach_point/crew_weapon/minidropship{
	dir = 2
	},
/turf/open/floor/plating/plating_catwalk,
/area/shuttle/minidropship)

(1,1,1) = {"
E
E
E
S
U
U
U
S
R
"}
(2,1,1) = {"
E
E
I
S
O
H
B
S
a
"}
(3,1,1) = {"
s
h
S
p
r
k
r
v
E
"}
(4,1,1) = {"
N
L
n
r
F
Y
r
v
E
"}
(5,1,1) = {"
b
h
S
K
r
k
r
v
E
"}
(6,1,1) = {"
E
E
I
S
T
e
t
S
R
"}
(7,1,1) = {"
E
E
E
S
U
U
U
S
a
"}
