//MAP CONVERTED BY dmm2tgm.py THIS HEADER COMMENT PREVENTS RECONVERSION, DO NOT REMOVE
"a" = (
/obj/machinery/door_control{
	dir = 1;
	id = "minidropship_podlock";
	name = "outer door-control"
	},
/obj/structure/dropship_piece/tadpole/tadpole_nose/right{
	pixel_y = 32;
	dir = 1
	},
/obj/structure/dropship_piece/tadpole/cockpit/right{
	dir = 1
	},
/turf/open/floor/mainship_hull/dir{
	dir = 5
	},
/area/shuttle/minidropship)
"b" = (
/obj/structure/dropship_piece/two/weapon/leftleft{
	dir = 1;
	pixel_y = 32
	},
/obj/structure/dropship_piece/tadpole/engine{
	pixel_x = -23;
	dir = 1
	},
/obj/effect/attach_point/weapon/minidropship{
	equipment_offset_y = 25
	},
/turf/closed/shuttle/tadpole{
	icon_state = "103";
	dir = 1
	},
/area/shuttle/minidropship)
"c" = (
/obj/structure/dropship_piece/two/weapon/rightright{
	dir = 1;
	pixel_y = 32
	},
/obj/effect/attach_point/weapon/minidropship{
	equipment_offset_y = 25
	},
/obj/structure/dropship_piece/tadpole/engine{
	pixel_x = 23;
	dir = 1
	},
/turf/closed/shuttle/tadpole{
	icon_state = "104";
	dir = 1
	},
/area/shuttle/minidropship)
"h" = (
/obj/structure/bed/chair/dropship/passenger{
	dir = 8
	},
/turf/open/shuttle/dropship/three,
/area/shuttle/minidropship)
"j" = (
/obj/machinery/door_control{
	id = "minidropship_podlock";
	name = "inner door-control"
	},
/obj/structure/bed/chair/dropship/passenger{
	dir = 8
	},
/turf/open/shuttle/dropship/three,
/area/shuttle/minidropship)
"n" = (
/obj/structure/dropship_piece/tadpole/tadpole_nose{
	dir = 1;
	pixel_y = 32
	},
/obj/structure/dropship_piece/tadpole/cockpit/window{
	icon_state = "109";
	dir = 1
	},
/turf/open/floor/mainship_hull/dir{
	dir = 1
	},
/area/shuttle/minidropship)
"p" = (
/obj/structure/barricade/plasteel{
	dir = 8
	},
/obj/machinery/door/poddoor/mainship/open{
	id = "minidropship_podlock"
	},
/obj/machinery/door/poddoor/shutters/transit,
/obj/machinery/light,
/turf/open/shuttle/dropship/floor,
/area/shuttle/minidropship)
"r" = (
/obj/machinery/vending/nanomed/tadpolemed{
	dir = 4
	},
/obj/structure/bed/chair/dropship/passenger{
	dir = 4
	},
/turf/open/shuttle/dropship/three,
/area/shuttle/minidropship)
"s" = (
/turf/open/shuttle/dropship/floor,
/area/shuttle/minidropship)
"u" = (
/obj/machinery/computer/camera_advanced/shuttle_docker/minidropship,
/obj/machinery/camera/autoname/mainship,
/turf/open/floor/mainship/orange,
/area/shuttle/minidropship)
"v" = (
/obj/machinery/door/poddoor/shutters/transit{
	dir = 2
	},
/obj/machinery/door/poddoor/mainship/open{
	dir = 2;
	id = "minidropship_podlock"
	},
/obj/structure/barricade/plasteel,
/turf/open/shuttle/dropship/three,
/area/shuttle/minidropship)
"y" = (
/obj/structure/barricade/plasteel{
	dir = 4
	},
/obj/machinery/door/poddoor/mainship/open{
	id = "minidropship_podlock"
	},
/obj/machinery/door/poddoor/shutters/transit,
/obj/machinery/light,
/turf/open/shuttle/dropship/floor,
/area/shuttle/minidropship)
"B" = (
/obj/structure/dropship_piece/tadpole/engine{
	pixel_x = -23;
	dir = 1;
	pixel_y = -14
	},
/turf/closed/shuttle/tadpole{
	icon_state = "52"
	},
/area/shuttle/minidropship)
"C" = (
/obj/machinery/telecomms/relay/preset/telecomms/onboard,
/obj/structure/dropship_piece/tadpole/engine{
	pixel_x = 23;
	dir = 1;
	pixel_y = -14
	},
/turf/closed/shuttle/tadpole{
	icon_state = "54"
	},
/area/shuttle/minidropship)
"D" = (
/obj/structure/dropship_piece/tadpole/cockpit/window{
	icon_state = "106";
	dir = 1
	},
/turf/open/shuttle/dropship/three,
/area/shuttle/minidropship)
"E" = (
/turf/template_noop,
/area/space)
"F" = (
/obj/docking_port/mobile/marine_dropship/minidropship,
/obj/structure/bed/chair/dropship/pilot{
	dir = 1
	},
/turf/open/shuttle/dropship/floor,
/area/shuttle/minidropship)
"I" = (
/obj/structure/closet/walllocker/hydrant/extinguisher{
	dir = 8
	},
/obj/structure/bed/chair/dropship/passenger{
	dir = 8
	},
/turf/open/shuttle/dropship/three,
/area/shuttle/minidropship)
"K" = (
/obj/structure/dropship_piece/tadpole/cockpit/window{
	icon_state = "105";
	dir = 1
	},
/turf/open/shuttle/dropship/three,
/area/shuttle/minidropship)
"L" = (
/obj/structure/dropship_piece/tadpole/rearleft{
	dir = 1
	},
/turf/template_noop,
/area/shuttle/minidropship)
"O" = (
/obj/structure/barricade/plasteel{
	dir = 8
	},
/obj/machinery/door/poddoor/mainship/open{
	id = "minidropship_podlock"
	},
/obj/machinery/door/poddoor/shutters/transit,
/obj/machinery/light{
	dir = 1
	},
/turf/open/shuttle/dropship/floor,
/area/shuttle/minidropship)
"S" = (
/obj/structure/dropship_piece/tadpole/tadpole_nose/left{
	pixel_y = 32;
	dir = 1
	},
/obj/structure/dropship_piece/tadpole/cockpit/left{
	dir = 1
	},
/turf/open/floor/mainship_hull/dir{
	dir = 9
	},
/area/shuttle/minidropship)
"T" = (
/obj/structure/barricade/plasteel{
	dir = 4
	},
/obj/machinery/door/poddoor/mainship/open{
	id = "minidropship_podlock"
	},
/obj/machinery/door/poddoor/shutters/transit,
/obj/machinery/light{
	dir = 1
	},
/turf/open/shuttle/dropship/floor,
/area/shuttle/minidropship)
"U" = (
/obj/structure/dropship_piece/tadpole/rearright{
	dir = 1
	},
/turf/template_noop,
/area/shuttle/minidropship)
"V" = (
/obj/structure/bed/chair/dropship/passenger{
	dir = 4
	},
/turf/open/shuttle/dropship/three,
/area/shuttle/minidropship)
"Y" = (
/obj/effect/attach_point/crew_weapon/minidropship,
/turf/open/shuttle/dropship/floor,
/area/shuttle/minidropship)

(1,1,1) = {"
E
E
E
E
E
E
E
E
E
"}
(2,1,1) = {"
E
E
E
b
O
p
B
L
E
"}
(3,1,1) = {"
E
E
S
K
V
V
r
v
E
"}
(4,1,1) = {"
E
E
n
u
F
Y
s
v
E
"}
(5,1,1) = {"
E
E
a
D
j
h
I
v
E
"}
(6,1,1) = {"
E
E
E
c
T
y
C
U
E
"}
(7,1,1) = {"
E
E
E
E
E
E
E
E
E
"}
