//MAP CONVERTED BY dmm2tgm.py THIS HEADER COMMENT PREVENTS RECONVERSION, DO NOT REMOVE
"a" = (
/turf/template_noop,
/area/template_noop)
"c" = (
/obj/machinery/light{
	dir = 1
	},
/turf/open/floor/mainship/mono,
/area/shuttle/minidropship)
"d" = (
/obj/machinery/vending/nanomed/tadpolemed,
/obj/machinery/light{
	dir = 1
	},
/turf/open/floor/mainship/mono,
/area/shuttle/minidropship)
"h" = (
/obj/machinery/telecomms/relay/preset/telecomms/onboard,
/turf/closed/wall/mainship/outer,
/area/shuttle/minidropship)
"l" = (
/obj/structure/dropship_piece/tadpole/engine{
	dir = 1;
	pixel_x = 23;
	pixel_y = -14
	},
/obj/machinery/door/poddoor/mainship/open{
	id = "minidropship_podlock"
	},
/obj/structure/window/framed/mainship,
/turf/open/floor/mainship/floor,
/area/shuttle/minidropship)
"p" = (
/obj/structure/closet/walllocker/hydrant/extinguisher,
/turf/open/floor/plating/plating_catwalk,
/area/shuttle/minidropship)
"r" = (
/obj/docking_port/mobile/marine_dropship/minidropship,
/obj/effect/attach_point/crew_weapon/minidropship,
/turf/open/floor/plating/plating_catwalk,
/area/shuttle/minidropship)
"t" = (
/obj/machinery/computer/camera_advanced/shuttle_docker/minidropship,
/obj/machinery/camera/autoname/mainship/dropship_two,
/turf/open/floor/plating/plating_catwalk,
/area/shuttle/minidropship)
"u" = (
/obj/structure/dropship_piece/tadpole/engine{
	dir = 1;
	pixel_x = -23;
	pixel_y = -14
	},
/obj/machinery/door/poddoor/mainship/open{
	id = "minidropship_podlock"
	},
/obj/structure/window/framed/mainship,
/turf/open/floor/mainship/floor,
/area/shuttle/minidropship)
"x" = (
/obj/machinery/light,
/obj/machinery/vending/nanoammo/directional/north,
/turf/open/floor/mainship/mono,
/area/shuttle/minidropship)
"y" = (
/obj/machinery/light,
/turf/open/floor/mainship/mono,
/area/shuttle/minidropship)
"z" = (
/obj/machinery/door/poddoor/mainship/open{
	id = "minidropship_podlock"
	},
/obj/structure/window/framed/mainship,
/turf/open/floor/mainship/floor,
/area/shuttle/minidropship)
"C" = (
/obj/structure/dropship_piece/tadpole/engine{
	dir = 1;
	pixel_x = -23
	},
/obj/machinery/door/poddoor/mainship/open{
	id = "minidropship_podlock"
	},
/obj/structure/window/framed/mainship,
/turf/open/floor/mainship/floor,
/area/shuttle/minidropship)
"G" = (
/turf/closed/wall/mainship/outer,
/area/shuttle/minidropship)
"K" = (
/obj/machinery/cic_maptable,
/turf/open/floor/mainship/mono,
/area/shuttle/minidropship)
"L" = (
/obj/machinery/door_control/minidropship{
	dir = 4;
	id = "minidropship_podlock";
	name = "inner door-control"
	},
/turf/open/floor/mainship/mono,
/area/shuttle/minidropship)
"O" = (
/turf/open/floor/mainship/mono,
/area/shuttle/minidropship)
"Q" = (
/turf/open/floor/plating/plating_catwalk,
/area/shuttle/minidropship)
"S" = (
/obj/machinery/door/poddoor/mainship/open{
	dir = 2;
	id = "minidropship_podlock"
	},
/obj/structure/window/framed/mainship,
/turf/open/floor/mainship/floor,
/area/shuttle/minidropship)
"T" = (
/obj/structure/dropship_piece/tadpole/engine{
	dir = 1;
	pixel_x = 23
	},
/obj/machinery/door/poddoor/mainship/open{
	id = "minidropship_podlock"
	},
/obj/structure/window/framed/mainship,
/turf/open/floor/mainship/floor,
/area/shuttle/minidropship)
"V" = (
/obj/machinery/door/airlock/mainship/command{
	dir = 1;
	opacity = 0
	},
/obj/machinery/door/poddoor/shutters/transit/nonsmoothing{
	dir = 1
	},
/obj/machinery/door/poddoor/mainship/open{
	dir = 2;
	id = "minidropship_podlock"
	},
/turf/open/floor/plating/plating_catwalk,
/area/shuttle/minidropship)
"X" = (
/obj/structure/bed/chair/dropship/pilot{
	dir = 1
	},
/turf/open/floor/plating/plating_catwalk,
/area/shuttle/minidropship)

(1,1,1) = {"
a
a
C
z
z
z
u
a
a
"}
(2,1,1) = {"
a
S
G
c
p
x
h
S
a
"}
(3,1,1) = {"
a
S
L
O
Q
O
O
S
a
"}
(4,1,1) = {"
a
S
t
X
r
Q
Q
V
a
"}
(5,1,1) = {"
a
S
K
O
Q
O
O
S
a
"}
(6,1,1) = {"
a
S
G
d
Q
y
G
S
a
"}
(7,1,1) = {"
a
a
T
z
z
z
l
a
a
"}
