//MAP CONVERTED BY dmm2tgm.py THIS HEADER COMMENT PREVENTS RECONVERSION, DO NOT REMOVE
"a" = (
/obj/structure/barricade/plasteel{
	dir = 8
	},
/obj/structure/barricade/plasteel,
/turf/open/floor/mainship/mono,
/area/shuttle/minidropship)
"b" = (
/obj/structure/barricade/plasteel{
	dir = 4
	},
/turf/open/floor/mainship/mono,
/area/shuttle/minidropship)
"g" = (
/obj/structure/dropship_piece/tadpole/cockpit/right{
	dir = 1
	},
/obj/effect/attach_point/electronics/dropship1,
/turf/open/floor/mainship/mono,
/area/shuttle/minidropship)
"h" = (
/obj/machinery/computer/camera_advanced/shuttle_docker/minidropship,
/obj/machinery/camera/autoname/mainship,
/turf/open/floor/mainship/mono,
/area/space)
"m" = (
/obj/structure/barricade/plasteel{
	dir = 8
	},
/turf/open/floor/mainship/mono,
/area/shuttle/minidropship)
"o" = (
/obj/structure/window/framed/mainship/canterbury/dropship/reinforced,
/turf/open/floor/mainship/mono,
/area/space)
"s" = (
/obj/machinery/light,
/obj/structure/bed/chair/dropship/pilot{
	dir = 1
	},
/turf/open/floor/plating/plating_catwalk,
/area/shuttle/minidropship)
"u" = (
/obj/machinery/light,
/turf/open/floor/plating/plating_catwalk,
/area/shuttle/minidropship)
"v" = (
/obj/structure/barricade/plasteel{
	dir = 4
	},
/turf/open/floor/plating/plating_catwalk,
/area/shuttle/minidropship)
"y" = (
/obj/structure/barricade/plasteel{
	dir = 8
	},
/turf/open/floor/plating/plating_catwalk,
/area/shuttle/minidropship)
"z" = (
/turf/closed/shuttle/dropship2/singlewindow/tadpole,
/area/shuttle/minidropship)
"A" = (
/obj/structure/barricade/plasteel,
/turf/open/floor/plating/plating_catwalk,
/area/shuttle/minidropship)
"N" = (
/obj/structure/barricade/plasteel{
	dir = 4
	},
/obj/machinery/light{
	dir = 1
	},
/turf/open/floor/mainship/mono,
/area/shuttle/minidropship)
"P" = (
/obj/structure/barricade/plasteel{
	dir = 8
	},
/obj/machinery/light{
	dir = 1
	},
/turf/open/floor/mainship/mono,
/area/shuttle/minidropship)
"W" = (
/obj/structure/barricade/plasteel,
/obj/structure/barricade/plasteel{
	dir = 4
	},
/turf/open/floor/mainship/mono,
/area/shuttle/minidropship)
"X" = (
/obj/effect/attach_point/crew_weapon/minidropship,
/turf/open/floor/mainship/mono,
/area/shuttle/minidropship)
"Z" = (
/obj/structure/dropship_piece/tadpole/cockpit/left{
	dir = 1
	},
/obj/effect/attach_point/electronics/dropship1,
/turf/open/floor/mainship/mono,
/area/shuttle/minidropship)

(1,1,1) = {"
Z
o
P
y
m
y
m
y
a
"}
(2,1,1) = {"
z
h
s
X
u
X
u
X
A
"}
(3,1,1) = {"
g
o
N
v
b
v
b
v
W
"}
