//MAP CONVERTED BY dmm2tgm.py THIS HEADER COMMENT PREVENTS RECONVERSION, DO NOT REMOVE
"a" = (
/turf/closed/shuttle/ert/engines/left{
	dir = 1
	},
/area/space)
"e" = (
/obj/structure/barricade/plasteel{
	dir = 4
	},
/obj/machinery/door/poddoor/shutters/transit/nonsmoothing,
/obj/machinery/door/poddoor/mainship/open{
	id = "minidropship_podlock"
	},
/obj/machinery/light{
	dir = 1
	},
/turf/open/floor/mainship/mono,
/area/space)
"f" = (
/obj/machinery/computer/camera_advanced/shuttle_docker/minidropship,
/turf/open/floor/plating/plating_catwalk,
/area/space)
"g" = (
/obj/structure/window/framed/mainship/canterbury/dropship/reinforced,
/turf/open/floor/mainship/mono,
/area/space)
"k" = (
/obj/structure/dropship_equipment/weapon_holder/mortar_holder,
/turf/open/floor/plating/plating_catwalk,
/area/space)
"o" = (
/obj/machinery/holopad,
/obj/structure/dropship_equipment/weapon_holder/mortar_holder,
/turf/open/floor/plating/plating_catwalk,
/area/space)
"r" = (
/obj/structure/barricade/plasteel,
/obj/machinery/door/poddoor/shutters/transit/nonsmoothing{
	dir = 1
	},
/obj/machinery/door/poddoor/mainship/open{
	dir = 2;
	id = "minidropship_podlock"
	},
/turf/open/floor/plating/plating_catwalk,
/area/space)
"t" = (
/obj/effect/attach_point/crew_weapon/minidropship,
/turf/open/floor/plating/plating_catwalk,
/area/space)
"v" = (
/obj/docking_port/mobile/marine_dropship/minidropship,
/turf/open/floor/plating/plating_catwalk,
/area/space)
"w" = (
/obj/structure/bed/chair/dropship/pilot{
	dir = 1
	},
/turf/open/floor/plating/plating_catwalk,
/area/space)
"y" = (
/obj/structure/barricade/plasteel{
	dir = 8
	},
/obj/machinery/door/poddoor/shutters/transit/nonsmoothing,
/obj/machinery/door/poddoor/mainship/open{
	id = "minidropship_podlock"
	},
/obj/machinery/light{
	dir = 1
	},
/turf/open/floor/mainship/mono,
/area/space)
"z" = (
/obj/structure/barricade/plasteel{
	dir = 4
	},
/obj/machinery/door/poddoor/shutters/transit/nonsmoothing,
/obj/machinery/door/poddoor/mainship/open{
	id = "minidropship_podlock"
	},
/turf/open/floor/mainship/mono,
/area/space)
"A" = (
/obj/machinery/light,
/turf/open/floor/mainship/mono,
/area/space)
"D" = (
/turf/closed/wall/mainship/outer/canterbury,
/area/space)
"E" = (
/obj/machinery/vending/nanomed/tadpolemed{
	dir = 4
	},
/turf/open/floor/plating/plating_catwalk,
/area/space)
"F" = (
/obj/structure/closet/open,
/turf/open/floor/plating/plating_catwalk,
/area/space)
"H" = (
/obj/structure/dropship_piece/tadpole/engine{
	dir = 1;
	pixel_x = -23
	},
/obj/effect/attach_point/weapon/minidropship{
	equipment_offset_y = 25
	},
/obj/structure/dropship_piece/two/weapon/leftleft{
	dir = 1;
	pixel_y = 32
	},
/turf/closed/wall/mainship/outer/canterbury,
/area/space)
"I" = (
/obj/structure/dropship_piece/tadpole/engine{
	dir = 1;
	pixel_x = 23
	},
/obj/effect/attach_point/weapon/minidropship{
	equipment_offset_y = 25
	},
/obj/structure/dropship_piece/two/weapon/rightright{
	dir = 1;
	pixel_y = 32
	},
/turf/closed/wall/mainship/outer/canterbury,
/area/space)
"L" = (
/obj/machinery/camera/autoname/mainship{
	pixel_y = 16
	},
/turf/open/floor/mainship/mono,
/area/space)
"N" = (
/turf/template_noop,
/area/space)
"O" = (
/turf/open/floor/plating/plating_catwalk,
/area/space)
"P" = (
/obj/machinery/door_control{
	dir = 4;
	id = "minidropship_podlock";
	name = "inner door-control";
	pixel_x = -25
	},
/turf/open/floor/mainship/mono,
/area/space)
"Q" = (
/turf/open/floor/mainship/mono,
/area/space)
"S" = (
/obj/structure/barricade/plasteel{
	dir = 8
	},
/obj/machinery/door/poddoor/shutters/transit/nonsmoothing,
/obj/machinery/door/poddoor/mainship/open{
	id = "minidropship_podlock"
	},
/turf/open/floor/mainship/mono,
/area/space)
"X" = (
/obj/machinery/telecomms/relay/preset/telecomms/onboard,
/turf/closed/wall/mainship/outer/canterbury,
/area/space)
"Z" = (
/turf/closed/shuttle/ert/engines/right{
	dir = 1
	},
/area/space)

(1,1,1) = {"
N
H
y
S
S
S
S
D
a
"}
(2,1,1) = {"
D
D
L
k
k
k
A
D
D
"}
(3,1,1) = {"
g
E
Q
t
t
t
Q
P
r
"}
(4,1,1) = {"
g
f
w
O
v
t
o
O
X
"}
(5,1,1) = {"
g
F
Q
t
t
t
Q
Q
r
"}
(6,1,1) = {"
D
D
L
k
k
k
A
D
D
"}
(7,1,1) = {"
N
I
e
z
z
z
z
D
Z
"}
