//MAP CONVERTED BY dmm2tgm.py THIS HEADER COMMENT PREVENTS RECONVERSION, DO NOT REMOVE
"a" = (
/obj/machinery/door_control{
	dir = 1;
	id = "minidropship_podlock";
	name = "outer door-control"
	},
/obj/structure/dropship_piece/tadpole/tadpole_nose/right{
	dir = 1;
	pixel_y = 32
	},
/obj/structure/dropship_piece/tadpole/cockpit/right{
	dir = 1
	},
/turf/open/floor/mainship/mono,
/area/shuttle/dropship/mini)
"b" = (
/obj/structure/dropship_piece/two/weapon/leftleft{
	dir = 1;
	pixel_y = 32
	},
/obj/structure/dropship_piece/tadpole/engine{
	dir = 1;
	pixel_x = -23
	},
/obj/effect/attach_point/weapon/minidropship{
	equipment_offset_y = 25
	},
/turf/closed/shuttle/dropship2/rearcorner/alt/tadpole{
	dir = 1
	},
/area/shuttle/dropship/mini)
"c" = (
/obj/structure/dropship_piece/two/weapon/rightright{
	dir = 1;
	pixel_y = 32
	},
/obj/effect/attach_point/weapon/minidropship{
	equipment_offset_y = 25
	},
/obj/structure/dropship_piece/tadpole/engine{
	dir = 1;
	pixel_x = 23
	},
/turf/closed/shuttle/dropship2/rearcorner/tadpole{
	dir = 1
	},
/area/shuttle/dropship/mini)
"j" = (
/obj/machinery/door_control{
	id = "minidropship_podlock";
	name = "inner door-control"
	},
/obj/item/stack/barbed_wire/half_stack,
/obj/structure/closet/walllocker/hydrant/extinguisher{
	pixel_x = -25
	},
/turf/open/floor/mainship/mono,
/area/shuttle/dropship/mini)
"n" = (
/obj/structure/dropship_piece/tadpole/tadpole_nose{
	dir = 1;
	pixel_y = 32
	},
/obj/structure/dropship_piece/singlewindow/tadpole{
	dir = 1
	},
/turf/open/floor/plating/plating_catwalk,
/area/shuttle/dropship/mini)
"q" = (
/obj/machinery/vending/nanomed/tadpolemed{
	pixel_x = 5
	},
/turf/open/floor/mainship/mono,
/area/shuttle/dropship/mini)
"s" = (
/turf/open/floor/plating/plating_catwalk,
/area/shuttle/dropship/mini)
"u" = (
/obj/machinery/computer/camera_advanced/shuttle_docker/minidropship,
/obj/machinery/camera/autoname/mainship/dropship_two,
/turf/open/floor/plating/plating_catwalk,
/area/shuttle/dropship/mini)
"v" = (
/obj/machinery/door/poddoor/mainship/open{
	dir = 2;
	id = "minidropship_podlock"
	},
/obj/machinery/door/poddoor/shutters/transit/nonsmoothing{
	dir = 1
	},
/turf/open/floor/mainship/mono,
/area/shuttle/dropship/mini)
"w" = (
/obj/machinery/holopad,
/turf/open/floor/plating/plating_catwalk,
/area/shuttle/dropship/mini)
"y" = (
/obj/machinery/door/poddoor/mainship/open{
	id = "minidropship_podlock"
	},
/obj/machinery/door/poddoor/shutters/transit/nonsmoothing,
/turf/open/floor/mainship/mono,
/area/shuttle/dropship/mini)
"A" = (
/obj/structure/dropship_piece/glassone/tadpole{
	dir = 1
	},
/turf/open/floor/plating/plating_catwalk,
/area/shuttle/dropship/mini)
"B" = (
/obj/structure/dropship_piece/tadpole/engine{
	dir = 1;
	pixel_x = -23;
	pixel_y = -14
	},
/obj/machinery/light,
/obj/machinery/door/poddoor/mainship/open{
	id = "minidropship_podlock"
	},
/obj/machinery/door/poddoor/shutters/transit/nonsmoothing,
/turf/open/floor/mainship/mono,
/area/shuttle/dropship/mini)
"C" = (
/obj/structure/dropship_piece/tadpole/engine{
	dir = 1;
	pixel_x = 23;
	pixel_y = -14
	},
/obj/machinery/light,
/obj/machinery/door/poddoor/mainship/open{
	id = "minidropship_podlock"
	},
/obj/machinery/door/poddoor/shutters/transit/nonsmoothing,
/turf/open/floor/mainship/mono,
/area/shuttle/dropship/mini)
"E" = (
/turf/template_noop,
/area/space)
"F" = (
/obj/docking_port/mobile/marine_dropship/minidropship,
/obj/structure/bed/chair/dropship/pilot{
	dir = 1
	},
/turf/open/floor/plating/plating_catwalk,
/area/shuttle/dropship/mini)
"L" = (
/obj/structure/dropship_piece/tadpole/rearleft{
	dir = 1
	},
/turf/template_noop,
/area/shuttle/dropship/mini)
"N" = (
/obj/structure/dropship_piece/glasstwo/tadpole{
	dir = 1
	},
/turf/open/floor/plating/plating_catwalk,
/area/shuttle/dropship/mini)
"Q" = (
/obj/machinery/door/poddoor/mainship/open{
	dir = 2;
	id = "minidropship_podlock"
	},
/obj/machinery/door/poddoor/shutters/transit/nonsmoothing{
	dir = 1
	},
/turf/open/floor/plating/plating_catwalk,
/area/shuttle/dropship/mini)
"S" = (
/obj/structure/dropship_piece/tadpole/tadpole_nose/left{
	dir = 1;
	pixel_y = 32
	},
/obj/structure/dropship_piece/tadpole/cockpit/left{
	dir = 1
	},
/turf/open/floor/mainship/mono,
/area/shuttle/dropship/mini)
"T" = (
/obj/machinery/door/poddoor/mainship/open{
	id = "minidropship_podlock"
	},
/obj/machinery/light{
	dir = 1
	},
/obj/machinery/door/poddoor/shutters/transit/nonsmoothing,
/turf/open/floor/mainship/mono,
/area/shuttle/dropship/mini)
"U" = (
/obj/structure/dropship_piece/tadpole/rearright{
	dir = 1
	},
/obj/machinery/telecomms/relay/preset/telecomms/onboard,
/turf/template_noop,
/area/shuttle/dropship/mini)
"V" = (
/turf/open/floor/mainship/mono,
/area/shuttle/dropship/mini)
"Y" = (
/obj/effect/attach_point/crew_weapon/minidropship,
/turf/open/floor/plating/plating_catwalk,
/area/shuttle/dropship/mini)

(1,1,1) = {"
E
E
E
E
E
E
E
E
E
"}
(2,1,1) = {"
E
E
E
b
T
y
B
L
E
"}
(3,1,1) = {"
E
E
S
A
q
s
V
v
E
"}
(4,1,1) = {"
E
E
n
u
F
Y
w
Q
E
"}
(5,1,1) = {"
E
E
a
N
j
s
V
v
E
"}
(6,1,1) = {"
E
E
E
c
T
y
C
U
E
"}
(7,1,1) = {"
E
E
E
E
E
E
E
E
E
"}
