//MAP CONVERTED BY dmm2tgm.py THIS HEADER COMMENT PREVENTS RECONVERSION, DO NOT REMOVE
"a" = (
/turf/closed/shuttle/ert/engines/left{
	dir = 1
	},
/area/shuttle/dropship/mini)
"b" = (
/turf/template_noop,
/area/template_noop)
"c" = (
/obj/effect/spawner/random/engineering/structure/tank/fuelweighted,
/turf/open/floor/plating/plating_catwalk,
/area/shuttle/dropship/mini)
"e" = (
/obj/machinery/holopad,
/turf/open/floor/plating/plating_catwalk,
/area/shuttle/dropship/mini)
"f" = (
/turf/closed/shuttle/ert/engines/right{
	dir = 1
	},
/area/shuttle/dropship/mini)
"k" = (
/obj/structure/dropship_piece/tadpole/engine{
	dir = 1;
	pixel_x = 23
	},
/obj/effect/attach_point/weapon/minidropship{
	equipment_offset_y = 25
	},
/obj/structure/dropship_piece/two/weapon/rightright{
	dir = 1;
	pixel_y = 32
	},
/turf/closed/wall/mainship/outer/canterbury,
/area/shuttle/dropship/mini)
"l" = (
/turf/open/floor/mainship/floor,
/area/shuttle/dropship/mini)
"q" = (
/turf/open/floor/plating/plating_catwalk,
/area/shuttle/dropship/mini)
"r" = (
/obj/structure/table/mainship,
/obj/item/storage/toolbox/electrical{
	pixel_y = 6
	},
/obj/item/storage/toolbox/mechanical,
/turf/open/floor/plating/plating_catwalk,
/area/shuttle/dropship/mini)
"t" = (
/obj/structure/table/mainship,
/obj/item/stack/sheet/metal/medium_stack,
/obj/effect/spawner/random/engineering/extinguisher/miniweighted,
/obj/machinery/vending/nanomed/tadpolemed{
	dir = 4
	},
/turf/open/floor/plating/plating_catwalk,
/area/shuttle/dropship/mini)
"u" = (
/obj/docking_port/mobile/marine_dropship/minidropship,
/turf/open/floor/plating/plating_catwalk,
/area/shuttle/dropship/mini)
"w" = (
/obj/machinery/camera/autoname/mainship/dropship_two,
/turf/open/floor/mainship/mono,
/area/shuttle/dropship/mini)
"z" = (
/obj/machinery/light,
/turf/open/floor/mainship/mono,
/area/shuttle/dropship/mini)
"A" = (
/obj/structure/dropship_piece/tadpole/engine{
	dir = 1;
	pixel_x = -23
	},
/obj/effect/attach_point/weapon/minidropship{
	equipment_offset_y = 25
	},
/obj/structure/dropship_piece/two/weapon/leftleft{
	dir = 1;
	pixel_y = 32
	},
/turf/closed/wall/mainship/outer/canterbury,
/area/shuttle/dropship/mini)
"B" = (
/turf/open/floor/mainship/mono,
/area/shuttle/dropship/mini)
"F" = (
/turf/closed/wall/mainship/outer/canterbury,
/area/shuttle/dropship/mini)
"J" = (
/obj/machinery/computer/camera_advanced/shuttle_docker/minidropship,
/turf/open/floor/plating/plating_catwalk,
/area/shuttle/dropship/mini)
"P" = (
/obj/effect/attach_point/crew_weapon/minidropship,
/turf/open/floor/plating/plating_catwalk,
/area/shuttle/dropship/mini)
"R" = (
/obj/machinery/telecomms/relay/preset/telecomms/onboard,
/turf/closed/wall/mainship/outer/canterbury,
/area/shuttle/dropship/mini)
"S" = (
/obj/machinery/door_control{
	dir = 4;
	id = "minidropship_podlock";
	name = "inner door-control";
	pixel_x = -25
	},
/turf/open/floor/mainship/mono,
/area/shuttle/dropship/mini)
"U" = (
/obj/machinery/door/poddoor/shutters/transit/nonsmoothing,
/obj/machinery/door/poddoor/mainship/open{
	id = "minidropship_podlock"
	},
/turf/open/floor/mainship/mono,
/area/shuttle/dropship/mini)
"V" = (
/obj/structure/bed/chair/dropship/pilot{
	dir = 1
	},
/turf/open/floor/plating/plating_catwalk,
/area/shuttle/dropship/mini)
"X" = (
/obj/machinery/door/poddoor/shutters/transit/nonsmoothing{
	dir = 1
	},
/obj/machinery/door/poddoor/mainship/open{
	dir = 2;
	id = "minidropship_podlock"
	},
/turf/open/floor/plating/plating_catwalk,
/area/shuttle/dropship/mini)
"Y" = (
/obj/machinery/door/poddoor/shutters/transit/nonsmoothing,
/obj/machinery/door/poddoor/mainship/open{
	id = "minidropship_podlock"
	},
/obj/machinery/light{
	dir = 1
	},
/turf/open/floor/mainship/mono,
/area/shuttle/dropship/mini)
"Z" = (
/obj/structure/window/framed/mainship/canterbury/dropship/reinforced,
/turf/open/floor/mainship/mono,
/area/shuttle/dropship/mini)

(1,1,1) = {"
b
A
Y
U
U
U
U
F
a
"}
(2,1,1) = {"
F
F
w
q
q
q
z
F
F
"}
(3,1,1) = {"
Z
t
B
q
l
q
B
S
X
"}
(4,1,1) = {"
Z
J
V
q
u
P
e
c
R
"}
(5,1,1) = {"
Z
r
B
q
l
q
B
B
X
"}
(6,1,1) = {"
F
F
w
q
q
q
z
F
F
"}
(7,1,1) = {"
b
k
Y
U
U
U
U
F
f
"}
