//MAP CONVERTED BY dmm2tgm.py THIS HEADER COMMENT PREVENTS RECONVERSION, DO NOT REMOVE
"a" = (
/turf/template_noop,
/area/template_noop)
"b" = (
/turf/closed/wall/mainship/outer/canterbury,
/area/shuttle/minidropship)
"c" = (
/obj/structure/bed/chair/dropship/pilot{
	dir = 1
	},
/turf/open/floor/plating/plating_catwalk,
/area/shuttle/minidropship)
"d" = (
/obj/item/weapon/gun/sentry/ads_system/premade,
/turf/closed/wall/mainship/outer/canterbury,
/area/shuttle/minidropship)
"e" = (
/obj/structure/dropship_piece/two/weapon/leftleft{
	dir = 1;
	pixel_y = 32
	},
/obj/effect/attach_point/weapon/minidropship{
	equipment_offset_y = 25
	},
/turf/closed/wall/mainship/outer/canterbury,
/area/shuttle/minidropship)
"f" = (
/obj/machinery/cic_maptable,
/turf/open/floor/plating/plating_catwalk,
/area/shuttle/minidropship)
"g" = (
/obj/effect/attach_point/crew_weapon/minidropship,
/turf/open/floor/plating/plating_catwalk,
/area/shuttle/minidropship)
"h" = (
/obj/structure/largecrate/supply/ammo/standard_ammo,
/turf/open/floor/plating/plating_catwalk,
/area/shuttle/minidropship)
"i" = (
/obj/machinery/door/poddoor/shutters/transit/nonsmoothing{
	dir = 1
	},
/obj/machinery/door/poddoor/mainship/open{
	dir = 2;
	id = "minidropship_podlock"
	},
/obj/structure/barricade/folding,
/turf/open/floor/mainship/mono,
/area/shuttle/minidropship)
"j" = (
/obj/structure/dropship_piece/singlewindow/tadpole{
	dir = 1
	},
/obj/structure/dropship_piece/tadpole/tadpole_nose{
	dir = 1;
	pixel_y = 32
	},
/turf/open/floor/mainship/mono,
/area/shuttle/minidropship)
"k" = (
/obj/structure/bed/chair/dropship/passenger{
	dir = 4
	},
/turf/open/floor/mainship/mono,
/area/shuttle/minidropship)
"m" = (
/obj/structure/bed/chair/dropship/passenger,
/turf/open/floor/mainship/mono,
/area/shuttle/minidropship)
"n" = (
/obj/structure/bed/chair/dropship/passenger{
	dir = 4
	},
/obj/machinery/light{
	dir = 8
	},
/turf/open/floor/plating/plating_catwalk,
/area/shuttle/minidropship)
"o" = (
/obj/docking_port/mobile/marine_dropship/minidropship,
/turf/open/floor/plating/plating_catwalk,
/area/shuttle/minidropship)
"p" = (
/obj/structure/dropship_piece/tadpole/rearright{
	dir = 1
	},
/turf/open/space/basic,
/area/shuttle/minidropship)
"q" = (
/obj/item/stack/barbed_wire{
	amount = 8
	},
/turf/open/floor/plating/plating_catwalk,
/area/shuttle/minidropship)
"r" = (
/obj/structure/dropship_piece/tadpole/engine{
	dir = 1;
	pixel_x = 23
	},
/turf/closed/shuttle/ert/engines/right/two{
	dir = 1
	},
/area/shuttle/minidropship)
"s" = (
/obj/machinery/camera/autoname/mainship/dropship_two,
/obj/structure/bed/chair/dropship/passenger,
/obj/machinery/vending/nanomed/tadpolemed,
/turf/open/floor/mainship/mono,
/area/shuttle/minidropship)
"t" = (
/obj/machinery/vending/nanoammo/directional/west,
/obj/structure/bed/chair/dropship/passenger{
	dir = 8
	},
/turf/open/floor/mainship/mono,
/area/shuttle/minidropship)
"u" = (
/obj/machinery/camera/autoname/mainship/dropship_two{
	dir = 8
	},
/obj/effect/turf_decal/tile/transparent/dark_blue/anticorner/contrasted,
/obj/machinery/light{
	dir = 4
	},
/turf/open/floor/mainship,
/area/shuttle/minidropship)
"v" = (
/obj/machinery/computer/camera{
	network = list("dropship2")
	},
/obj/structure/table/mainship,
/turf/open/floor/plating/plating_catwalk,
/area/shuttle/minidropship)
"x" = (
/obj/structure/dropship_piece/glassone/tadpole,
/obj/machinery/telecomms/relay/preset/telecomms/onboard,
/turf/open/space/basic,
/area/shuttle/minidropship)
"y" = (
/obj/machinery/computer/camera_advanced/shuttle_docker/minidropship,
/turf/open/floor/plating/plating_catwalk,
/area/shuttle/minidropship)
"A" = (
/obj/structure/dropship_piece/glasstwo/tadpole,
/obj/structure/dropship_piece/tadpole/engine{
	dir = 1;
	pixel_x = -23
	},
/turf/open/floor/mainship/mono,
/area/shuttle/minidropship)
"C" = (
/obj/machinery/door/poddoor/shutters/transit/nonsmoothing{
	dir = 1
	},
/obj/machinery/door/poddoor/mainship/open{
	dir = 2;
	id = "minidropship_podlock"
	},
/obj/structure/barricade/folding,
/turf/open/floor/plating/plating_catwalk,
/area/shuttle/minidropship)
"D" = (
/obj/machinery/door/airlock/mainship/command{
	dir = 1
	},
/turf/open/floor/mainship/mono,
/area/shuttle/minidropship)
"E" = (
/obj/machinery/door/poddoor/shutters/transit/nonsmoothing,
/obj/machinery/door/poddoor/mainship/open{
	id = "minidropship_podlock"
	},
/obj/structure/barricade/folding{
	dir = 8
	},
/turf/open/floor/plating/plating_catwalk,
/area/shuttle/minidropship)
"F" = (
/obj/structure/window/framed/mainship/canterbury/dropship/reinforced,
/obj/structure/extinguisher_cabinet{
	pixel_x = -10
	},
/turf/open/floor/mainship/floor,
/area/shuttle/minidropship)
"G" = (
/obj/structure/dropship_piece/glasstwo/tadpole,
/turf/open/floor/mainship/mono,
/area/shuttle/minidropship)
"H" = (
/obj/structure/window/framed/mainship/canterbury/dropship/reinforced,
/turf/open/floor/mainship/floor,
/area/shuttle/minidropship)
"J" = (
/obj/machinery/holopad,
/turf/open/floor/plating/plating_catwalk,
/area/shuttle/minidropship)
"L" = (
/obj/structure/bed/chair/dropship/passenger{
	dir = 8
	},
/obj/machinery/light{
	dir = 4
	},
/turf/open/floor/plating/plating_catwalk,
/area/shuttle/minidropship)
"M" = (
/obj/structure/dropship_piece/tadpole/engine{
	dir = 1;
	pixel_x = -23
	},
/turf/closed/shuttle/ert/engines/left/two{
	dir = 1
	},
/area/shuttle/minidropship)
"N" = (
/obj/structure/dropship_piece/glassone,
/obj/structure/dropship_piece/tadpole/engine{
	dir = 1;
	pixel_x = 23
	},
/turf/open/floor/mainship/mono,
/area/shuttle/minidropship)
"O" = (
/turf/closed/shuttle/ert/engines/right{
	dir = 1
	},
/area/shuttle/minidropship)
"P" = (
/obj/structure/dropship_piece/tadpole/tadpole_nose/right{
	dir = 1;
	pixel_y = 32
	},
/obj/structure/dropship_piece/two/weapon/rightright{
	dir = 1;
	pixel_y = 32
	},
/obj/effect/attach_point/weapon/minidropship{
	equipment_offset_y = 25
	},
/obj/structure/dropship_piece/tadpole/cockpit/right{
	dir = 1
	},
/turf/open/space/basic,
/area/shuttle/minidropship)
"R" = (
/obj/structure/dropship_piece/tadpole/rearleft{
	dir = 1
	},
/turf/template_noop,
/area/shuttle/minidropship)
"S" = (
/obj/machinery/door/poddoor/shutters/transit/nonsmoothing,
/obj/machinery/door/poddoor/mainship/open{
	id = "minidropship_podlock"
	},
/obj/structure/barricade/folding{
	dir = 4
	},
/turf/open/floor/plating/plating_catwalk,
/area/shuttle/minidropship)
"T" = (
/obj/structure/dropship_piece/two/weapon/rightright{
	dir = 1;
	pixel_y = 32
	},
/obj/effect/attach_point/weapon/minidropship{
	equipment_offset_y = 25
	},
/turf/closed/wall/mainship/outer/canterbury,
/area/shuttle/minidropship)
"V" = (
/turf/closed/shuttle/ert/engines/left{
	dir = 1
	},
/area/shuttle/minidropship)
"X" = (
/obj/structure/dropship_piece/tadpole/tadpole_nose/left{
	dir = 1;
	pixel_y = 32
	},
/obj/structure/dropship_piece/tadpole/cockpit/left{
	dir = 1
	},
/obj/effect/attach_point/weapon/minidropship{
	equipment_offset_y = 25
	},
/obj/structure/dropship_piece/two/weapon/leftleft{
	dir = 1;
	pixel_y = 32
	},
/turf/open/floor/mainship/mono,
/area/shuttle/minidropship)
"Y" = (
/obj/structure/dropship_piece/singlewindow/tadpole{
	dir = 1
	},
/obj/structure/dropship_piece/tadpole/tadpole_nose{
	dir = 1;
	pixel_y = 32
	},
/turf/open/space/basic,
/area/shuttle/minidropship)
"Z" = (
/obj/machinery/door_control/minidropship{
	dir = 4;
	name = "inner door-control";
	pixel_x = -25;
	pixel_y = 3
	},
/obj/effect/turf_decal/tile/transparent/dark_blue/anticorner/contrasted{
	dir = 8
	},
/turf/open/floor/mainship,
/area/shuttle/minidropship)

(1,1,1) = {"
a
a
e
V
a
a
b
M
V
"}
(2,1,1) = {"
X
A
b
b
E
E
b
G
R
"}
(3,1,1) = {"
j
f
Z
H
s
h
k
n
i
"}
(4,1,1) = {"
Y
y
c
D
o
g
J
g
C
"}
(5,1,1) = {"
j
v
u
F
m
q
t
L
i
"}
(6,1,1) = {"
P
N
b
b
S
S
b
x
p
"}
(7,1,1) = {"
a
a
T
O
a
a
d
r
O
"}
