//MAP CONVERTED BY dmm2tgm.py THIS HEADER COMMENT PREVENTS RECONVERSION, DO NOT REMOVE
"a" = (
/turf/closed/shuttle/ert/engines/left,
/area/shuttle/minidropship)
"b" = (
/turf/template_noop,
/area/template_noop)
"c" = (
/obj/effect/spawner/random/engineering/structure/tank/fuelweighted,
/turf/open/floor/plating/plating_catwalk,
/area/shuttle/minidropship)
"f" = (
/turf/closed/shuttle/ert/engines/right,
/area/shuttle/minidropship)
"h" = (
/obj/structure/extinguisher_cabinet{
	pixel_x = 16
	},
/turf/open/floor/mainship/mono,
/area/shuttle/minidropship)
"k" = (
/obj/structure/dropship_piece/tadpole/engine{
	dir = 1;
	pixel_x = 23
	},
/obj/effect/attach_point/weapon/minidropship{
	equipment_offset_y = 25
	},
/obj/structure/dropship_piece/two/weapon/rightright{
	dir = 1;
	pixel_y = 32
	},
/turf/closed/wall/mainship/outer,
/area/shuttle/minidropship)
"l" = (
/turf/open/floor/mainship/floor,
/area/shuttle/minidropship)
"m" = (
/obj/structure/barricade/plasteel{
	dir = 4
	},
/obj/machinery/door/poddoor/shutters/transit/nonsmoothing,
/obj/machinery/door/poddoor/mainship/open{
	id = "minidropship_podlock"
	},
/turf/open/floor/mainship/mono,
/area/shuttle/minidropship)
"q" = (
/turf/open/floor/plating/plating_catwalk,
/area/shuttle/minidropship)
"r" = (
/obj/structure/table/mainship,
/obj/item/storage/toolbox/electrical{
	pixel_y = 6
	},
/obj/item/storage/toolbox/mechanical,
/turf/open/floor/plating/plating_catwalk,
/area/shuttle/minidropship)
"t" = (
/obj/structure/table/mainship,
/obj/item/stack/sheet/metal/medium_stack,
/obj/item/tool/extinguisher/mini,
/turf/open/floor/plating/plating_catwalk,
/area/shuttle/minidropship)
"u" = (
/obj/docking_port/mobile/marine_dropship/minidropship,
/turf/open/floor/plating/plating_catwalk,
/area/shuttle/minidropship)
"x" = (
/obj/structure/barricade/plasteel{
	dir = 4
	},
/obj/machinery/door/poddoor/shutters/transit/nonsmoothing,
/obj/machinery/door/poddoor/mainship/open{
	id = "minidropship_podlock"
	},
/obj/machinery/light{
	dir = 1
	},
/turf/open/floor/mainship/mono,
/area/shuttle/minidropship)
"z" = (
/obj/machinery/light,
/turf/open/floor/mainship/mono,
/area/shuttle/minidropship)
"A" = (
/obj/structure/dropship_piece/tadpole/engine{
	dir = 1;
	pixel_x = -23
	},
/obj/effect/attach_point/weapon/minidropship{
	equipment_offset_y = 25
	},
/obj/structure/dropship_piece/two/weapon/leftleft{
	dir = 1;
	pixel_y = 32
	},
/turf/closed/wall/mainship/outer,
/area/shuttle/minidropship)
"B" = (
/turf/open/floor/mainship/mono,
/area/shuttle/minidropship)
"F" = (
/turf/closed/wall/mainship/outer/canterbury,
/area/shuttle/minidropship)
"I" = (
/obj/structure/window/framed/mainship/canterbury{
	name = "orbital insertion safety window";
	max_integrity = 300
	},
/obj/machinery/door/poddoor/shutters/transit/nonsmoothing{
	dir = 1
	},
/obj/machinery/door/poddoor/mainship/open{
	dir = 2;
	id = "minidropship_podlock"
	},
/turf/open/floor/plating/plating_catwalk,
/area/shuttle/minidropship)
"J" = (
/obj/machinery/computer/camera_advanced/shuttle_docker/minidropship,
/turf/open/floor/plating/plating_catwalk,
/area/shuttle/minidropship)
"P" = (
/obj/effect/attach_point/crew_weapon/minidropship,
/turf/open/floor/plating/plating_catwalk,
/area/shuttle/minidropship)
"S" = (
/obj/machinery/door_control{
	id = "minidropship_podlock";
	name = "inner door-control";
	pixel_x = -25;
	dir = 4
	},
/turf/open/floor/mainship/mono,
/area/shuttle/minidropship)
"U" = (
/obj/structure/barricade/plasteel{
	dir = 8
	},
/obj/machinery/door/poddoor/shutters/transit/nonsmoothing,
/obj/machinery/door/poddoor/mainship/open{
	id = "minidropship_podlock"
	},
/turf/open/floor/mainship/mono,
/area/shuttle/minidropship)
"V" = (
/obj/structure/bed/chair/dropship/pilot{
	dir = 1
	},
/turf/open/floor/plating/plating_catwalk,
/area/shuttle/minidropship)
"X" = (
/obj/structure/barricade/plasteel,
/obj/machinery/door/poddoor/shutters/transit/nonsmoothing{
	dir = 1
	},
/obj/machinery/door/poddoor/mainship/open{
	dir = 2;
	id = "minidropship_podlock"
	},
/turf/open/floor/plating/plating_catwalk,
/area/shuttle/minidropship)
"Y" = (
/obj/structure/barricade/plasteel{
	dir = 8
	},
/obj/machinery/door/poddoor/shutters/transit/nonsmoothing,
/obj/machinery/door/poddoor/mainship/open{
	id = "minidropship_podlock"
	},
/obj/machinery/light{
	dir = 1
	},
/turf/open/floor/mainship/mono,
/area/shuttle/minidropship)
"Z" = (
/obj/structure/window/framed/mainship/canterbury{
	name = "orbital insertion safety window";
	max_integrity = 300
	},
/turf/open/floor/mainship/mono,
/area/shuttle/minidropship)

(1,1,1) = {"
b
A
Y
U
U
U
U
F
a
"}
(2,1,1) = {"
Z
Z
B
q
q
q
z
F
F
"}
(3,1,1) = {"
Z
t
B
q
l
q
B
S
X
"}
(4,1,1) = {"
Z
J
V
q
u
P
q
c
I
"}
(5,1,1) = {"
Z
r
B
q
l
q
B
h
X
"}
(6,1,1) = {"
Z
Z
B
q
q
q
z
F
F
"}
(7,1,1) = {"
b
k
x
m
m
m
m
F
f
"}
