//MAP CONVERTED BY dmm2tgm.py THIS HEADER COMMENT PREVENTS RECONVERSION, DO NOT REMOVE
"a" = (
/turf/template_noop,
/area/template_noop)
"b" = (
/turf/closed/wall/mainship/outer/canterbury,
/area/shuttle/dropship/mini)
"c" = (
/turf/open/floor/plating/plating_catwalk,
/area/shuttle/dropship/mini)
"e" = (
/obj/structure/dropship_piece/two/weapon/leftleft{
	dir = 1;
	pixel_y = 32
	},
/obj/effect/attach_point/weapon/minidropship{
	equipment_offset_y = 25
	},
/turf/closed/wall/mainship/outer/canterbury,
/area/shuttle/dropship/mini)
"f" = (
/obj/machinery/cic_maptable,
/turf/open/floor/plating/plating_catwalk,
/area/shuttle/dropship/mini)
"g" = (
/obj/effect/attach_point/crew_weapon/minidropship,
/turf/open/floor/plating/plating_catwalk,
/area/shuttle/dropship/mini)
"i" = (
/obj/machinery/door/poddoor/shutters/transit/nonsmoothing{
	dir = 1
	},
/obj/machinery/door/poddoor/mainship/open{
	dir = 2;
	id = "minidropship_podlock"
	},
/turf/open/floor/mainship/mono,
/area/shuttle/dropship/mini)
"k" = (
/obj/structure/bed/chair/dropship/passenger{
	dir = 4
	},
/turf/open/floor/mainship/mono,
/area/shuttle/dropship/mini)
"m" = (
/obj/structure/bed/chair/dropship/passenger,
/obj/structure/extinguisher_cabinet{
	pixel_x = -10
	},
/turf/open/floor/mainship/mono,
/area/shuttle/dropship/mini)
"n" = (
/obj/structure/bed/chair/dropship/passenger{
	dir = 4
	},
/obj/machinery/light{
	dir = 8
	},
/turf/open/floor/plating/plating_catwalk,
/area/shuttle/dropship/mini)
"o" = (
/obj/docking_port/mobile/marine_dropship/minidropship,
/turf/open/floor/plating/plating_catwalk,
/area/shuttle/dropship/mini)
"r" = (
/turf/closed/shuttle/ert/engines/right/two{
	dir = 1
	},
/area/shuttle/dropship/mini)
"s" = (
/obj/machinery/camera/autoname/mainship/dropship_two,
/obj/structure/bed/chair/dropship/passenger,
/obj/machinery/vending/nanomed/tadpolemed,
/turf/open/floor/mainship/mono,
/area/shuttle/dropship/mini)
"t" = (
/obj/structure/bed/chair/dropship/passenger{
	dir = 8
	},
/turf/open/floor/mainship/mono,
/area/shuttle/dropship/mini)
"u" = (
/obj/structure/bed/chair/dropship/pilot{
	dir = 1
	},
/obj/machinery/camera/autoname/mainship/dropship_two{
	dir = 8
	},
/obj/effect/turf_decal/tile/transparent/dark_blue/anticorner/contrasted,
/obj/machinery/light{
	dir = 4
	},
/turf/open/floor/mainship,
/area/shuttle/dropship/mini)
"v" = (
/obj/machinery/computer/camera{
	network = list("dropship2")
	},
/obj/structure/table/mainship,
/turf/open/floor/plating/plating_catwalk,
/area/shuttle/dropship/mini)
"x" = (
/obj/machinery/telecomms/relay/preset/telecomms/onboard,
/turf/closed/wall/mainship/outer/canterbury,
/area/shuttle/dropship/mini)
"y" = (
/obj/machinery/computer/camera_advanced/shuttle_docker/flyable,
/turf/open/floor/plating/plating_catwalk,
/area/shuttle/dropship/mini)
"A" = (
/obj/structure/window/framed/mainship/canterbury/dropship/reinforced,
/turf/open/floor/mainship/mono,
/area/shuttle/dropship/mini)
"C" = (
/obj/machinery/door/poddoor/shutters/transit/nonsmoothing{
	dir = 1
	},
/obj/machinery/door/poddoor/mainship/open{
	dir = 2;
	id = "minidropship_podlock"
	},
/turf/open/floor/plating/plating_catwalk,
/area/shuttle/dropship/mini)
"D" = (
/obj/machinery/door/airlock/mainship/command{
	dir = 1
	},
/turf/open/floor/mainship/mono,
/area/shuttle/dropship/mini)
"J" = (
/obj/machinery/holopad,
/turf/open/floor/plating/plating_catwalk,
/area/shuttle/dropship/mini)
"L" = (
/obj/structure/bed/chair/dropship/passenger{
	dir = 8
	},
/obj/machinery/light{
	dir = 4
	},
/turf/open/floor/plating/plating_catwalk,
/area/shuttle/dropship/mini)
"M" = (
/turf/closed/shuttle/ert/engines/left/two{
	dir = 1
	},
/area/shuttle/dropship/mini)
"O" = (
/turf/closed/shuttle/ert/engines/right{
	dir = 1
	},
/area/shuttle/dropship/mini)
"S" = (
/obj/machinery/door/poddoor/shutters/transit/nonsmoothing,
/obj/machinery/door/poddoor/mainship/open{
	id = "minidropship_podlock"
	},
/turf/open/floor/plating/plating_catwalk,
/area/shuttle/dropship/mini)
"T" = (
/obj/structure/dropship_piece/two/weapon/rightright{
	dir = 1;
	pixel_y = 32
	},
/obj/effect/attach_point/weapon/minidropship{
	equipment_offset_y = 25
	},
/turf/closed/wall/mainship/outer/canterbury,
/area/shuttle/dropship/mini)
"V" = (
/turf/closed/shuttle/ert/engines/left{
	dir = 1
	},
/area/shuttle/dropship/mini)
"Z" = (
/obj/structure/bed/chair/dropship/pilot{
	dir = 1
	},
/obj/machinery/door_control{
	dir = 4;
	id = "minidropship_podlock";
	name = "inner door-control";
	pixel_x = -25;
	pixel_y = 3
	},
/obj/effect/turf_decal/tile/transparent/dark_blue/anticorner/contrasted{
	dir = 8
	},
/turf/open/floor/mainship,
/area/shuttle/dropship/mini)

(1,1,1) = {"
a
a
e
V
a
a
b
M
V
"}
(2,1,1) = {"
b
A
b
b
b
S
b
b
b
"}
(3,1,1) = {"
A
f
Z
b
s
c
k
n
i
"}
(4,1,1) = {"
A
y
c
D
o
c
J
g
C
"}
(5,1,1) = {"
A
v
u
b
m
c
t
L
i
"}
(6,1,1) = {"
b
A
b
b
b
S
b
x
b
"}
(7,1,1) = {"
a
a
T
O
a
a
b
r
O
"}
