"a" = (/obj/structure/barricade/plasteel{dir = 8},/obj/structure/barricade/plasteel,/turf/open/floor/mainship/mono,/area/shuttle/minidropship)
"b" = (/obj/structure/barricade/plasteel{dir = 4},/turf/open/floor/mainship/mono,/area/shuttle/minidropship)
"c" = (/obj/machinery/computer/camera_advanced/shuttle_docker/minidropship,/obj/machinery/camera/autoname/mainship,/turf/open/floor/mainship/mono,/area/shuttle/minidropship)
"h" = (/turf/closed/shuttle/dropship2/singlewindow/tadpole,/area/shuttle/minidropship)
"m" = (/obj/structure/barricade/plasteel{dir = 8},/turf/open/floor/mainship/mono,/area/shuttle/minidropship)
"o" = (/obj/structure/dropship_piece/tadpole/cockpit/right{dir = 1},/obj/effect/attach_point/electronics/dropship1,/turf/open/floor/mainship/mono,/area/shuttle/minidropship)
"s" = (/obj/structure/barricade/plasteel{dir = 4},/obj/machinery/light{dir = 1},/turf/open/floor/mainship/mono,/area/shuttle/minidropship)
"u" = (/turf/open/floor/plating/plating_catwalk,/area/shuttle/minidropship)
"v" = (/obj/structure/barricade/plasteel{dir = 4},/turf/open/floor/plating/plating_catwalk,/area/shuttle/minidropship)
"y" = (/obj/structure/barricade/plasteel{dir = 8},/turf/open/floor/plating/plating_catwalk,/area/shuttle/minidropship)
"A" = (/obj/structure/barricade/plasteel,/turf/open/floor/plating/plating_catwalk,/area/shuttle/minidropship)
"B" = (/obj/structure/dropship_piece/glassone/tadpole{dir = 1},/obj/machinery/light,/turf/open/floor/mainship/mono,/area/shuttle/minidropship)
"I" = (/obj/structure/bed/chair/dropship/pilot{dir = 1},/turf/open/floor/mainship/mono,/area/shuttle/minidropship)
"J" = (/obj/machinery/light{dir = 1},/obj/structure/barricade/plasteel{dir = 8},/turf/open/floor/mainship/mono,/area/shuttle/minidropship)
"K" = (/obj/structure/dropship_piece/glassone/tadpole,/obj/machinery/light,/turf/open/floor/mainship/mono,/area/shuttle/minidropship)
"T" = (/obj/structure/dropship_piece/tadpole/cockpit/left{dir = 1},/obj/effect/attach_point/electronics/dropship1,/turf/open/floor/mainship/mono,/area/shuttle/minidropship)
"W" = (/obj/structure/barricade/plasteel,/obj/structure/barricade/plasteel{dir = 4},/turf/open/floor/mainship/mono,/area/shuttle/minidropship)
"X" = (/obj/effect/attach_point/crew_weapon/minidropship,/turf/open/floor/mainship/mono,/area/shuttle/minidropship)

(1,1,1) = {"
Tho
BcK
JIs
mub
yXv
mub
mub
yXv
mub
mub
yXv
aAW
"}
