//MAP CONVERTED BY dmm2tgm.py THIS HEADER COMMENT PREVENTS RECONVERSION, DO NOT REMOVE
"a" = (
/obj/structure/barricade/plasteel{
	dir = 8
	},
/obj/structure/barricade/plasteel,
/turf/open/floor/mainship/mono,
/area/shuttle/minidropship)
"b" = (
/obj/structure/barricade/plasteel{
	dir = 4
	},
/turf/open/floor/mainship/mono,
/area/shuttle/minidropship)
"c" = (
/obj/docking_port/mobile/marine_dropship/minidropship,
/turf/open/floor/plating/plating_catwalk,
/area/shuttle/minidropship)
"f" = (
/obj/structure/barricade/plasteel{
	dir = 8
	},
/obj/machinery/light{
	dir = 1
	},
/turf/open/floor/mainship/mono,
/area/shuttle/minidropship)
"h" = (
/obj/machinery/computer/camera_advanced/shuttle_docker/minidropship,
/obj/machinery/camera/autoname/mainship,
/turf/open/floor/mainship/mono,
/area/shuttle/minidropship)
"k" = (
/obj/structure/dropship_piece/tadpole/cockpit/left{
	dir = 1
	},
/obj/effect/attach_point/electronics/dropship1,
/turf/open/floor/mainship/mono,
/area/shuttle/minidropship)
"m" = (
/obj/structure/barricade/plasteel{
	dir = 8
	},
/turf/open/floor/mainship/mono,
/area/shuttle/minidropship)
"n" = (
/obj/structure/dropship_piece/tadpole/cockpit/right{
	dir = 1
	},
/obj/effect/attach_point/electronics/dropship1,
/turf/open/floor/mainship/mono,
/area/shuttle/minidropship)
"o" = (
/obj/structure/window/framed/mainship/canterbury/dropship/reinforced,
/turf/open/floor/mainship/mono,
/area/shuttle/minidropship)
"s" = (
/obj/machinery/light,
/obj/structure/bed/chair/dropship/pilot{
	dir = 1
	},
/turf/open/floor/plating/plating_catwalk,
/area/shuttle/minidropship)
"u" = (
/obj/machinery/light,
/turf/open/floor/plating/plating_catwalk,
/area/shuttle/minidropship)
"v" = (
/obj/structure/barricade/plasteel{
	dir = 4
	},
/turf/open/floor/plating/plating_catwalk,
/area/shuttle/minidropship)
"y" = (
/obj/structure/barricade/plasteel{
	dir = 8
	},
/turf/open/floor/plating/plating_catwalk,
/area/shuttle/minidropship)
"A" = (
/obj/structure/barricade/plasteel,
/turf/open/floor/plating/plating_catwalk,
/area/shuttle/minidropship)
"P" = (
/obj/machinery/telecomms/relay/preset/telecomms/onboard,
/turf/closed/shuttle/dropship2/singlewindow/tadpole,
/area/shuttle/minidropship)
"W" = (
/obj/structure/barricade/plasteel,
/obj/structure/barricade/plasteel{
	dir = 4
	},
/turf/open/floor/mainship/mono,
/area/shuttle/minidropship)
"X" = (
/obj/effect/attach_point/crew_weapon/minidropship,
/turf/open/floor/mainship/mono,
/area/shuttle/minidropship)
"Y" = (
/obj/structure/barricade/plasteel{
	dir = 4
	},
/obj/machinery/light{
	dir = 1
	},
/turf/open/floor/mainship/mono,
/area/shuttle/minidropship)

(1,1,1) = {"
k
o
f
y
m
y
m
y
a
"}
(2,1,1) = {"
P
h
s
X
c
X
u
X
A
"}
(3,1,1) = {"
n
o
Y
v
b
v
b
v
W
"}
