//MAP CONVERTED BY dmm2tgm.py THIS HEADER COMMENT PREVENTS RECONVERSION, DO NOT REMOVE
"a" = (
/obj/structure/dropship_piece/tadpole/rearleft{
	dir = 1
	},
/obj/machinery/vending/nanomed/tadpolemed{
	pixel_x = 5
	},
/turf/template_noop,
/area/shuttle/minidropship)
"c" = (
/obj/structure/dropship_piece/tadpole/tadpole_nose/left{
	dir = 1;
	pixel_y = 32
	},
/obj/structure/dropship_piece/tadpole/cockpit/left{
	dir = 1
	},
/obj/effect/attach_point/weapon/minidropship{
	equipment_offset_y = 25
	},
/turf/open/floor/mainship/mono,
/area/shuttle/minidropship)
"n" = (
/obj/structure/dropship_piece/tadpole/rearright{
	dir = 1
	},
/obj/machinery/telecomms/relay/preset/telecomms/onboard,
/turf/template_noop,
/area/shuttle/minidropship)
"o" = (
/obj/structure/dropship_piece/glassone/tadpole{
	dir = 1
	},
/turf/open/floor/plating/plating_catwalk,
/area/shuttle/minidropship)
"r" = (
/obj/structure/dropship_piece/tadpole/tadpole_nose{
	dir = 1;
	pixel_y = 32
	},
/obj/structure/dropship_piece/singlewindow/tadpole{
	dir = 1
	},
/turf/open/floor/plating/plating_catwalk,
/area/shuttle/minidropship)
"u" = (
/obj/structure/barricade/plasteel,
/turf/open/floor/plating/plating_catwalk,
/area/shuttle/minidropship)
"v" = (
/obj/machinery/computer/camera_advanced/shuttle_docker/minidropship,
/obj/machinery/camera/autoname/mainship,
/obj/machinery/vending/nanomed/tadpolemed{
	dir = 4;
	pixel_x = -16
	},
/obj/docking_port/mobile/marine_dropship/minidropship,
/turf/open/floor/plating/plating_catwalk,
/area/shuttle/minidropship)
"w" = (
/obj/structure/dropship_piece/glasstwo/tadpole{
	dir = 1
	},
/turf/open/floor/plating/plating_catwalk,
/area/shuttle/minidropship)
"S" = (
/obj/machinery/door_control{
	dir = 1;
	id = "minidropship_podlock";
	name = "outer door-control"
	},
/obj/structure/dropship_piece/tadpole/tadpole_nose/right{
	dir = 1;
	pixel_y = 32
	},
/obj/structure/dropship_piece/tadpole/cockpit/right{
	dir = 1
	},
/obj/effect/attach_point/weapon/minidropship{
	equipment_offset_y = 25
	},
/turf/open/floor/mainship/mono,
/area/shuttle/minidropship)

(1,1,1) = {"
c
o
a
"}
(2,1,1) = {"
r
v
u
"}
(3,1,1) = {"
S
w
n
"}
