//MAP CONVERTED BY dmm2tgm.py THIS HEADER COMMENT PREVENTS RECONVERSION, DO NOT REMOVE
"a" = (
/turf/open/space/basic,
/area/space)
"b" = (
/obj/docking_port/mobile/marine_dropship/minidropship,
/obj/structure/bed/chair/dropship/pilot{
	dir = 1
	},
/turf/open/floor/mainship/mono,
/area/shuttle/minidropship)
"d" = (
/obj/effect/attach_point/crew_weapon/minidropship{
	pixel_x = -21
	},
/turf/open/floor/mainship/mono,
/area/shuttle/minidropship)
"e" = (
/obj/structure/dropship_piece/tadpole/engine{
	dir = 1;
	pixel_x = -24;
	pixel_y = -14
	},
/obj/structure/barricade/plasteel{
	dir = 8
	},
/obj/machinery/light,
/turf/open/floor/mainship/mono,
/area/shuttle/minidropship)
"f" = (
/obj/structure/bed/chair/dropship/passenger{
	dir = 1
	},
/obj/docking_port/mobile/marine_dropship/minidropship,
/turf/open/floor/mainship/mono,
/area/shuttle/minidropship)
"j" = (
/obj/structure/bed/chair/dropship/passenger{
	dir = 1;
	pixel_x = -7
	},
/obj/structure/bed/chair/dropship/passenger{
	dir = 1;
	pixel_x = 8
	},
/turf/open/floor/mainship/mono,
/area/shuttle/minidropship)
"k" = (
/turf/closed/wall/mainship/outer/canterbury,
/area/space)
"r" = (
/obj/structure/dropship_piece/tadpole/rearright{
	dir = 1
	},
/turf/template_noop,
/area/shuttle/minidropship)
"u" = (
/obj/structure/barricade/plasteel{
	dir = 4
	},
/obj/machinery/light{
	dir = 1
	},
/turf/open/floor/mainship/mono,
/area/shuttle/minidropship)
"B" = (
/obj/structure/barricade/plasteel{
	dir = 8
	},
/obj/structure/barricade/plasteel,
/obj/structure/barricade/plasteel{
	dir = 1
	},
/turf/open/floor/mainship/mono,
/area/shuttle/minidropship)
"F" = (
/obj/structure/dropship_piece/two/weapon/leftleft{
	dir = 1;
	pixel_y = 32
	},
/obj/structure/dropship_piece/tadpole/engine{
	dir = 1;
	pixel_x = -23
	},
/obj/effect/attach_point/weapon/minidropship{
	equipment_offset_y = 25
	},
/turf/closed/shuttle/dropship2/rearcorner/alt/tadpole{
	dir = 1
	},
/area/shuttle/minidropship)
"I" = (
/obj/structure/dropship_piece/two/weapon/rightright{
	dir = 1;
	pixel_y = 32
	},
/obj/effect/attach_point/weapon/minidropship{
	equipment_offset_y = 25
	},
/obj/structure/dropship_piece/tadpole/engine{
	dir = 1;
	pixel_x = 23
	},
/turf/closed/shuttle/dropship2/rearcorner/tadpole{
	dir = 1
	},
/area/shuttle/minidropship)
"J" = (
/obj/structure/bed/chair/dropship/passenger{
	dir = 1
	},
/obj/machinery/vending/nanomed/tadpolemed{
	dir = 4;
	pixel_x = -15
	},
/turf/open/floor/mainship/mono,
/area/shuttle/minidropship)
"K" = (
/obj/machinery/computer/camera_advanced/shuttle_docker/minidropship,
/turf/open/floor/plating/plating_catwalk,
/area/shuttle/minidropship)
"M" = (
/obj/structure/dropship_piece/tadpole/rearleft{
	dir = 1
	},
/turf/template_noop,
/area/shuttle/minidropship)
"N" = (
/obj/machinery/telecomms/relay/preset/telecomms/onboard,
/turf/closed/wall/mainship/outer/canterbury,
/area/space)
"O" = (
/obj/effect/attach_point/crew_weapon/minidropship{
	pixel_x = 23
	},
/turf/open/floor/mainship/mono,
/area/shuttle/minidropship)
"Q" = (
/obj/structure/barricade/plasteel{
	dir = 4
	},
/obj/structure/barricade/plasteel{
	dir = 1
	},
/obj/structure/barricade/plasteel,
/turf/open/floor/mainship/mono,
/area/shuttle/minidropship)
"S" = (
/obj/structure/barricade/plasteel{
	dir = 8
	},
/obj/machinery/light{
	dir = 1
	},
/turf/open/floor/mainship/mono,
/area/shuttle/minidropship)
"V" = (
/obj/structure/window/framed/mainship/canterbury/dropship/reinforced,
/turf/open/floor/mainship/mono,
/area/shuttle/minidropship)
"W" = (
/obj/structure/dropship_piece/tadpole/engine{
	dir = 1;
	pixel_x = 23;
	pixel_y = -14
	},
/obj/structure/barricade/plasteel{
	dir = 4
	},
/obj/machinery/light,
/turf/open/floor/mainship/mono,
/area/shuttle/minidropship)

(1,1,1) = {"
a
a
a
B
a
a
a
a
a
"}
(2,1,1) = {"
a
F
S
d
e
M
a
a
k
"}
(3,1,1) = {"
V
K
b
j
f
J
N
k
k
"}
(4,1,1) = {"
a
I
u
O
W
r
a
a
k
"}
(5,1,1) = {"
a
a
a
Q
a
a
a
a
a
"}
