//MAP CONVERTED BY dmm2tgm.py THIS HEADER COMMENT PREVENTS RECONVERSION, DO NOT REMOVE
"a" = (
/turf/open/space/basic,
/area/space)
"e" = (
/obj/effect/attach_point/crew_weapon/minidropship{
	pixel_x = -21
	},
/turf/open/floor/mainship/mono,
/area/shuttle/minidropship)
"h" = (
/obj/structure/dropship_piece/tadpole/rearright{
	dir = 1
	},
/turf/template_noop,
/area/shuttle/minidropship)
"m" = (
/obj/structure/barricade/plasteel{
	dir = 4
	},
/obj/machinery/light{
	dir = 1
	},
/turf/open/floor/mainship/mono,
/area/shuttle/minidropship)
"n" = (
/obj/structure/barricade/plasteel{
	dir = 8
	},
/obj/machinery/light{
	dir = 1
	},
/turf/open/floor/mainship/mono,
/area/shuttle/minidropship)
"o" = (
/obj/machinery/computer/camera_advanced/shuttle_docker/minidropship,
/turf/open/floor/plating/plating_catwalk,
/area/shuttle/minidropship)
"r" = (
/obj/structure/dropship_piece/two/weapon/rightright{
	dir = 1;
	pixel_y = 32
	},
/obj/effect/attach_point/weapon/minidropship{
	equipment_offset_y = 25
	},
/obj/structure/dropship_piece/tadpole/engine{
	dir = 1;
	pixel_x = 23
	},
/turf/closed/shuttle/dropship2/rearcorner/tadpole{
	dir = 1
	},
/area/shuttle/minidropship)
"y" = (
/obj/effect/attach_point/crew_weapon/minidropship{
	pixel_x = 23
	},
/turf/open/floor/mainship/mono,
/area/shuttle/minidropship)
"z" = (
/obj/structure/barricade/plasteel{
	dir = 4
	},
/obj/structure/barricade/plasteel{
	dir = 1
	},
/obj/structure/barricade/plasteel,
/turf/open/floor/mainship/mono,
/area/shuttle/minidropship)
"A" = (
/obj/structure/window/framed/mainship/canterbury/dropship/reinforced,
/turf/open/floor/mainship/mono,
/area/shuttle/minidropship)
"C" = (
/obj/structure/bed/chair/dropship/passenger{
	dir = 8;
	pixel_x = -13
	},
/obj/structure/bed/chair/dropship/passenger{
	dir = 4;
	pixel_x = 11
	},
/turf/open/floor/mainship/mono,
/area/shuttle/minidropship)
"H" = (
/obj/structure/dropship_piece/tadpole/engine{
	dir = 1;
	pixel_x = -24;
	pixel_y = -14
	},
/obj/structure/barricade/plasteel{
	dir = 8
	},
/obj/machinery/light,
/turf/open/floor/mainship/mono,
/area/shuttle/minidropship)
"J" = (
/turf/closed/wall/mainship/outer/canterbury,
/area/space)
"N" = (
/obj/structure/bed/chair/dropship/passenger{
	dir = 1
	},
/obj/machinery/vending/nanomed/tadpolemed{
	dir = 4;
	pixel_x = -15
	},
/turf/open/floor/mainship/mono,
/area/shuttle/minidropship)
"P" = (
/obj/docking_port/mobile/marine_dropship/minidropship,
/obj/structure/bed/chair/dropship/pilot{
	dir = 1
	},
/turf/open/floor/mainship/mono,
/area/shuttle/minidropship)
"Q" = (
/obj/machinery/telecomms/relay/preset/telecomms/onboard,
/turf/closed/wall/mainship/outer/canterbury,
/area/space)
"S" = (
/obj/structure/dropship_piece/tadpole/engine{
	dir = 1;
	pixel_x = 23;
	pixel_y = -14
	},
/obj/structure/barricade/plasteel{
	dir = 4
	},
/obj/machinery/light,
/turf/open/floor/mainship/mono,
/area/shuttle/minidropship)
"T" = (
/obj/structure/dropship_piece/two/weapon/leftleft{
	dir = 1;
	pixel_y = 32
	},
/obj/structure/dropship_piece/tadpole/engine{
	dir = 1;
	pixel_x = -23
	},
/obj/effect/attach_point/weapon/minidropship{
	equipment_offset_y = 25
	},
/turf/closed/shuttle/dropship2/rearcorner/alt/tadpole{
	dir = 1
	},
/area/shuttle/minidropship)
"W" = (
/obj/structure/bed/chair/dropship/passenger{
	dir = 1
	},
/obj/docking_port/mobile/marine_dropship/minidropship,
/turf/open/floor/mainship/mono,
/area/shuttle/minidropship)
"X" = (
/obj/structure/dropship_piece/tadpole/rearleft{
	dir = 1
	},
/turf/template_noop,
/area/shuttle/minidropship)
"Y" = (
/obj/structure/barricade/plasteel{
	dir = 8
	},
/obj/structure/barricade/plasteel,
/obj/structure/barricade/plasteel{
	dir = 1
	},
/turf/open/floor/mainship/mono,
/area/shuttle/minidropship)

(1,1,1) = {"
a
a
a
Y
a
a
a
a
a
"}
(2,1,1) = {"
a
T
n
e
H
X
a
a
J
"}
(3,1,1) = {"
A
o
P
C
W
N
Q
J
J
"}
(4,1,1) = {"
a
r
m
y
S
h
a
a
J
"}
(5,1,1) = {"
a
a
a
z
a
a
a
a
a
"}
