//MAP CONVERTED BY dmm2tgm.py THIS HEADER COMMENT PREVENTS RECONVERSION, DO NOT REMOVE
"b" = (
/turf/template_noop,
/area/template_noop)
"e" = (
/obj/effect/turf_decal/tile/transparent/dark_blue/full,
/obj/structure/bed/chair/dropship/passenger{
	dir = 8
	},
/turf/open/floor/mainship/mono,
/area/shuttle/minidropship)
"f" = (
/obj/structure/dropship_piece/tadpole/engine{
	dir = 1;
	pixel_x = 23
	},
/turf/closed/shuttle/ert/engines/right{
	dir = 1
	},
/area/shuttle/minidropship)
"i" = (
/obj/effect/turf_decal/warning_stripes/box,
/turf/open/floor/mainship/mono,
/area/shuttle/minidropship)
"j" = (
/obj/structure/bed/chair/dropship/passenger{
	dir = 8
	},
/obj/effect/turf_decal/tile/transparent/dark_blue/full,
/obj/machinery/camera/autoname/mainship{
	dir = 8;
	pixel_x = 14
	},
/turf/open/floor/mainship/mono,
/area/shuttle/minidropship)
"k" = (
/obj/structure/dropship_piece/tadpole/engine{
	dir = 1;
	pixel_x = 23
	},
/turf/closed/wall/mainship/outer/canterbury,
/area/shuttle/minidropship)
"l" = (
/obj/structure/barricade/plasteel{
	dir = 8
	},
/turf/open/floor/plating/plating_catwalk,
/area/shuttle/minidropship)
"o" = (
/obj/machinery/cic_maptable,
/turf/open/floor/mainship/floor,
/area/shuttle/minidropship)
"q" = (
/turf/open/floor/plating/plating_catwalk,
/area/shuttle/minidropship)
"t" = (
/obj/structure/dropship_piece/tadpole/engine{
	dir = 1;
	pixel_x = -23
	},
/turf/closed/wall/mainship/outer/canterbury,
/area/shuttle/minidropship)
"u" = (
/obj/effect/turf_decal/tile/transparent/dark_blue/full,
/obj/docking_port/mobile/marine_dropship/minidropship,
/turf/open/floor/mainship/mono,
/area/shuttle/minidropship)
"v" = (
/obj/effect/attach_point/crew_weapon/minidropship,
/turf/open/floor/plating/plating_catwalk,
/area/shuttle/minidropship)
"x" = (
/obj/effect/attach_point/weapon/minidropship{
	equipment_offset_y = 25
	},
/obj/structure/dropship_piece/two/weapon/leftleft{
	dir = 1;
	pixel_y = 32
	},
/turf/closed/wall/mainship/outer/canterbury,
/area/shuttle/minidropship)
"z" = (
/obj/structure/window/framed/mainship/canterbury/dropship/reinforced,
/turf/open/floor/mainship/floor,
/area/shuttle/minidropship)
"C" = (
/obj/machinery/light,
/turf/open/floor/plating/plating_catwalk,
/area/shuttle/minidropship)
"D" = (
/obj/structure/bed/chair/dropship/passenger{
	dir = 4
	},
/obj/effect/turf_decal/tile/transparent/dark_blue/full,
/obj/machinery/door_control{
	dir = 4;
	id = "minidropship_podlock";
	name = "inner door-control";
	pixel_x = -25
	},
/turf/open/floor/mainship/mono,
/area/shuttle/minidropship)
"E" = (
/obj/effect/attach_point/weapon/minidropship{
	equipment_offset_y = 25
	},
/obj/structure/dropship_piece/two/weapon/rightright{
	dir = 1;
	pixel_y = 32
	},
/turf/closed/wall/mainship/outer/canterbury,
/area/shuttle/minidropship)
"F" = (
/turf/closed/wall/mainship/outer/canterbury,
/area/shuttle/minidropship)
"G" = (
/obj/structure/closet/walllocker/hydrant/extinguisher{
	pixel_x = -25
	},
/obj/structure/table/mainship,
/turf/open/floor/mainship/floor,
/area/shuttle/minidropship)
"J" = (
/obj/machinery/light{
	dir = 8
	},
/obj/structure/bed/chair/dropship/passenger{
	dir = 4
	},
/turf/open/floor/mainship/floor,
/area/shuttle/minidropship)
"L" = (
/obj/machinery/computer/camera_advanced/shuttle_docker/minidropship,
/obj/machinery/light{
	dir = 1
	},
/turf/open/floor/mainship/floor,
/area/shuttle/minidropship)
"N" = (
/turf/closed/shuttle/ert/engines/right{
	dir = 1
	},
/area/shuttle/minidropship)
"O" = (
/obj/structure/bed/chair/dropship/passenger{
	dir = 8
	},
/turf/open/floor/plating/plating_catwalk,
/area/shuttle/minidropship)
"P" = (
/turf/open/floor/mainship/floor,
/area/shuttle/minidropship)
"Q" = (
/obj/machinery/telecomms/relay/preset/telecomms/onboard,
/turf/closed/wall/mainship/outer/canterbury,
/area/shuttle/minidropship)
"R" = (
/turf/closed/shuttle/ert/engines/left{
	dir = 1
	},
/area/shuttle/minidropship)
"S" = (
/obj/structure/bed/chair/dropship/passenger{
	dir = 8
	},
/turf/open/floor/mainship/floor,
/area/shuttle/minidropship)
"T" = (
/obj/machinery/vending/nanomed/tadpolemed,
/obj/structure/barricade/plasteel{
	dir = 8
	},
/turf/open/floor/plating/plating_catwalk,
/area/shuttle/minidropship)
"U" = (
/obj/effect/turf_decal/warning_stripes/box,
/obj/machinery/door/poddoor/shutters/transit/nonsmoothing,
/obj/machinery/door/poddoor/mainship/open{
	id = "minidropship_podlock"
	},
/obj/structure/barricade/plasteel{
	dir = 8
	},
/turf/open/floor/mainship/mono,
/area/shuttle/minidropship)
"V" = (
/obj/structure/window/reinforced,
/turf/open/floor/mainship/floor,
/area/shuttle/minidropship)
"X" = (
/obj/structure/dropship_piece/tadpole/engine{
	dir = 1;
	pixel_x = -23
	},
/turf/closed/shuttle/ert/engines/left{
	dir = 1
	},
/area/shuttle/minidropship)
"Y" = (
/obj/structure/bed/chair/dropship/pilot{
	dir = 1
	},
/obj/machinery/door/window{
	dir = 2
	},
/turf/open/floor/mainship/floor,
/area/shuttle/minidropship)

(1,1,1) = {"
b
b
b
t
U
U
t
b
b
"}
(2,1,1) = {"
b
b
b
z
i
i
z
b
b
"}
(3,1,1) = {"
x
t
F
Q
T
l
F
F
X
"}
(4,1,1) = {"
z
G
V
J
u
q
D
F
R
"}
(5,1,1) = {"
z
L
Y
P
v
q
C
F
F
"}
(6,1,1) = {"
z
o
V
S
e
O
j
F
N
"}
(7,1,1) = {"
E
k
F
z
z
z
F
F
f
"}
