//MAP CONVERTED BY dmm2tgm.py THIS HEADER COMMENT PREVENTS RECONVERSION, DO NOT REMOVE
"bi" = (
/obj/structure/bed/chair/dropship/passenger{
	dir = 4
	},
/turf/open/shuttle/dropship/four,
/area/shuttle/dropship/normandy)
"cK" = (
/obj/structure/prop/holidays/string_lights/corner{
	dir = 8
	},
/turf/closed/shuttle/dropship2/glassone,
/area/shuttle/dropship/normandy)
"cW" = (
/obj/structure/bed/chair/dropship/passenger,
/turf/open/shuttle/dropship/seven,
/area/shuttle/dropship/normandy)
"eY" = (
/turf/open/shuttle/dropship/three,
/area/shuttle/dropship/normandy)
"fz" = (
/obj/structure/dropship_piece/two/engine/leftbottom,
/turf/closed/shuttle/dropship2/engineone{
	dir = 4
	},
/area/shuttle/dropship/normandy)
"fJ" = (
/obj/structure/bed/chair/dropship/passenger{
	dir = 4
	},
/obj/machinery/light{
	dir = 8
	},
/turf/open/shuttle/dropship/three,
/area/shuttle/dropship/normandy)
"gx" = (
/obj/structure/prop/holidays/string_lights{
	dir = 4
	},
/turf/closed/shuttle/dropship2/engine_sidealt{
	dir = 4
	},
/area/shuttle/dropship/normandy)
"gA" = (
/obj/effect/attach_point/crew_weapon/dropship2,
/turf/open/shuttle/dropship/floor,
/area/shuttle/dropship/normandy)
"hz" = (
/obj/structure/dropship_piece/two/cockpit/right{
	dir = 1
	},
/obj/structure/prop/holidays/string_lights/corner{
	dir = 1
	},
/turf/template_noop,
/area/shuttle/dropship/normandy)
"iq" = (
/obj/structure/bed/chair/dropship/passenger,
/obj/docking_port/mobile/marine_dropship/two,
/turf/open/shuttle/dropship/floor,
/area/shuttle/dropship/normandy)
"jx" = (
/obj/machinery/computer/shuttle/marine_dropship/two,
/turf/open/shuttle/dropship/floor,
/area/shuttle/dropship/normandy)
"jY" = (
/obj/structure/bed/chair/dropship/passenger{
	dir = 8
	},
/turf/open/shuttle/dropship/three,
/area/shuttle/dropship/normandy)
"lI" = (
/obj/machinery/door/poddoor/shutters/transit{
	dir = 1
	},
/turf/open/shuttle/dropship/floor/alt,
/area/shuttle/dropship/normandy)
"mf" = (
/obj/machinery/telecomms/relay/preset/telecomms/onboard,
/obj/structure/prop/holidays/string_lights,
/turf/closed/shuttle/dropship2/edge{
	dir = 1
	},
/area/shuttle/dropship/normandy)
"nu" = (
/obj/structure/bed/chair/dropship/passenger{
	dir = 4
	},
/turf/open/shuttle/dropship/three,
/area/shuttle/dropship/normandy)
"oe" = (
/obj/structure/bed/chair/dropship/passenger{
	dir = 8
	},
/obj/machinery/camera/autoname/mainship/dropship_two{
	dir = 8
	},
/turf/open/shuttle/dropship/three,
/area/shuttle/dropship/normandy)
"oB" = (
/obj/structure/bed/chair/dropship/passenger,
/obj/item/radio/intercom/dropship/normandy,
/turf/open/shuttle/dropship/six,
/area/shuttle/dropship/normandy)
"pB" = (
/obj/structure/prop/holidays/string_lights{
	dir = 8
	},
/turf/closed/shuttle/dropship2/glassfour,
/area/shuttle/dropship/normandy)
"qP" = (
/turf/closed/shuttle/dropship2/enginetwo{
	dir = 1
	},
/area/shuttle/dropship/normandy)
"qW" = (
/turf/closed/shuttle/dropship2/enginethree{
	dir = 4
	},
/area/shuttle/dropship/normandy)
"rG" = (
/obj/structure/prop/holidays/string_lights,
/turf/closed/shuttle/dropship2/edge{
	dir = 1
	},
/area/shuttle/dropship/normandy)
"rN" = (
/turf/closed/shuttle/dropship2/enginetwo{
	dir = 8
	},
/area/shuttle/dropship/normandy)
"sh" = (
/turf/closed/shuttle/dropship2/enginetwo{
	dir = 4
	},
/area/shuttle/dropship/normandy)
"th" = (
/turf/open/shuttle/dropship/five,
/area/shuttle/dropship/normandy)
"ud" = (
/turf/closed/shuttle/dropship2/engineone/alt,
/area/shuttle/dropship/normandy)
"ur" = (
/obj/structure/bed/chair/dropship/pilot{
	dir = 1
	},
/obj/machinery/camera/autoname/mainship/dropship_two{
	dir = 8
	},
/obj/machinery/light{
	dir = 8
	},
/turf/open/shuttle/dropship/floor,
/area/shuttle/dropship/normandy)
"wV" = (
/obj/structure/prop/holidays/string_lights/corner{
	dir = 8
	},
/turf/closed/shuttle/dropship2/wallthree,
/area/shuttle/dropship/normandy)
"xX" = (
/turf/closed/shuttle/dropship2/singlewindow{
	dir = 1
	},
/area/shuttle/dropship/normandy)
"yx" = (
/obj/structure/dropship_piece/two/corner/rearleft{
	dir = 1
	},
/turf/template_noop,
/area/shuttle/dropship/normandy)
"yT" = (
/obj/machinery/door/poddoor/shutters/transit,
/obj/machinery/door/airlock/dropship_hatch/right/two,
/turf/open/shuttle/dropship/floor,
/area/shuttle/dropship/normandy)
"zF" = (
/obj/structure/dropship_piece/two/front/left{
	dir = 1
	},
/turf/template_noop,
/area/shuttle/dropship/normandy)
"AM" = (
/turf/closed/shuttle/dropship2/enginetwo,
/area/shuttle/dropship/normandy)
"Bd" = (
/turf/closed/shuttle/dropship2/enginethree{
	dir = 8
	},
/area/shuttle/dropship/normandy)
"BK" = (
/obj/machinery/door/poddoor/shutters/transit{
	dir = 1
	},
/obj/machinery/door/airlock/multi_tile/mainship/dropshiprear/ds2,
/turf/open/shuttle/dropship/floor/alt,
/area/shuttle/dropship/normandy)
"Cq" = (
/obj/machinery/door/poddoor/shutters/transit{
	dir = 8
	},
/obj/machinery/door/airlock/dropship_hatch/left/two,
/turf/open/shuttle/dropship/floor,
/area/shuttle/dropship/normandy)
"CN" = (
/turf/closed/shuttle/dropship2/engineone/alt{
	dir = 1
	},
/area/shuttle/dropship/normandy)
"Dp" = (
/obj/structure/dropship_piece/two/engine/leftbottom,
/turf/closed/shuttle/dropship2/engineone,
/area/shuttle/dropship/normandy)
"Dz" = (
/obj/structure/bed/chair/dropship/passenger{
	dir = 8
	},
/obj/machinery/light{
	dir = 4
	},
/turf/open/shuttle/dropship/three,
/area/shuttle/dropship/normandy)
"DH" = (
/obj/structure/prop/holidays/string_lights{
	dir = 4
	},
/turf/closed/shuttle/dropship2/walltwo,
/area/shuttle/dropship/normandy)
"Fn" = (
/obj/structure/prop/holidays/string_lights{
	dir = 4
	},
/turf/closed/shuttle/dropship2/glassthree,
/area/shuttle/dropship/normandy)
"FH" = (
/turf/closed/shuttle/dropship2/engineone/alt{
	dir = 4
	},
/area/shuttle/dropship/normandy)
"Gg" = (
/turf/closed/shuttle/dropship2/engineone/alt{
	dir = 8
	},
/area/shuttle/dropship/normandy)
"Ii" = (
/turf/closed/shuttle/dropship2/enginethree,
/area/shuttle/dropship/normandy)
"Iv" = (
/obj/structure/prop/holidays/string_lights{
	dir = 8
	},
/turf/closed/shuttle/dropship2/engine_sidealt{
	dir = 8
	},
/area/shuttle/dropship/normandy)
"Js" = (
/obj/structure/prop/holidays/string_lights/corner{
	dir = 4
	},
/turf/closed/shuttle/dropship2/glasstwo,
/area/shuttle/dropship/normandy)
"JK" = (
/turf/closed/shuttle/dropship2/enginethree{
	dir = 1
	},
/area/shuttle/dropship/normandy)
"LS" = (
/turf/open/shuttle/dropship/floor,
/area/shuttle/dropship/normandy)
"Mg" = (
/obj/structure/dropship_piece/two/engine/rightbottom,
/turf/closed/shuttle/dropship2/engineone{
	dir = 8
	},
/area/shuttle/dropship/normandy)
"OZ" = (
/obj/structure/prop/holidays/string_lights{
	dir = 8
	},
/turf/closed/shuttle/dropship2/wallthree,
/area/shuttle/dropship/normandy)
"Ph" = (
/obj/structure/dropship_piece/two/front/right{
	dir = 1
	},
/turf/template_noop,
/area/shuttle/dropship/normandy)
"Qh" = (
/obj/structure/dropship_piece/two/front{
	dir = 1
	},
/turf/template_noop,
/area/shuttle/dropship/normandy)
"Qr" = (
/obj/structure/prop/holidays/string_lights/corner{
	dir = 4
	},
/turf/closed/shuttle/dropship2/walltwo,
/area/shuttle/dropship/normandy)
"QN" = (
/obj/structure/dropship_piece/two/corner/rearright{
	dir = 1
	},
/turf/template_noop,
/area/shuttle/dropship/normandy)
"Rq" = (
/obj/structure/bed/chair/dropship/passenger{
	dir = 8
	},
/turf/open/shuttle/dropship/eight,
/area/shuttle/dropship/normandy)
"Su" = (
/obj/structure/prop/holidays/string_lights{
	dir = 4
	},
/turf/closed/shuttle/dropship2/engine_sidealt,
/area/shuttle/dropship/normandy)
"SV" = (
/obj/structure/bed/chair/dropship/passenger{
	dir = 4
	},
/obj/machinery/vending/nanomed{
	dir = 4
	},
/turf/open/shuttle/dropship/three,
/area/shuttle/dropship/normandy)
"Tb" = (
/obj/structure/dropship_piece/two/cockpit/left{
	dir = 1
	},
/obj/structure/prop/holidays/string_lights/corner,
/turf/template_noop,
/area/shuttle/dropship/normandy)
"Wg" = (
/obj/structure/prop/holidays/string_lights/corner,
/turf/closed/shuttle/dropship2/rearcorner/alt{
	dir = 1
	},
/area/shuttle/dropship/normandy)
"Wk" = (
/obj/structure/prop/holidays/string_lights/corner{
	dir = 1
	},
/turf/closed/shuttle/dropship2/rearcorner{
	dir = 1
	},
/area/shuttle/dropship/normandy)
"XK" = (
/obj/structure/bed/chair/dropship/passenger{
	dir = 8
	},
/obj/machinery/vending/nanomed{
	dir = 8
	},
/turf/open/shuttle/dropship/three,
/area/shuttle/dropship/normandy)
"Ye" = (
/obj/structure/prop/holidays/string_lights{
	dir = 8
	},
/turf/closed/shuttle/dropship2/engine_sidealt{
	dir = 1
	},
/area/shuttle/dropship/normandy)
"Zp" = (
/turf/template_noop,
/area/template_noop)
"ZF" = (
/obj/machinery/door/airlock/hatch/cockpit/two,
/turf/open/shuttle/dropship/floor,
/area/shuttle/dropship/normandy)

(1,1,1) = {"
Zp
Zp
Zp
Zp
Zp
Zp
Zp
Zp
ud
Ii
AM
fz
Zp
"}
(2,1,1) = {"
Zp
Zp
Zp
Zp
Zp
Zp
Zp
Zp
CN
JK
rN
Mg
Zp
"}
(3,1,1) = {"
Zp
Zp
Zp
Zp
Wg
DH
Cq
DH
DH
Su
gx
Qr
yx
"}
(4,1,1) = {"
zF
Tb
Fn
Js
rG
oB
eY
nu
fJ
SV
nu
bi
BK
"}
(5,1,1) = {"
Qh
xX
jx
ur
ZF
th
iq
gA
LS
LS
LS
th
lI
"}
(6,1,1) = {"
Ph
hz
pB
cK
mf
cW
eY
oe
Dz
XK
jY
Rq
lI
"}
(7,1,1) = {"
Zp
Zp
Zp
Zp
Wk
OZ
yT
OZ
OZ
Ye
Iv
wV
QN
"}
(8,1,1) = {"
Zp
Zp
Zp
Zp
Zp
Zp
Zp
Zp
FH
Bd
sh
Dp
Zp
"}
(9,1,1) = {"
Zp
Zp
Zp
Zp
Zp
Zp
Zp
Zp
Gg
qW
qP
Mg
Zp
"}
