//MAP CONVERTED BY dmm2tgm.py THIS HEADER COMMENT PREVENTS RECONVERSION, DO NOT REMOVE
"a" = (
/turf/open/floor/plating/plating_catwalk,
/area/shuttle/supply/som)
"b" = (
/obj/docking_port/mobile/supply/som,
/turf/open/floor/plating/plating_catwalk,
/area/shuttle/supply/som)

(1,1,1) = {"
a
"}
(2,1,1) = {"
b
"}
(3,1,1) = {"
a
"}
