//MAP CONVERTED BY dmm2tgm.py THIS HEADER COMMENT PREVENTS RECONVERSION, DO NOT REMOVE
"aa" = (
/turf/template_noop,
/area/template_noop)
"ab" = (
/turf/closed/wall/mainship/outer/canterbury,
/area/shuttle/canterbury/cic)
"ac" = (
/obj/structure/window/framed/mainship/hull/canterbury,
/turf/open/floor/plating,
/area/shuttle/canterbury/cic)
"ad" = (
/obj/structure/table/mainship,
/obj/machinery/computer/security/marine_network,
/turf/open/floor/mainship/blue{
	dir = 9
	},
/area/shuttle/canterbury/cic)
"ae" = (
/obj/structure/table/mainship,
/obj/machinery/computer/shuttle/shuttle_control/canterbury,
/turf/open/floor/mainship/blue{
	dir = 1
	},
/area/shuttle/canterbury/cic)
"af" = (
/obj/structure/table/mainship,
/obj/machinery/computer/camera_advanced/overwatch,
/turf/open/floor/mainship/blue{
	dir = 1
	},
/area/shuttle/canterbury/cic)
"ag" = (
/obj/structure/table/mainship,
/obj/machinery/faxmachine/cic,
/turf/open/floor/mainship/blue{
	dir = 1
	},
/area/shuttle/canterbury/cic)
"ah" = (
/obj/structure/table/mainship,
/obj/machinery/computer/marine_card,
/turf/open/floor/mainship/blue{
	dir = 5
	},
/area/shuttle/canterbury/cic)
"ai" = (
/turf/open/floor/mainship/blue{
	dir = 8
	},
/area/shuttle/canterbury/cic)
"aj" = (
/obj/structure/bed/chair/dropship/pilot{
	dir = 1
	},
/obj/effect/landmark/start/job/crash/fieldcommander,
/turf/open/floor/mainship/mono,
/area/shuttle/canterbury/cic)
"ak" = (
/turf/open/floor/mainship/blue/full,
/area/shuttle/canterbury/cic)
"am" = (
/turf/open/floor/mainship/blue{
	dir = 4
	},
/area/shuttle/canterbury/cic)
"an" = (
/turf/closed/wall/mainship/outer/canterbury,
/area/shuttle/canterbury)
"ao" = (
/obj/structure/cable,
/obj/docking_port/mobile/crashmode,
/turf/open/floor/plating/plating_catwalk,
/area/shuttle/canterbury)
"ap" = (
/obj/machinery/light{
	dir = 8
	},
/obj/structure/closet/secure_closet/guncabinet/canterbury,
/obj/machinery/firealarm{
	dir = 1
	},
/turf/open/floor/mainship/blue{
	dir = 10
	},
/area/shuttle/canterbury/cic)
"aq" = (
/obj/machinery/telecomms/relay/preset/telecomms,
/obj/machinery/air_alarm{
	dir = 1
	},
/turf/open/floor/mainship/blue,
/area/shuttle/canterbury/cic)
"ar" = (
/obj/structure/cable,
/turf/open/floor/mainship,
/area/shuttle/canterbury/cic)
"as" = (
/obj/machinery/power/apc/mainship{
	dir = 1
	},
/obj/structure/cable,
/obj/machinery/marine_selector/clothes/commander,
/turf/open/floor/mainship/blue,
/area/shuttle/canterbury/cic)
"at" = (
/obj/machinery/light{
	dir = 4
	},
/obj/machinery/marine_selector/gear/commander,
/turf/open/floor/mainship/blue{
	dir = 6
	},
/area/shuttle/canterbury/cic)
"au" = (
/obj/machinery/air_alarm,
/obj/machinery/door_control{
	dir = 4;
	id = "port_umbilical_outer";
	name = "outer door-control"
	},
/obj/structure/largecrate/supply/supplies/sandbags,
/turf/open/floor/mainship/cargo,
/area/shuttle/canterbury)
"av" = (
/obj/structure/rack,
/obj/effect/turf_decal/warning_stripes/thin{
	dir = 4
	},
/obj/item/tool/hand_labeler,
/obj/item/storage/toolbox/electrical,
/obj/machinery/light/small{
	dir = 1
	},
/obj/item/stack/barbed_wire/full,
/obj/item/stack/razorwire/full,
/obj/item/stack/sheet/metal/large_stack,
/obj/item/stack/sheet/metal/large_stack,
/obj/item/stack/sheet/plasteel/medium_stack,
/obj/item/tool/wrench,
/obj/item/storage/toolbox/mechanical,
/obj/item/tool/screwdriver,
/turf/open/floor/mainship/cargo,
/area/shuttle/canterbury)
"aw" = (
/obj/machinery/door/airlock/mainship/command/canterbury{
	dir = 1;
	name = "\improper Command Cockpit"
	},
/obj/structure/cable,
/turf/open/floor/mainship/mono,
/area/shuttle/canterbury/cic)
"ax" = (
/obj/machinery/light/small{
	dir = 1
	},
/obj/structure/rack,
/obj/item/storage/toolbox/mechanical,
/obj/item/tool/wrench,
/obj/item/tool/screwdriver,
/obj/item/tool/crowbar,
/obj/effect/spawner/random/engineering/extinguisher/regularweighted,
/turf/open/floor/mainship/cargo,
/area/shuttle/canterbury)
"ay" = (
/obj/machinery/air_alarm,
/obj/machinery/door_control{
	dir = 8;
	id = "starboard_umbilical_outer";
	name = "outer door-control"
	},
/obj/structure/rack,
/obj/effect/spawner/random/engineering/extinguisher/regularweighted,
/obj/item/storage/belt/utility/full,
/obj/item/clothing/suit/storage/hazardvest,
/obj/item/radio/intercom{
	freerange = 1;
	name = "General Listening Channel"
	},
/turf/open/floor/mainship/cargo,
/area/shuttle/canterbury)
"aA" = (
/obj/structure/barricade/folding{
	dir = 8
	},
/turf/open/floor/mainship/stripesquare,
/area/shuttle/canterbury)
"aB" = (
/obj/structure/bed/chair/dropship/passenger,
/obj/effect/landmark/start/job/crash/squadmarine,
/turf/open/floor/mainship/mono,
/area/shuttle/canterbury)
"aC" = (
/obj/machinery/light{
	dir = 1
	},
/obj/machinery/chem_master,
/obj/item/reagent_containers/glass/beaker/bluespace,
/obj/item/reagent_containers/glass/beaker/bluespace,
/turf/open/floor/mainship/sterile,
/area/shuttle/canterbury/medical)
"aD" = (
/turf/open/floor/mainship/mono,
/area/shuttle/canterbury)
"aF" = (
/obj/structure/barricade/folding{
	dir = 4
	},
/turf/open/floor/mainship/stripesquare,
/area/shuttle/canterbury)
"aH" = (
/obj/machinery/door/poddoor/mainship{
	id = "port_umbilical_outer";
	name = "\improper Umbillical Airlock"
	},
/obj/machinery/door/poddoor/shutters/transit,
/turf/open/floor/mainship/mono,
/area/shuttle/canterbury)
"aJ" = (
/turf/open/floor/plating/plating_catwalk,
/area/shuttle/canterbury)
"aK" = (
/obj/machinery/door/poddoor/mainship{
	id = "starboard_umbilical_outer";
	name = "\improper Umbillical Airlock"
	},
/obj/machinery/door/poddoor/shutters/transit,
/turf/open/floor/mainship/mono,
/area/shuttle/canterbury)
"aL" = (
/obj/effect/landmark/start/job/crash/squadmarine,
/obj/structure/bed/chair/dropship/passenger,
/turf/open/floor/mainship/mono,
/area/shuttle/canterbury)
"aN" = (
/obj/item/radio/intercom{
	freerange = 1;
	name = "General Listening Channel";
	dir = 4
	},
/obj/machinery/vending/tool,
/obj/structure/window/reinforced/toughened{
	dir = 1
	},
/turf/open/floor/mainship/orange/full,
/area/shuttle/canterbury)
"aO" = (
/obj/machinery/loadout_vendor/crash,
/turf/open/floor/mainship/cargo,
/area/shuttle/canterbury)
"aP" = (
/obj/machinery/power/fusion_engine/random,
/obj/structure/cable,
/turf/open/floor/mainship/mono,
/area/shuttle/canterbury)
"aQ" = (
/obj/machinery/fuelcell_recycler,
/turf/open/floor/mainship/orange/full,
/area/shuttle/canterbury)
"aR" = (
/obj/structure/window/framed/mainship/canterbury,
/turf/open/floor/plating,
/area/shuttle/canterbury)
"aT" = (
/obj/structure/reagent_dispensers/fueltank,
/turf/open/floor/mainship/orange/full,
/area/shuttle/canterbury)
"aV" = (
/obj/effect/landmark/start/job/crash/squadleader,
/turf/open/floor/mainship/mono,
/area/shuttle/canterbury)
"aW" = (
/obj/structure/window/reinforced/toughened{
	dir = 4
	},
/obj/machinery/marine_selector/clothes/leader,
/turf/open/floor/mainship/cargo,
/area/shuttle/canterbury)
"aZ" = (
/obj/machinery/power/terminal,
/obj/effect/turf_decal/warning_stripes/thin{
	dir = 1
	},
/obj/effect/turf_decal/warning_stripes/thin{
	dir = 4
	},
/obj/machinery/light/small{
	dir = 8
	},
/obj/structure/cable,
/obj/structure/rack,
/obj/item/fuel_cell/random,
/obj/item/fuel_cell/random,
/obj/item/fuel_cell/random,
/turf/open/floor/mainship/tcomms,
/area/shuttle/canterbury)
"bb" = (
/obj/machinery/door/airlock/mainship/engineering/free_access,
/obj/structure/cable,
/turf/open/floor/mainship/orange/full,
/area/shuttle/canterbury)
"bd" = (
/obj/structure/window/reinforced/toughened{
	dir = 4
	},
/obj/machinery/vending/weapon/crash,
/turf/open/floor/mainship/cargo,
/area/shuttle/canterbury)
"be" = (
/obj/machinery/marine_selector/clothes/synth,
/turf/open/floor/mainship/mono,
/area/shuttle/canterbury)
"bg" = (
/obj/structure/cable,
/obj/effect/landmark/start/job/crash/synthetic,
/turf/open/floor/mainship/orange/full,
/area/shuttle/canterbury)
"bi" = (
/obj/machinery/power/smes/preset,
/obj/effect/turf_decal/warning_stripes/thin{
	dir = 4
	},
/obj/structure/cable,
/turf/open/floor/mainship/tcomms,
/area/shuttle/canterbury)
"bj" = (
/obj/machinery/power/monitor{
	name = "Core Power Monitoring"
	},
/obj/structure/cable,
/turf/open/floor/mainship/orange/full,
/area/shuttle/canterbury)
"bk" = (
/obj/structure/window/reinforced/toughened{
	dir = 4
	},
/obj/machinery/marine_selector/gear/leader,
/turf/open/floor/mainship/cargo,
/area/shuttle/canterbury)
"bl" = (
/obj/item/lightreplacer,
/obj/item/clothing/glasses/welding,
/obj/item/cell/high,
/obj/machinery/cell_charger,
/obj/item/radio,
/obj/item/tool/crowbar,
/obj/item/storage/box/crate/sentry,
/obj/item/storage/box/crate/sentry,
/obj/item/storage/box/crate/sentry,
/obj/structure/rack,
/turf/open/floor/mainship/orange/full,
/area/shuttle/canterbury)
"bn" = (
/obj/machinery/cryopod,
/turf/open/floor/mainship/mono,
/area/shuttle/canterbury)
"bo" = (
/turf/closed/wall/mainship/outer/canterbury,
/area/shuttle/canterbury/medical)
"bp" = (
/obj/effect/landmark/start/latejoin/crash,
/obj/machinery/light{
	dir = 1
	},
/turf/open/floor/mainship/mono,
/area/shuttle/canterbury)
"bq" = (
/obj/effect/landmark/start/latejoin/crash,
/turf/open/floor/mainship/mono,
/area/shuttle/canterbury)
"br" = (
/obj/structure/window/reinforced{
	dir = 8
	},
/obj/structure/window/reinforced{
	dir = 4
	},
/obj/machinery/vending/weapon/crash,
/turf/open/floor/mainship/mono,
/area/shuttle/canterbury)
"bt" = (
/obj/machinery/vending/uniform_supply,
/turf/open/floor/mainship/mono,
/area/shuttle/canterbury)
"bu" = (
/obj/machinery/marine_selector/gear/engi,
/turf/open/floor/mainship/red/full,
/area/shuttle/canterbury)
"bv" = (
/obj/machinery/computer/cryopod,
/turf/open/floor/mainship/mono,
/area/shuttle/canterbury)
"bw" = (
/obj/machinery/air_alarm,
/obj/machinery/chem_dispenser,
/obj/item/reagent_containers/dropper,
/turf/open/floor/mainship/sterile,
/area/shuttle/canterbury/medical)
"by" = (
/obj/machinery/robotic_cradle,
/turf/open/floor/mainship/sterile,
/area/shuttle/canterbury/medical)
"bz" = (
/obj/structure/table/reinforced,
/obj/machinery/vending/nanomed/nopower,
/obj/item/storage/box/bodybags,
/obj/item/storage/firstaid/o2{
	pixel_x = 4;
	pixel_y = 6
	},
/obj/item/storage/firstaid/fire,
/obj/item/storage/firstaid/adv,
/obj/machinery/recharger,
/obj/item/reagent_containers/spray/cleaner,
/obj/item/defibrillator,
/obj/item/bodybag/cryobag,
/obj/item/reagent_containers/glass/beaker/cryomix{
	name = "cryo beaker"
	},
/turf/open/floor/mainship/sterile,
/area/shuttle/canterbury/medical)
"bA" = (
/obj/machinery/atmospherics/components/unary/cryo_cell,
/turf/open/floor/mainship/sterile,
/area/shuttle/canterbury/medical)
"bB" = (
/obj/machinery/marine_selector/clothes/engi,
/turf/open/floor/mainship/red/full,
/area/shuttle/canterbury)
"bC" = (
/turf/open/floor/mainship/orange/full,
/area/shuttle/canterbury)
"bD" = (
/obj/effect/landmark/start/job/crash/squadsmartgunner,
/obj/structure/window/reinforced/toughened{
	dir = 1
	},
/obj/structure/window/reinforced{
	dir = 8
	},
/turf/open/floor/mainship/red,
/area/shuttle/canterbury)
"bE" = (
/obj/machinery/door/window{
	dir = 1
	},
/obj/structure/window/reinforced/toughened{
	dir = 8
	},
/obj/effect/landmark/start/job/crash/squadcorpsman,
/turf/open/floor/mainship/red,
/area/shuttle/canterbury)
"bF" = (
/obj/machinery/marine_selector/clothes/smartgun,
/obj/structure/window/reinforced{
	dir = 8
	},
/turf/open/floor/mainship/red/full,
/area/shuttle/canterbury)
"bG" = (
/obj/machinery/autodoc/crash,
/turf/open/floor/mainship/sterile,
/area/shuttle/canterbury/medical)
"bH" = (
/obj/machinery/computer/autodoc_console,
/turf/open/floor/mainship/sterile,
/area/shuttle/canterbury/medical)
"bI" = (
/turf/open/floor/mainship/sterile,
/area/shuttle/canterbury/medical)
"bJ" = (
/obj/machinery/vending/armor_supply,
/turf/open/floor/mainship,
/area/shuttle/canterbury)
"bK" = (
/obj/structure/window/framed/mainship/white/canterbury,
/turf/open/floor/plating,
/area/shuttle/canterbury/medical)
"bO" = (
/obj/structure/cable,
/turf/open/floor/plating/plating_catwalk,
/area/shuttle/canterbury)
"bQ" = (
/obj/machinery/vending/uniform_supply,
/turf/open/floor/mainship/red/full,
/area/shuttle/canterbury)
"bR" = (
/obj/machinery/bioprinter/stocked,
/turf/open/floor/mainship/sterile/dark,
/area/shuttle/canterbury/medical)
"bT" = (
/obj/structure/cable,
/turf/open/floor/mainship/sterile,
/area/shuttle/canterbury/medical)
"bU" = (
/obj/effect/landmark/start/job/crash/medicalofficer,
/obj/structure/cable,
/turf/open/floor/mainship/sterile,
/area/shuttle/canterbury/medical)
"bV" = (
/obj/structure/bed/chair/dropship/passenger{
	dir = 4
	},
/obj/effect/landmark/start/job/crash/squadmarine,
/turf/open/floor/mainship/mono,
/area/shuttle/canterbury)
"bW" = (
/obj/structure/bed/chair/dropship/passenger{
	dir = 8
	},
/obj/effect/landmark/start/job/crash/squadmarine,
/turf/open/floor/mainship/mono,
/area/shuttle/canterbury)
"bZ" = (
/obj/machinery/optable,
/obj/item/tank/anesthetic,
/obj/item/clothing/mask/breath/medical,
/turf/open/floor/mainship/sterile/dark,
/area/shuttle/canterbury/medical)
"ca" = (
/obj/effect/landmark/start/job/crash/cmo,
/turf/open/floor/mainship/sterile/dark,
/area/shuttle/canterbury/medical)
"cb" = (
/obj/machinery/vending/MarineMed,
/turf/open/floor/mainship/sterile/dark,
/area/shuttle/canterbury/medical)
"cc" = (
/obj/effect/landmark/start/job/crash/squadsmartgunner,
/obj/structure/window/reinforced/toughened{
	dir = 1
	},
/obj/machinery/door/window/right,
/turf/open/floor/mainship/red,
/area/shuttle/canterbury)
"cd" = (
/obj/machinery/vending/medical,
/turf/open/floor/mainship/sterile/dark,
/area/shuttle/canterbury/medical)
"ce" = (
/obj/structure/table/reinforced,
/obj/item/storage/surgical_tray,
/obj/item/storage/firstaid/adv,
/obj/structure/sink{
	dir = 1
	},
/obj/machinery/light,
/turf/open/floor/mainship/sterile/dark,
/area/shuttle/canterbury/medical)
"cg" = (
/obj/machinery/vending/MarineMed/Blood,
/obj/machinery/firealarm{
	dir = 1
	},
/turf/open/floor/mainship/sterile/dark,
/area/shuttle/canterbury/medical)
"cl" = (
/obj/structure/shuttle/engine/propulsion/burst/left,
/turf/open/floor/podhatch/floor,
/area/shuttle/canterbury)
"cm" = (
/obj/structure/shuttle/engine/propulsion,
/turf/open/floor/podhatch/floor,
/area/shuttle/canterbury)
"cn" = (
/obj/structure/shuttle/engine/propulsion/burst/right,
/turf/open/floor/podhatch/floor,
/area/shuttle/canterbury)
"co" = (
/obj/machinery/door/poddoor/mainship{
	dir = 1;
	id = "aft_engine_podlock"
	},
/obj/machinery/door/poddoor/shutters/transit{
	dir = 2
	},
/turf/open/floor/plating,
/area/shuttle/canterbury)
"cs" = (
/obj/structure/table/reinforced,
/obj/machinery/power/apc{
	dir = 4
	},
/obj/structure/cable,
/obj/machinery/reagentgrinder,
/obj/item/reagent_containers/glass/beaker/large,
/obj/item/stack/sheet/mineral/phoron,
/obj/item/stack/sheet/mineral/phoron,
/turf/open/floor/mainship/sterile,
/area/shuttle/canterbury/medical)
"cv" = (
/obj/structure/cable,
/turf/open/floor/mainship/orange/full,
/area/shuttle/canterbury)
"cw" = (
/obj/machinery/marine_selector/gear/medic,
/turf/open/floor/mainship/red/full,
/area/shuttle/canterbury)
"cy" = (
/obj/machinery/door/window{
	dir = 2
	},
/obj/structure/window/reinforced/toughened{
	dir = 8
	},
/obj/effect/landmark/start/job/crash/squadengineer,
/turf/open/floor/mainship/red{
	dir = 1
	},
/area/shuttle/canterbury)
"cz" = (
/obj/effect/landmark/start/job/crash/squadmarine,
/turf/open/floor/mainship/red{
	dir = 4
	},
/area/shuttle/canterbury)
"cA" = (
/obj/machinery/marine_selector/clothes/medic,
/turf/open/floor/mainship/red/full,
/area/shuttle/canterbury)
"cE" = (
/obj/machinery/marine_selector/gear/smartgun,
/turf/open/floor/mainship/red/full,
/area/shuttle/canterbury)
"cF" = (
/obj/structure/bed/chair/dropship/passenger,
/obj/effect/landmark/start/job/crash/squadcorpsman,
/turf/open/floor/mainship/mono,
/area/shuttle/canterbury)
"cH" = (
/obj/machinery/vending/marineFood,
/turf/open/floor/mainship/mono,
/area/shuttle/canterbury)
"cI" = (
/turf/closed/wall/mainship/white/canterbury,
/area/shuttle/canterbury/medical)
"cJ" = (
/turf/open/floor/mainship/sterile/dark,
/area/shuttle/canterbury/medical)
"cK" = (
/obj/machinery/marine_selector/clothes,
/turf/open/floor/mainship/red/full,
/area/shuttle/canterbury)
"cN" = (
/obj/machinery/vending/nanomed,
/turf/open/floor/mainship/mono,
/area/shuttle/canterbury)
"cO" = (
/obj/effect/landmark/start/job/crash/squadengineer,
/obj/structure/window/reinforced/toughened,
/obj/machinery/light{
	dir = 4
	},
/turf/open/floor/mainship/red{
	dir = 1
	},
/area/shuttle/canterbury)
"cP" = (
/obj/structure/bed/chair/dropship/passenger,
/obj/effect/landmark/start/job/crash/squadengineer,
/turf/open/floor/mainship/mono,
/area/shuttle/canterbury)
"cQ" = (
/obj/structure/bed/chair/dropship/passenger,
/obj/effect/landmark/start/job/crash/squadsmartgunner,
/turf/open/floor/mainship/mono,
/area/shuttle/canterbury)
"cR" = (
/obj/structure/bed/chair/dropship/passenger{
	dir = 1
	},
/obj/effect/landmark/start/job/crash/squadcorpsman,
/turf/open/floor/mainship/mono,
/area/shuttle/canterbury)
"cS" = (
/obj/structure/bed/chair/dropship/passenger{
	dir = 1
	},
/obj/effect/landmark/start/job/crash/squadengineer,
/turf/open/floor/mainship/mono,
/area/shuttle/canterbury)
"cT" = (
/obj/structure/bed/chair/dropship/passenger{
	dir = 1
	},
/obj/machinery/light/small,
/obj/effect/landmark/start/job/crash/squadspecialist,
/turf/open/floor/mainship/mono,
/area/shuttle/canterbury)
"cU" = (
/obj/structure/bed/chair/dropship/passenger{
	dir = 1
	},
/obj/effect/landmark/start/job/crash/squadspecialist,
/turf/open/floor/mainship/mono,
/area/shuttle/canterbury)
"cV" = (
/obj/structure/bed/chair/dropship/passenger,
/obj/effect/landmark/start/job/crash/medicalofficer,
/turf/open/floor/mainship/mono,
/area/shuttle/canterbury)
"cY" = (
/obj/machinery/light/small{
	dir = 8
	},
/obj/structure/barricade/folding,
/obj/machinery/air_alarm{
	dir = 4
	},
/turf/open/floor/mainship/cargo,
/area/shuttle/canterbury)
"cZ" = (
/obj/structure/barricade/folding,
/turf/open/floor/mainship/mono,
/area/shuttle/canterbury)
"da" = (
/obj/structure/barricade/folding,
/obj/machinery/door_control{
	dir = 8;
	id = "aft_engine_podlock"
	},
/turf/open/floor/mainship/cargo,
/area/shuttle/canterbury)
"db" = (
/obj/effect/landmark/start/job/crash/squadcorpsman,
/obj/structure/window/reinforced/toughened{
	dir = 1
	},
/obj/machinery/light{
	dir = 4
	},
/turf/open/floor/mainship/red,
/area/shuttle/canterbury)
"fI" = (
/obj/machinery/computer/camera_advanced/overwatch/medical,
/obj/structure/window/reinforced/toughened{
	dir = 1
	},
/turf/open/floor/mainship/sterile/dark,
/area/shuttle/canterbury/medical)
"nN" = (
/obj/machinery/vending/snack,
/turf/open/floor/mainship/red/full,
/area/shuttle/canterbury)
"pY" = (
/obj/machinery/door/airlock/mainship/marine/canterbury{
	dir = 8
	},
/turf/open/floor/mainship/mono,
/area/shuttle/canterbury)
"vY" = (
/obj/structure/bed/chair/dropship/passenger{
	dir = 1
	},
/turf/open/floor/mainship/mono,
/area/shuttle/canterbury)
"xB" = (
/obj/machinery/shower{
	dir = 1
	},
/turf/open/floor/mainship/sterile/dark,
/area/shuttle/canterbury/medical)
"zE" = (
/obj/structure/window/framed/mainship/canterbury,
/obj/structure/cable,
/turf/open/floor/mainship/orange/full,
/area/shuttle/canterbury)
"zN" = (
/obj/machinery/vending/engivend,
/obj/machinery/light/small{
	dir = 8;
	status = 0
	},
/turf/open/floor/mainship/orange/full,
/area/shuttle/canterbury)
"Bu" = (
/obj/structure/bed/chair/dropship/passenger{
	dir = 1
	},
/obj/effect/landmark/start/job/crash/squadmarine,
/obj/machinery/light/small,
/turf/open/floor/mainship/mono,
/area/shuttle/canterbury)
"Cq" = (
/obj/machinery/light{
	dir = 4
	},
/obj/machinery/vending/cigarette,
/turf/open/floor/mainship/mono,
/area/shuttle/canterbury)
"Hv" = (
/obj/structure/window/reinforced/toughened{
	dir = 4
	},
/obj/machinery/quick_vendor/beginner,
/turf/open/floor/mainship/cargo,
/area/shuttle/canterbury)
"KE" = (
/obj/effect/landmark/start/job/crash/squadmarine,
/turf/open/floor/mainship/mono,
/area/shuttle/canterbury)
"RS" = (
/obj/structure/window/framed/mainship/canterbury,
/turf/open/floor/mainship/orange/full,
/area/shuttle/canterbury)
"UG" = (
/obj/structure/window/reinforced/toughened{
	dir = 1
	},
/turf/open/floor/mainship/orange/full,
/area/shuttle/canterbury)
"YI" = (
/obj/machinery/iv_drip,
/turf/open/floor/mainship/sterile/dark,
/area/shuttle/canterbury/medical)

(1,1,1) = {"
aa
aa
aa
aa
aa
aa
aa
aa
an
an
an
an
bo
bo
bo
bo
bo
bo
bo
bo
an
"}
(2,1,1) = {"
aa
aa
aa
an
an
aH
aH
aH
an
aP
aZ
bi
bo
bw
cs
bG
fI
bZ
bR
bo
cl
"}
(3,1,1) = {"
aa
aa
aa
an
au
aA
aA
aA
an
aQ
bC
bj
bo
aC
bT
bH
cJ
ca
ce
bo
cm
"}
(4,1,1) = {"
aa
aa
aa
an
av
aB
aJ
Bu
an
RS
bb
zE
bo
by
bT
bI
cJ
YI
xB
bo
cm
"}
(5,1,1) = {"
ab
ac
ac
ab
ab
cV
aJ
vY
aN
zN
cv
aT
bo
bz
bU
bI
cb
cd
cg
bo
cn
"}
(6,1,1) = {"
ac
ad
ai
ap
ab
cF
aJ
cR
UG
bC
bg
bl
bo
bA
bT
bI
bK
bK
cI
bo
an
"}
(7,1,1) = {"
ac
ae
aj
aq
ab
cN
aJ
aD
aD
aD
bO
aD
bV
aD
bO
aD
bV
bV
bV
cY
co
"}
(8,1,1) = {"
ac
af
ak
ar
aw
bO
bO
bO
bO
ao
bO
bO
bO
bO
bO
aJ
aJ
aJ
aJ
cZ
co
"}
(9,1,1) = {"
ac
ag
aj
as
ab
aL
aJ
aD
aD
aD
aD
aJ
aD
aD
aD
aJ
KE
bW
bW
da
co
"}
(10,1,1) = {"
ac
ah
am
at
ab
cP
aJ
cS
aO
Hv
bd
aJ
bJ
Cq
cH
aJ
nN
bD
bF
an
an
"}
(11,1,1) = {"
ab
ac
ac
ab
ab
cQ
aJ
cT
an
aV
aD
aJ
bt
br
br
aJ
be
cc
cE
an
cl
"}
(12,1,1) = {"
aa
aa
aa
an
ax
cQ
aJ
cU
an
aW
bk
pY
aR
an
cK
aJ
aJ
aJ
cK
an
cm
"}
(13,1,1) = {"
aa
aa
aa
an
ay
aF
aF
aF
an
bp
bq
bq
aD
an
bu
cy
cz
bE
cw
an
cm
"}
(14,1,1) = {"
aa
aa
aa
an
an
aK
aK
aK
an
bn
bn
bn
bv
an
bB
cO
bQ
db
cA
an
cn
"}
(15,1,1) = {"
aa
aa
aa
aa
aa
aa
aa
aa
an
an
an
an
an
an
an
an
an
an
an
an
an
"}
