//MAP CONVERTED BY dmm2tgm.py THIS HEADER COMMENT PREVENTS RECONVERSION, DO NOT REMOVE
"aa" = (
/obj/structure/dropship_piece/one/front/left,
/turf/template_noop,
/area/shuttle/dropship/triumph)
"ab" = (
/obj/structure/dropship_piece/one/front,
/turf/template_noop,
/area/shuttle/dropship/triumph)
"ac" = (
/obj/machinery/door/poddoor/shutters/transit{
	dir = 8
	},
/obj/machinery/door/airlock/dropship_hatch/left,
/turf/open/shuttle/dropship/floor,
/area/shuttle/dropship/triumph)
"ad" = (
/obj/structure/dropship_piece/one/front/right,
/turf/template_noop,
/area/shuttle/dropship/triumph)
"ae" = (
/obj/structure/dropship_piece/one/cockpit/left,
/turf/template_noop,
/area/shuttle/dropship/triumph)
"af" = (
/turf/closed/shuttle/dropship1/window,
/area/shuttle/dropship/triumph)
"ag" = (
/turf/closed/shuttle/dropship1/window{
	dir = 4
	},
/area/shuttle/dropship/triumph)
"ah" = (
/turf/closed/shuttle/dropship1/window{
	dir = 8
	},
/area/shuttle/dropship/triumph)
"ai" = (
/obj/structure/dropship_piece/one/cockpit/right,
/turf/template_noop,
/area/shuttle/dropship/triumph)
"aj" = (
/turf/closed/shuttle/dropship1/cornersalt{
	dir = 4
	},
/area/shuttle/dropship/triumph)
"ak" = (
/obj/machinery/computer/security/dropship/three,
/turf/closed/shuttle/dropship1/panel,
/area/shuttle/dropship/triumph)
"al" = (
/turf/open/shuttle/dropship/floor,
/area/shuttle/dropship/triumph)
"am" = (
/obj/machinery/computer/dropship_weapons/dropship3,
/turf/closed/shuttle/dropship1/panel{
	dir = 4
	},
/area/shuttle/dropship/triumph)
"an" = (
/turf/closed/shuttle/dropship1/cornersalt{
	dir = 8
	},
/area/shuttle/dropship/triumph)
"ao" = (
/turf/template_noop,
/area/template_noop)
"ap" = (
/obj/effect/attach_point/weapon/dropship3{
	dir = 1
	},
/obj/structure/dropship_piece/one/weapon/leftleft,
/turf/template_noop,
/area/shuttle/dropship/triumph)
"aq" = (
/obj/effect/attach_point/electronics/dropship3{
	dir = 1
	},
/obj/structure/dropship_piece/one/weapon/leftright,
/turf/template_noop,
/area/shuttle/dropship/triumph)
"ar" = (
/turf/closed/shuttle/dropship1/interiorwindow{
	dir = 4
	},
/area/shuttle/dropship/triumph)
"as" = (
/obj/structure/bed/chair/dropship/pilot{
	dir = 1
	},
/obj/machinery/light,
/turf/open/shuttle/dropship/floor,
/area/shuttle/dropship/triumph)
"at" = (
/obj/item/radio/intercom/dropship/triumph{
	pixel_x = 21;
	pixel_y = 16
	},
/turf/open/shuttle/dropship/floor,
/area/shuttle/dropship/triumph)
"au" = (
/obj/structure/bed/chair/dropship/pilot{
	dir = 1
	},
/obj/machinery/camera/autoname/mainship/dropship_three{
	pixel_x = -6;
	pixel_y = -16
	},
/turf/open/shuttle/dropship/floor,
/area/shuttle/dropship/triumph)
"av" = (
/turf/closed/shuttle/dropship1/interiorwindow{
	dir = 1
	},
/area/shuttle/dropship/triumph)
"aw" = (
/obj/effect/attach_point/electronics/dropship3{
	dir = 1
	},
/obj/structure/dropship_piece/one/weapon/rightleft,
/turf/template_noop,
/area/shuttle/dropship/triumph)
"ax" = (
/obj/effect/attach_point/weapon/dropship3{
	dir = 1
	},
/obj/structure/dropship_piece/one/weapon/rightright,
/turf/template_noop,
/area/shuttle/dropship/triumph)
"ay" = (
/turf/closed/shuttle/dropship1/cornersalt2,
/area/shuttle/dropship/triumph)
"aB" = (
/turf/closed/shuttle/dropship1/interiormisc{
	dir = 4
	},
/area/shuttle/dropship/triumph)
"aC" = (
/obj/machinery/door/airlock/hatch/cockpit/rebel,
/turf/open/shuttle/dropship/floor,
/area/shuttle/dropship/triumph)
"aD" = (
/turf/closed/shuttle/dropship1/interiormisc{
	dir = 8
	},
/area/shuttle/dropship/triumph)
"aE" = (
/turf/closed/shuttle/dropship1/edge,
/area/shuttle/dropship/triumph)
"aF" = (
/turf/closed/shuttle/dropship1/cornersalt2{
	dir = 1
	},
/area/shuttle/dropship/triumph)
"aG" = (
/obj/structure/dropship_piece/one/wing/left/top,
/turf/template_noop,
/area/shuttle/dropship/triumph)
"aH" = (
/turf/closed/shuttle/dropship1/finleft{
	dir = 4
	},
/area/shuttle/dropship/triumph)
"aI" = (
/obj/structure/bed/chair/dropship/passenger{
	dir = 4
	},
/turf/open/shuttle/dropship/floor,
/area/shuttle/dropship/triumph)
"aJ" = (
/obj/item/radio/intercom/dropship/triumph,
/turf/open/shuttle/dropship/six,
/area/shuttle/dropship/triumph)
"aK" = (
/turf/open/shuttle/dropship/five,
/area/shuttle/dropship/triumph)
"aM" = (
/obj/item/radio/intercom/dropship/triumph,
/turf/open/shuttle/dropship/seven,
/area/shuttle/dropship/triumph)
"aN" = (
/obj/structure/bed/chair/dropship/passenger{
	dir = 8
	},
/turf/open/shuttle/dropship/floor,
/area/shuttle/dropship/triumph)
"aO" = (
/turf/closed/shuttle/dropship1/finright{
	dir = 4
	},
/area/shuttle/dropship/triumph)
"aP" = (
/obj/structure/dropship_piece/one/wing/right/top,
/turf/template_noop,
/area/shuttle/dropship/triumph)
"aQ" = (
/turf/closed/shuttle/dropship1/finleft{
	dir = 8
	},
/area/shuttle/dropship/triumph)
"aR" = (
/turf/closed/shuttle/dropship1/finleft{
	dir = 1
	},
/area/shuttle/dropship/triumph)
"aS" = (
/turf/open/shuttle/dropship/three,
/area/shuttle/dropship/triumph)
"aT" = (
/turf/closed/shuttle/dropship1/aisle,
/area/shuttle/dropship/triumph)
"aU" = (
/obj/structure/bed/chair/dropship/passenger{
	dir = 8
	},
/obj/machinery/camera/autoname/mainship/dropship_three{
	dir = 8;
	pixel_x = 16
	},
/turf/open/shuttle/dropship/floor,
/area/shuttle/dropship/triumph)
"aV" = (
/turf/closed/shuttle/dropship1/finright{
	dir = 1
	},
/area/shuttle/dropship/triumph)
"aW" = (
/turf/closed/shuttle/dropship1/finright{
	dir = 8
	},
/area/shuttle/dropship/triumph)
"aX" = (
/obj/effect/attach_point/weapon/dropship1{
	dir = 8;
	},
/obj/structure/dropship_piece/one/wing/left/bottom,
/turf/template_noop,
/area/shuttle/dropship/triumph)
"aY" = (
/turf/closed/shuttle/dropship1/finleft,
/area/shuttle/dropship/triumph)
"aZ" = (
/turf/closed/shuttle/dropship1/aisle{
	dir = 4
	},
/area/shuttle/dropship/triumph)
"ba" = (
/turf/closed/shuttle/dropship1/finright,
/area/shuttle/dropship/triumph)
"bb" = (
/obj/effect/attach_point/weapon/dropship1{
	dir = 4;
	},
/obj/structure/dropship_piece/one/wing/right/bottom,
/turf/template_noop,
/area/shuttle/dropship/triumph)
"bc" = (
/obj/machinery/door/poddoor/shutters/transit,
/obj/machinery/door/airlock/dropship_hatch/right,
/turf/open/shuttle/dropship/floor,
/area/shuttle/dropship/triumph)
"bd" = (
/obj/structure/bed/chair/dropship/passenger{
	dir = 8
	},
/obj/machinery/light{
	dir = 4
	},
/turf/open/shuttle/dropship/floor,
/area/shuttle/dropship/triumph)
"be" = (
/obj/structure/bed/chair/dropship/passenger{
	dir = 4
	},
/obj/machinery/light{
	dir = 8
	},
/turf/open/shuttle/dropship/floor,
/area/shuttle/dropship/triumph)
"bg" = (
/obj/docking_port/mobile/marine_dropship/three,
/turf/closed/shuttle/dropship1/aisle{
	dir = 8
	},
/area/shuttle/dropship/triumph)
"bh" = (
/turf/closed/shuttle/dropship1/edge/alt,
/area/shuttle/dropship/triumph)
"bi" = (
/turf/closed/shuttle/dropship1/edge/alt{
	dir = 8
	},
/area/shuttle/dropship/triumph)
"bj" = (
/turf/open/shuttle/dropship/four,
/area/shuttle/dropship/triumph)
"bk" = (
/obj/item/radio/intercom/dropship/triumph,
/turf/open/shuttle/dropship/five,
/area/shuttle/dropship/triumph)
"bl" = (
/turf/open/shuttle/dropship/eight,
/area/shuttle/dropship/triumph)
"bn" = (
/obj/structure/dropship_piece/one/corner/middleleft,
/turf/template_noop,
/area/shuttle/dropship/triumph)
"bo" = (
/turf/closed/shuttle/dropship1/cornersalt,
/area/shuttle/dropship/triumph)
"bp" = (
/obj/structure/bed/chair/dropship/passenger,
/turf/open/shuttle/dropship/floor,
/area/shuttle/dropship/triumph)
"bq" = (
/turf/closed/shuttle/dropship1/cornersalt{
	dir = 1
	},
/area/shuttle/dropship/triumph)
"br" = (
/obj/structure/dropship_piece/one/corner/middleright,
/turf/template_noop,
/area/shuttle/dropship/triumph)
"bs" = (
/obj/structure/dropship_piece/one/engine/lefttop,
/turf/template_noop,
/area/shuttle/dropship/triumph)
"bt" = (
/obj/structure/dropship_piece/one/engine/righttop,
/turf/template_noop,
/area/shuttle/dropship/triumph)
"bu" = (
/turf/closed/shuttle/dropship1/edge/alt{
	dir = 1
	},
/area/shuttle/dropship/triumph)
"bv" = (
/obj/structure/bed/chair/dropship/passenger{
	dir = 4
	},
/obj/machinery/vending/nanomed{
	dir = 4
	},
/turf/open/shuttle/dropship/floor,
/area/shuttle/dropship/triumph)
"bw" = (
/obj/effect/attach_point/crew_weapon/dropship3,
/turf/open/shuttle/dropship/floor,
/area/shuttle/dropship/triumph)
"bx" = (
/obj/structure/bed/chair/dropship/passenger{
	dir = 8
	},
/obj/machinery/vending/nanomed{
	dir = 8
	},
/turf/open/shuttle/dropship/floor,
/area/shuttle/dropship/triumph)
"by" = (
/turf/closed/shuttle/dropship1/edge/alt{
	dir = 4
	},
/area/shuttle/dropship/triumph)
"bB" = (
/turf/closed/shuttle/dropship1/enginefour,
/area/shuttle/dropship/triumph)
"bC" = (
/turf/closed/shuttle/dropship1/enginefour{
	dir = 1
	},
/area/shuttle/dropship/triumph)
"bD" = (
/obj/structure/bed/chair/dropship/passenger{
	dir = 4
	},
/obj/machinery/camera/autoname/mainship/dropship_three{
	dir = 4;
	pixel_x = -16
	},
/turf/open/shuttle/dropship/floor,
/area/shuttle/dropship/triumph)
"bE" = (
/turf/closed/shuttle/dropship1/enginefour{
	dir = 4
	},
/area/shuttle/dropship/triumph)
"bF" = (
/turf/closed/shuttle/dropship1/enginefour{
	dir = 8
	},
/area/shuttle/dropship/triumph)
"bG" = (
/obj/effect/attach_point/fuel/dropship3,
/turf/closed/shuttle/dropship1/enginethree,
/area/shuttle/dropship/triumph)
"bH" = (
/turf/closed/shuttle/dropship1/enginethree{
	dir = 1
	},
/area/shuttle/dropship/triumph)
"bI" = (
/turf/closed/shuttle/dropship1/wall{
	dir = 4
	},
/area/shuttle/dropship/triumph)
"bJ" = (
/turf/closed/shuttle/dropship1/wall{
	dir = 8
	},
/area/shuttle/dropship/triumph)
"bK" = (
/turf/closed/shuttle/dropship1/enginethree{
	dir = 8
	},
/area/shuttle/dropship/triumph)
"bL" = (
/obj/effect/attach_point/fuel/dropship3{
	pixel_x = -32
	},
/turf/closed/shuttle/dropship1/enginethree{
	dir = 4
	},
/area/shuttle/dropship/triumph)
"bM" = (
/turf/closed/shuttle/dropship1/enginetwo,
/area/shuttle/dropship/triumph)
"bN" = (
/turf/closed/shuttle/dropship1/enginetwo{
	dir = 1
	},
/area/shuttle/dropship/triumph)
"bO" = (
/turf/closed/shuttle/dropship1/wall,
/area/shuttle/dropship/triumph)
"bP" = (
/turf/closed/shuttle/dropship1/wall{
	dir = 1
	},
/area/shuttle/dropship/triumph)
"bQ" = (
/turf/closed/shuttle/dropship1/enginetwo{
	dir = 4
	},
/area/shuttle/dropship/triumph)
"bR" = (
/turf/closed/shuttle/dropship1/enginetwo{
	dir = 8
	},
/area/shuttle/dropship/triumph)
"bS" = (
/obj/structure/dropship_piece/one/engine/leftbottom,
/turf/template_noop,
/area/shuttle/dropship/triumph)
"bT" = (
/obj/structure/dropship_piece/one/engine/rightbottom,
/turf/template_noop,
/area/shuttle/dropship/triumph)
"bW" = (
/obj/structure/dropship_piece/one/corner/rearleft,
/turf/template_noop,
/area/shuttle/dropship/triumph)
"bX" = (
/turf/closed/shuttle/dropship1/interiormisc,
/area/shuttle/dropship/triumph)
"bY" = (
/obj/machinery/door/airlock/multi_tile/mainship/dropshiprear/ds1,
/obj/machinery/door/poddoor/shutters/transit{
	dir = 1
	},
/turf/open/shuttle/dropship/floor,
/area/shuttle/dropship/triumph)
"bZ" = (
/obj/machinery/door/poddoor/shutters/transit{
	dir = 1
	},
/turf/open/shuttle/dropship/floor,
/area/shuttle/dropship/triumph)
"ca" = (
/turf/closed/shuttle/dropship1/interiormisc{
	dir = 1
	},
/area/shuttle/dropship/triumph)
"cb" = (
/obj/structure/dropship_piece/one/corner/rearright,
/turf/template_noop,
/area/shuttle/dropship/triumph)
"cc" = (
/obj/structure/dropship_piece/one/rearwing/lefttop,
/turf/template_noop,
/area/shuttle/dropship/triumph)
"cd" = (
/obj/structure/dropship_piece/one/rearwing/righttop,
/turf/template_noop,
/area/shuttle/dropship/triumph)
"ce" = (
/obj/structure/dropship_piece/one/rearwing/leftllbottom,
/turf/template_noop,
/area/shuttle/dropship/triumph)
"cf" = (
/obj/structure/dropship_piece/one/rearwing/leftlbottom,
/turf/template_noop,
/area/shuttle/dropship/triumph)
"cg" = (
/obj/structure/dropship_piece/one/rearwing/leftbottom,
/turf/template_noop,
/area/shuttle/dropship/triumph)
"ci" = (
/obj/structure/dropship_piece/one/rearwing/rightbottom,
/turf/template_noop,
/area/shuttle/dropship/triumph)
"cj" = (
/obj/structure/dropship_piece/one/rearwing/rightrbottom,
/turf/template_noop,
/area/shuttle/dropship/triumph)
"ck" = (
/obj/structure/dropship_piece/one/rearwing/rightrrbottom,
/turf/template_noop,
/area/shuttle/dropship/triumph)
"Ki" = (
/obj/machinery/computer/shuttle/marine_dropship/three,
/turf/closed/shuttle/dropship1/panel{
	dir = 1
	},
/area/shuttle/dropship/triumph)

(1,1,1) = {"
ao
ao
ao
ao
ao
aG
aQ
aX
ao
ao
ao
ao
ao
bs
bB
bG
bM
bS
ao
ao
ao
"}
(2,1,1) = {"
ao
ao
ao
ap
ay
aH
aR
aY
ac
ac
bu
bi
bn
bt
bC
bH
bN
bT
ao
ao
ce
"}
(3,1,1) = {"
ao
ao
ao
aq
aE
aI
aI
aI
al
al
aI
aI
bo
bu
bu
bI
bO
bu
bW
ao
cf
"}
(4,1,1) = {"
aa
ae
aj
ar
aE
aJ
aS
aS
aS
aS
aS
bj
aI
bv
bD
be
aI
aI
bX
cc
cg
"}
(5,1,1) = {"
ab
af
ak
as
aB
aK
aN
aN
bd
aN
aN
aK
aS
aS
aS
aS
aS
aS
bY
ao
ao
"}
(6,1,1) = {"
ab
ag
Ki
at
aC
aK
aT
aZ
aZ
aZ
bg
bk
bp
bw
al
al
al
al
bZ
ao
ao
"}
(7,1,1) = {"
ab
ah
am
au
aD
aK
aI
aI
be
aI
aI
aK
aS
aS
aS
aS
aS
aS
bZ
ao
ao
"}
(8,1,1) = {"
ad
ai
an
av
aE
aM
aS
aS
aS
aS
aS
bl
aN
bx
aN
bd
aN
aN
ca
cd
ci
"}
(9,1,1) = {"
ao
ao
ao
aw
aE
aN
aU
aN
al
al
aN
aN
bq
by
bh
bJ
bP
by
cb
ao
cj
"}
(10,1,1) = {"
ao
ao
ao
ax
aF
aO
aV
ba
bc
bc
bh
by
br
bs
bE
bK
bQ
bS
ao
ao
ck
"}
(11,1,1) = {"
ao
ao
ao
ao
ao
aP
aW
bb
ao
ao
ao
ao
ao
bt
bF
bL
bR
bT
ao
ao
ao
"}
