//MAP CONVERTED BY dmm2tgm.py THIS HEADER COMMENT PREVENTS RECONVERSION, DO NOT REMOVE
"aa" = (
/obj/structure/dropship_piece/four/front/left,
/turf/template_noop,
/area/shuttle/dropship/victory)
"ab" = (
/obj/structure/dropship_piece/four/front,
/turf/template_noop,
/area/shuttle/dropship/victory)
"ac" = (
/obj/machinery/door/poddoor/shutters/transit{
	dir = 8
	},
/obj/machinery/door/airlock/dropship_hatch/left,
/turf/open/shuttle/dropship/floor,
/area/shuttle/dropship/victory)
"ad" = (
/obj/structure/dropship_piece/four/front/right,
/turf/template_noop,
/area/shuttle/dropship/victory)
"ae" = (
/obj/structure/dropship_piece/four/cockpit/left,
/turf/template_noop,
/area/shuttle/dropship/victory)
"af" = (
/turf/closed/shuttle/dropship4/transparent{
	icon_state = "96"
	},
/area/shuttle/dropship/victory)
"ag" = (
/turf/closed/shuttle/dropship4/transparent{
	icon_state = "97"
	},
/area/shuttle/dropship/victory)
"ah" = (
/turf/closed/shuttle/dropship4/transparent{
	icon_state = "98"
	},
/area/shuttle/dropship/victory)
"ai" = (
/obj/structure/dropship_piece/four/cockpit/right,
/turf/template_noop,
/area/shuttle/dropship/victory)
"aj" = (
/turf/closed/shuttle/dropship4{
	icon_state = "92"
	},
/area/shuttle/dropship/victory)
"ak" = (
/obj/machinery/computer/security/dropship/one,
/turf/open/shuttle/dropship/floor,
/area/shuttle/dropship/victory)
"al" = (
/turf/open/shuttle/dropship/floor,
/area/shuttle/dropship/victory)
"am" = (
/obj/machinery/computer/dropship_weapons/dropship1,
/turf/open/shuttle/dropship/floor,
/area/shuttle/dropship/victory)
"an" = (
/turf/closed/shuttle/dropship4{
	icon_state = "94"
	},
/area/shuttle/dropship/victory)
"ao" = (
/turf/template_noop,
/area/template_noop)
"ap" = (
/obj/effect/attach_point/weapon/dropship1{
	dir = 1
	},
/obj/structure/dropship_piece/four/weapon/leftleft,
/turf/template_noop,
/area/shuttle/dropship/victory)
"aq" = (
/obj/effect/attach_point/electronics/dropship1{
	dir = 1
	},
/obj/structure/dropship_piece/four/weapon/leftright,
/turf/template_noop,
/area/shuttle/dropship/victory)
"ar" = (
/turf/closed/shuttle/dropship4/transparent{
	icon_state = "86"
	},
/area/shuttle/dropship/victory)
"as" = (
/obj/structure/bed/chair/dropship/pilot{
	dir = 1
	},
/obj/machinery/light,
/turf/open/shuttle/dropship/floor,
/area/shuttle/dropship/victory)
"at" = (
/obj/item/radio/intercom/dropship{
	pixel_x = 21;
	pixel_y = 16
	},
/turf/open/shuttle/dropship/floor,
/area/shuttle/dropship/victory)
"au" = (
/obj/structure/bed/chair/dropship/pilot{
	dir = 1
	},
/obj/machinery/camera/autoname/mainship/dropship_one{
	pixel_x = -6;
	pixel_y = -16
	},
/turf/open/shuttle/dropship/floor,
/area/shuttle/dropship/victory)
"av" = (
/turf/closed/shuttle/dropship4/transparent{
	icon_state = "89"
	},
/area/shuttle/dropship/victory)
"aw" = (
/obj/effect/attach_point/electronics/dropship1{
	dir = 1
	},
/obj/structure/dropship_piece/four/weapon/rightleft,
/turf/template_noop,
/area/shuttle/dropship/victory)
"ax" = (
/obj/effect/attach_point/weapon/dropship1{
	dir = 1
	},
/obj/structure/dropship_piece/four/weapon/rightright,
/turf/template_noop,
/area/shuttle/dropship/victory)
"ay" = (
/turf/closed/shuttle/dropship4{
	icon_state = "75"
	},
/area/shuttle/dropship/victory)
"az" = (
/turf/closed/shuttle/dropship4{
	icon_state = "76"
	},
/area/shuttle/dropship/victory)
"aA" = (
/turf/closed/shuttle/dropship4{
	icon_state = "81"
	},
/area/shuttle/dropship/victory)
"aB" = (
/turf/closed/shuttle/dropship4{
	icon_state = "78"
	},
/area/shuttle/dropship/victory)
"aC" = (
/obj/machinery/door/airlock/hatch/cockpit,
/turf/open/shuttle/dropship/floor,
/area/shuttle/dropship/victory)
"aD" = (
/turf/closed/shuttle/dropship4{
	icon_state = "80"
	},
/area/shuttle/dropship/victory)
"aE" = (
/turf/closed/shuttle/dropship4{
	icon_state = "77"
	},
/area/shuttle/dropship/victory)
"aF" = (
/turf/closed/shuttle/dropship4{
	icon_state = "83"
	},
/area/shuttle/dropship/victory)
"aG" = (
/obj/structure/dropship_piece/four/wing/left/top,
/turf/template_noop,
/area/shuttle/dropship/victory)
"aH" = (
/turf/closed/shuttle/dropship4{
	icon_state = "72"
	},
/area/shuttle/dropship/victory)
"aI" = (
/obj/structure/bed/chair/dropship/passenger{
	dir = 4
	},
/turf/open/shuttle/dropship/floor,
/area/shuttle/dropship/victory)
"aJ" = (
/obj/item/radio/intercom/dropship,
/turf/open/shuttle/dropship{
	icon_state = "rasputin6"
	},
/area/shuttle/dropship/victory)
"aK" = (
/turf/open/shuttle/dropship/five,
/area/shuttle/dropship/victory)
"aL" = (
/turf/open/shuttle/dropship{
	icon_state = "floor8"
	},
/area/shuttle/dropship/victory)
"aM" = (
/obj/item/radio/intercom/dropship,
/turf/open/shuttle/dropship/seven,
/area/shuttle/dropship/victory)
"aN" = (
/obj/structure/bed/chair/dropship/passenger{
	dir = 8
	},
/turf/open/shuttle/dropship/floor,
/area/shuttle/dropship/victory)
"aO" = (
/turf/closed/shuttle/dropship4{
	icon_state = "73"
	},
/area/shuttle/dropship/victory)
"aP" = (
/obj/structure/dropship_piece/four/wing/right/top,
/turf/template_noop,
/area/shuttle/dropship/victory)
"aQ" = (
/turf/closed/shuttle/dropship4/transparent{
	icon_state = "66"
	},
/area/shuttle/dropship/victory)
"aR" = (
/turf/closed/shuttle/dropship4{
	icon_state = "67"
	},
/area/shuttle/dropship/victory)
"aS" = (
/turf/open/shuttle/dropship/three,
/area/shuttle/dropship/victory)
"aT" = (
/turf/closed/shuttle/dropship4{
	icon_state = "68"
	},
/area/shuttle/dropship/victory)
"aU" = (
/obj/structure/bed/chair/dropship/passenger{
	dir = 8
	},
/obj/machinery/camera/autoname/mainship/dropship_one{
	dir = 8;
	pixel_x = 16
	},
/turf/open/shuttle/dropship/floor,
/area/shuttle/dropship/victory)
"aV" = (
/turf/closed/shuttle/dropship4{
	icon_state = "69"
	},
/area/shuttle/dropship/victory)
"aW" = (
/turf/closed/shuttle/dropship4/transparent{
	icon_state = "70"
	},
/area/shuttle/dropship/victory)
"aX" = (
/obj/effect/attach_point/weapon/dropship1{
	dir = 8;
	icon_state = "equip_base_l_wing"
	},
/obj/structure/dropship_piece/four/wing/left/bottom,
/turf/template_noop,
/area/shuttle/dropship/victory)
"aY" = (
/turf/closed/shuttle/dropship4{
	icon_state = "62"
	},
/area/shuttle/dropship/victory)
"aZ" = (
/turf/closed/shuttle/dropship4{
	icon_state = "63"
	},
/area/shuttle/dropship/victory)
"ba" = (
/turf/closed/shuttle/dropship4{
	icon_state = "64"
	},
/area/shuttle/dropship/victory)
"bb" = (
/obj/effect/attach_point/weapon/dropship1{
	dir = 4;
	icon_state = "equip_base_r_wing"
	},
/obj/structure/dropship_piece/four/wing/right/bottom,
/turf/template_noop,
/area/shuttle/dropship/victory)
"bc" = (
/obj/machinery/door/poddoor/shutters/transit,
/obj/machinery/door/airlock/dropship_hatch/right,
/turf/open/shuttle/dropship/floor,
/area/shuttle/dropship/victory)
"bd" = (
/obj/structure/bed/chair/dropship/passenger{
	dir = 8
	},
/obj/machinery/light{
	dir = 4
	},
/turf/open/shuttle/dropship/floor,
/area/shuttle/dropship/victory)
"be" = (
/obj/structure/bed/chair/dropship/passenger{
	dir = 4
	},
/obj/machinery/light{
	dir = 8
	},
/turf/open/shuttle/dropship/floor,
/area/shuttle/dropship/victory)
"bf" = (
/turf/closed/shuttle/dropship4{
	icon_state = "52"
	},
/area/shuttle/dropship/victory)
"bg" = (
/obj/docking_port/mobile/marine_dropship/one,
/turf/closed/shuttle/dropship4{
	icon_state = "53"
	},
/area/shuttle/dropship/victory)
"bh" = (
/turf/closed/shuttle/dropship4{
	icon_state = "54"
	},
/area/shuttle/dropship/victory)
"bi" = (
/turf/closed/shuttle/dropship4{
	icon_state = "50"
	},
/area/shuttle/dropship/victory)
"bj" = (
/turf/open/shuttle/dropship{
	icon_state = "rasputin4"
	},
/area/shuttle/dropship/victory)
"bk" = (
/obj/item/radio/intercom/dropship,
/turf/open/shuttle/dropship/five,
/area/shuttle/dropship/victory)
"bl" = (
/turf/open/shuttle/dropship/eight,
/area/shuttle/dropship/victory)
"bm" = (
/turf/closed/shuttle/dropship4{
	icon_state = "51"
	},
/area/shuttle/dropship/victory)
"bn" = (
/obj/structure/dropship_piece/four/corner/middleleft,
/turf/template_noop,
/area/shuttle/dropship/victory)
"bo" = (
/turf/closed/shuttle/dropship4{
	icon_state = "47"
	},
/area/shuttle/dropship/victory)
"bp" = (
/obj/structure/bed/chair/dropship/passenger,
/turf/open/shuttle/dropship/floor,
/area/shuttle/dropship/victory)
"bq" = (
/turf/closed/shuttle/dropship4{
	icon_state = "48"
	},
/area/shuttle/dropship/victory)
"br" = (
/obj/structure/dropship_piece/four/corner/middleright,
/turf/template_noop,
/area/shuttle/dropship/victory)
"bs" = (
/obj/structure/dropship_piece/four/engine/lefttop,
/turf/template_noop,
/area/shuttle/dropship/victory)
"bt" = (
/obj/structure/dropship_piece/four/engine/righttop,
/turf/template_noop,
/area/shuttle/dropship/victory)
"bu" = (
/turf/closed/shuttle/dropship4{
	icon_state = "42"
	},
/area/shuttle/dropship/victory)
"bv" = (
/obj/structure/bed/chair/dropship/passenger{
	dir = 4
	},
/obj/machinery/vending/nanomed{
	dir = 4
	},
/turf/open/shuttle/dropship/floor,
/area/shuttle/dropship/victory)
"bw" = (
/obj/effect/attach_point/crew_weapon/dropship1,
/turf/open/shuttle/dropship/floor,
/area/shuttle/dropship/victory)
"bx" = (
/obj/structure/bed/chair/dropship/passenger{
	dir = 8
	},
/obj/machinery/vending/nanomed{
	dir = 8
	},
/turf/open/shuttle/dropship/floor,
/area/shuttle/dropship/victory)
"by" = (
/turf/closed/shuttle/dropship4{
	icon_state = "43"
	},
/area/shuttle/dropship/victory)
"bB" = (
/turf/closed/shuttle/dropship4/transparent{
	icon_state = "34"
	},
/area/shuttle/dropship/victory)
"bC" = (
/turf/closed/shuttle/dropship4/transparent{
	icon_state = "35"
	},
/area/shuttle/dropship/victory)
"bD" = (
/obj/structure/bed/chair/dropship/passenger{
	dir = 4
	},
/obj/machinery/camera/autoname/mainship/dropship_one{
	dir = 4;
	pixel_x = -16
	},
/turf/open/shuttle/dropship/floor,
/area/shuttle/dropship/victory)
"bE" = (
/turf/closed/shuttle/dropship4/transparent{
	icon_state = "38"
	},
/area/shuttle/dropship/victory)
"bF" = (
/turf/closed/shuttle/dropship4/transparent{
	icon_state = "39"
	},
/area/shuttle/dropship/victory)
"bG" = (
/obj/effect/attach_point/fuel/dropship1,
/turf/closed/shuttle/dropship4/transparent{
	icon_state = "28"
	},
/area/shuttle/dropship/victory)
"bH" = (
/turf/closed/shuttle/dropship4/transparent{
	icon_state = "29"
	},
/area/shuttle/dropship/victory)
"bI" = (
/turf/closed/shuttle/dropship4{
	icon_state = "30"
	},
/area/shuttle/dropship/victory)
"bJ" = (
/turf/closed/shuttle/dropship4{
	icon_state = "31"
	},
/area/shuttle/dropship/victory)
"bK" = (
/turf/closed/shuttle/dropship4/transparent{
	icon_state = "32"
	},
/area/shuttle/dropship/victory)
"bL" = (
/obj/effect/attach_point/fuel/dropship1{
	pixel_x = -32
	},
/turf/closed/shuttle/dropship4/transparent{
	icon_state = "33"
	},
/area/shuttle/dropship/victory)
"bM" = (
/turf/closed/shuttle/dropship4/transparent{
	icon_state = "22"
	},
/area/shuttle/dropship/victory)
"bN" = (
/turf/closed/shuttle/dropship4/transparent{
	icon_state = "23"
	},
/area/shuttle/dropship/victory)
"bO" = (
/turf/closed/shuttle/dropship4{
	icon_state = "24"
	},
/area/shuttle/dropship/victory)
"bP" = (
/turf/closed/shuttle/dropship4{
	icon_state = "25"
	},
/area/shuttle/dropship/victory)
"bQ" = (
/turf/closed/shuttle/dropship4/transparent{
	icon_state = "26"
	},
/area/shuttle/dropship/victory)
"bR" = (
/turf/closed/shuttle/dropship4/transparent{
	icon_state = "27"
	},
/area/shuttle/dropship/victory)
"bS" = (
/obj/structure/dropship_piece/four/engine/leftbottom,
/turf/template_noop,
/area/shuttle/dropship/victory)
"bT" = (
/obj/structure/dropship_piece/four/engine/rightbottom,
/turf/template_noop,
/area/shuttle/dropship/victory)
"bW" = (
/obj/structure/dropship_piece/four/corner/rearleft,
/turf/template_noop,
/area/shuttle/dropship/victory)
"bX" = (
/turf/closed/shuttle/dropship4{
	icon_state = "10"
	},
/area/shuttle/dropship/victory)
"bY" = (
/obj/machinery/door/airlock/multi_tile/mainship/dropshiprear/ds1,
/obj/machinery/door/poddoor/shutters/transit{
	dir = 1
	},
/turf/open/shuttle/dropship/floor,
/area/shuttle/dropship/victory)
"bZ" = (
/obj/machinery/door/poddoor/shutters/transit{
	dir = 1
	},
/turf/open/shuttle/dropship/floor,
/area/shuttle/dropship/victory)
"ca" = (
/turf/closed/shuttle/dropship4{
	icon_state = "14"
	},
/area/shuttle/dropship/victory)
"cb" = (
/obj/structure/dropship_piece/four/corner/rearright,
/turf/template_noop,
/area/shuttle/dropship/victory)
"cc" = (
/obj/structure/dropship_piece/four/rearwing/lefttop,
/turf/template_noop,
/area/shuttle/dropship/victory)
"cd" = (
/obj/structure/dropship_piece/four/rearwing/righttop,
/turf/template_noop,
/area/shuttle/dropship/victory)
"ce" = (
/obj/structure/dropship_piece/four/rearwing/leftllbottom,
/turf/template_noop,
/area/shuttle/dropship/victory)
"cf" = (
/obj/structure/dropship_piece/four/rearwing/leftlbottom,
/turf/template_noop,
/area/shuttle/dropship/victory)
"cg" = (
/obj/structure/dropship_piece/four/rearwing/leftbottom,
/turf/template_noop,
/area/shuttle/dropship/victory)
"ci" = (
/obj/structure/dropship_piece/four/rearwing/rightbottom,
/turf/template_noop,
/area/shuttle/dropship/victory)
"cj" = (
/obj/structure/dropship_piece/four/rearwing/rightrbottom,
/turf/template_noop,
/area/shuttle/dropship/victory)
"ck" = (
/obj/structure/dropship_piece/four/rearwing/rightrrbottom,
/turf/template_noop,
/area/shuttle/dropship/victory)
"Ki" = (
/obj/machinery/computer/shuttle/marine_dropship/four,
/turf/open/shuttle/dropship/floor,
/area/shuttle/dropship/victory)
"Zx" = (
/obj/machinery/telecomms/relay/preset/telecomms/onboard,
/turf/closed/shuttle/dropship4{
	icon_state = "63"
	},
/area/shuttle/dropship/victory)

(1,1,1) = {"
ao
ao
ao
ao
ao
aG
aQ
aX
ao
ao
ao
ao
ao
bs
bB
bG
bM
bS
ao
ao
ao
"}
(2,1,1) = {"
ao
ao
ao
ap
ay
aH
aR
aY
ac
ac
bf
bi
bn
bt
bC
bH
bN
bT
ao
ao
ce
"}
(3,1,1) = {"
ao
ao
ao
aq
az
aI
aI
aI
al
al
aI
aI
bo
bu
bu
bI
bO
bu
bW
ao
cf
"}
(4,1,1) = {"
aa
ae
aj
ar
aA
aJ
aS
aS
aS
aS
aS
bj
aI
bv
bD
be
aI
aI
bX
cc
cg
"}
(5,1,1) = {"
ab
af
ak
as
aB
aK
aN
aN
bd
aN
aN
aK
aS
aS
aS
aS
aS
aS
bY
ao
ao
"}
(6,1,1) = {"
ab
ag
Ki
at
aC
aL
aT
aZ
Zx
aZ
bg
bk
bp
bw
al
al
al
al
bZ
ao
ao
"}
(7,1,1) = {"
ab
ah
am
au
aD
aK
aI
aI
be
aI
aI
aK
aS
aS
aS
aS
aS
aS
bZ
ao
ao
"}
(8,1,1) = {"
ad
ai
an
av
aE
aM
aS
aS
aS
aS
aS
bl
aN
bx
aN
bd
aN
aN
ca
cd
ci
"}
(9,1,1) = {"
ao
ao
ao
aw
az
aN
aU
aN
al
al
aN
aN
bq
by
by
bJ
bP
by
cb
ao
cj
"}
(10,1,1) = {"
ao
ao
ao
ax
aF
aO
aV
ba
bc
bc
bh
bm
br
bs
bE
bK
bQ
bS
ao
ao
ck
"}
(11,1,1) = {"
ao
ao
ao
ao
ao
aP
aW
bb
ao
ao
ao
ao
ao
bt
bF
bL
bR
bT
ao
ao
ao
"}
