"a" = (/turf/closed/wall/r_wall/chigusa,/area/shipyard/bunker/administration)
"b" = (/turf/open/floor/vault,/area/shipyard/bunker/administration)
"c" = (/obj/machinery/door/airlock/vault,/turf/open/floor/vault,/area/shipyard/bunker/administration)
"d" = (/obj/machinery/power/apc/supercharged{dir = 1},/turf/open/floor/vault,/area/shipyard/bunker/administration)
"e" = (/obj/machinery/alarm{dir = 1},/turf/open/floor/vault,/area/shipyard/bunker/administration)
"f" = (/obj/machinery/firealarm{dir = 1},/turf/open/floor/vault,/area/shipyard/bunker/administration)

(1,1,1) = {"
aaaaaaaaaa
adefbbbbba
abbbbbbbba
abbbbbbbba
abbbbbbbba
abbbbbbbba
abbbbbbbba
abbbbbbbba
abbbbbbbba
aaaaccaaaa
"}
