//MAP CONVERTED BY dmm2tgm.py THIS HEADER COMMENT PREVENTS RECONVERSION, DO NOT REMOVE
"aD" = (
/obj/effect/landmark/patrol_point{
	id = "TGMC_14";
	name = "TGMC exit point 14"
	},
/turf/open/floor/plating/ground/concrete,
/area/centcom/roomba_race)
"aQ" = (
/turf/open/floor/plating,
/area/centcom/roomba_race)
"bW" = (
/obj/effect/landmark/patrol_point{
	id = "SOM_21";
	name = "SOM exit point 21"
	},
/turf/open/floor/plating/ground/concrete,
/area/centcom/roomba_race)
"dA" = (
/obj/structure/window/framed/mainship/gray/toughened/hull,
/turf/open/floor/plating/ground/concrete,
/area/centcom/roomba_race)
"dM" = (
/obj/effect/landmark/patrol_point{
	id = "TGMC_21";
	name = "TGMC exit point 21"
	},
/turf/open/floor/plating/ground/concrete,
/area/centcom/roomba_race)
"ed" = (
/obj/effect/landmark/dropship_start_location,
/turf/open/floor/plating/ground/concrete,
/area/centcom/roomba_race)
"eu" = (
/obj/effect/win/winxeno,
/obj/structure/window/reinforced/viewing{
	dir = 4
	},
/obj/structure/window/reinforced/viewing{
	dir = 8
	},
/obj/structure/window/reinforced/viewing{
	dir = 1
	},
/turf/open/space/basic,
/area/centcom/roomba_race/race_area)
"fc" = (
/turf/closed/wall/mainship/gray/outer,
/area/lv624/lazarus/console)
"fu" = (
/obj/structure/closet/secure_closet/security,
/turf/open/floor/prison/red/full,
/area/centcom/roomba_race)
"gj" = (
/obj/machinery/computer/nuke_disk_generator/green,
/turf/open/floor/plating/ground/concrete,
/area/centcom/roomba_race)
"gl" = (
/obj/effect/landmark/patrol_point{
	id = "TGMC_24";
	name = "TGMC exit point 24"
	},
/turf/open/floor/plating/ground/concrete,
/area/centcom/roomba_race)
"hH" = (
/obj/machinery/roomba/valhalla,
/obj/structure/window/reinforced/viewing{
	dir = 4
	},
/obj/structure/window/reinforced/viewing,
/turf/open/space/basic,
/area/centcom/roomba_race/race_area)
"iP" = (
/turf/closed/wall/mainship/gray/outer,
/area/centcom/roomba_race)
"iW" = (
/obj/effect/landmark/patrol_point{
	id = "SOM_12";
	name = "SOM exit point 12"
	},
/turf/open/floor/plating/ground/concrete,
/area/centcom/roomba_race)
"jY" = (
/obj/effect/landmark/patrol_point{
	id = "SOM_24";
	name = "SOM exit point 24"
	},
/turf/open/floor/plating/ground/concrete,
/area/centcom/roomba_race)
"kc" = (
/obj/effect/landmark/start/job/xenomorph,
/obj/effect/ai_node,
/turf/open/floor/plating/ground/concrete,
/area/centcom/roomba_race)
"lM" = (
/obj/effect/win,
/obj/structure/window/reinforced/viewing{
	dir = 4
	},
/obj/structure/window/reinforced/viewing{
	dir = 1
	},
/turf/open/space/basic,
/area/centcom/roomba_race/race_area)
"mC" = (
/obj/effect/landmark/patrol_point{
	id = "TGMC_12";
	name = "TGMC exit point 12"
	},
/turf/open/floor/plating/ground/concrete,
/area/centcom/roomba_race)
"nL" = (
/turf/open/floor/mainship/blue/full,
/area/centcom/roomba_race)
"pg" = (
/turf/open/floor/plating/ground/concrete,
/area/centcom/roomba_race)
"pR" = (
/obj/effect/landmark/patrol_point{
	id = "TGMC_23";
	name = "TGMC exit point 23"
	},
/turf/open/floor/plating/ground/concrete,
/area/centcom/roomba_race)
"qw" = (
/obj/machinery/camera/autoname/lz_camera,
/turf/open/floor/plating,
/area/centcom/roomba_race)
"qD" = (
/obj/docking_port/stationary/marine_dropship/lz1,
/turf/open/floor/plating,
/area/centcom/roomba_race)
"sy" = (
/obj/effect/landmark/patrol_point{
	id = "SOM_22";
	name = "SOM exit point 22"
	},
/turf/open/floor/plating/ground/concrete,
/area/centcom/roomba_race)
"tW" = (
/obj/machinery/vending/boozeomat,
/turf/open/floor/plating/ground/concrete,
/area/centcom/roomba_race)
"uT" = (
/obj/effect/landmark/patrol_point{
	id = "SOM_23";
	name = "SOM exit point 23"
	},
/turf/open/floor/plating/ground/concrete,
/area/centcom/roomba_race)
"vt" = (
/obj/machinery/telecomms/relay/preset/telecomms,
/turf/open/floor/plating/icefloor,
/area/lv624/lazarus/console)
"vE" = (
/obj/structure/table/reinforced,
/turf/open/floor/plating/ground/concrete,
/area/centcom/roomba_race)
"wq" = (
/obj/machinery/door/poddoor/timed_late/containment/landing_zone{
	dir = 2
	},
/obj/structure/window/reinforced/viewing{
	dir = 4
	},
/obj/structure/window/reinforced/viewing{
	dir = 8
	},
/turf/open/space/basic,
/area/centcom/roomba_race/race_area)
"wC" = (
/obj/item/pizzabox/margherita,
/obj/structure/table/reinforced,
/turf/open/floor/plating/ground/concrete,
/area/centcom/roomba_race)
"wT" = (
/obj/effect/landmark/patrol_point{
	id = "SOM_11";
	name = "SOM exit point 11"
	},
/turf/open/floor/plating/ground/concrete,
/area/centcom/roomba_race)
"xq" = (
/obj/machinery/button/door/open_only/landing_zone,
/turf/open/floor/plating/ground/concrete,
/area/centcom/roomba_race)
"xE" = (
/obj/machinery/light{
	dir = 4
	},
/turf/open/floor/plating/ground/concrete,
/area/centcom/roomba_race)
"yU" = (
/obj/structure/bed/chair/office/dark,
/obj/structure/prop/mainship/prop_sec,
/turf/open/floor/prison/red/full,
/area/centcom/roomba_race)
"zb" = (
/obj/docking_port/stationary/crashmode,
/turf/open/floor/plating/ground/concrete,
/area/centcom/roomba_race)
"zw" = (
/turf/open/space/basic,
/area/space)
"Ac" = (
/obj/machinery/roomba/valhalla,
/obj/structure/window/reinforced/viewing{
	dir = 4
	},
/obj/structure/window/reinforced/viewing{
	dir = 8
	},
/obj/structure/window/reinforced/viewing,
/turf/open/space/basic,
/area/centcom/roomba_race/race_area)
"BD" = (
/obj/machinery/light{
	dir = 8
	},
/turf/open/floor/plating/ground/concrete,
/area/centcom/roomba_race)
"BH" = (
/obj/machinery/computer/nuke_disk_generator/blue,
/turf/open/floor/plating/ground/concrete,
/area/centcom/roomba_race)
"BN" = (
/obj/structure/bed/chair/sofa/corsat/verticaltop,
/turf/open/floor/plating/ground/concrete,
/area/centcom/roomba_race)
"BP" = (
/obj/structure/window/reinforced/viewing{
	dir = 4
	},
/obj/structure/window/reinforced/viewing{
	dir = 8
	},
/turf/open/space/basic,
/area/centcom/roomba_race/race_area)
"Io" = (
/obj/machinery/computer/nuke_disk_generator/red,
/turf/open/floor/plating/ground/concrete,
/area/centcom/roomba_race)
"Jq" = (
/obj/structure/window/reinforced/viewing{
	dir = 4
	},
/turf/open/space/basic,
/area/centcom/roomba_race/race_area)
"Kd" = (
/obj/effect/landmark/xeno_turret_spawn,
/turf/open/floor/plating/ground/concrete,
/area/centcom/roomba_race)
"Kx" = (
/obj/item/weapon/gun/sentry/premade,
/turf/open/floor/plating/ground/concrete,
/area/centcom/roomba_race)
"Ll" = (
/obj/effect/landmark/sensor_tower,
/turf/open/floor/plating/ground/concrete,
/area/centcom/roomba_race)
"LO" = (
/obj/effect/landmark/start/job/xenomorph,
/turf/open/floor/plating/ground/concrete,
/area/centcom/roomba_race)
"LY" = (
/obj/effect/ai_node,
/turf/open/floor/plating/ground/concrete,
/area/centcom/roomba_race)
"Nh" = (
/obj/effect/landmark/patrol_point{
	id = "TGMC_13";
	name = "TGMC exit point 13"
	},
/turf/open/floor/plating/ground/concrete,
/area/centcom/roomba_race)
"Oe" = (
/obj/structure/table/mainship,
/turf/open/floor/prison/red/full,
/area/centcom/roomba_race)
"OZ" = (
/obj/effect/landmark/patrol_point{
	id = "SOM_13";
	name = "SOM exit point 13"
	},
/turf/open/floor/plating/ground/concrete,
/area/centcom/roomba_race)
"PD" = (
/obj/structure/prop/mainship/toolboxforacause2020,
/turf/open/floor/plating/ground/concrete,
/area/centcom/roomba_race)
"Qf" = (
/obj/structure/table/mainship,
/obj/machinery/computer/guestpass,
/turf/open/floor/prison/red/full,
/area/centcom/roomba_race)
"QB" = (
/obj/effect/landmark/patrol_point{
	id = "TGMC_11";
	name = "TGMC exit point 11"
	},
/turf/open/floor/plating/ground/concrete,
/area/centcom/roomba_race)
"QF" = (
/obj/effect/landmark/nuke_spawn,
/turf/open/floor/plating/ground/concrete,
/area/centcom/roomba_race)
"RD" = (
/obj/machinery/status_display,
/turf/closed/wall/mainship/gray,
/area/centcom/roomba_race)
"ST" = (
/obj/effect/landmark/lv624/fog_blocker/xeno_spawn,
/turf/open/floor/plating/ground/concrete,
/area/centcom/roomba_race)
"Tl" = (
/turf/open/floor/prison/red/full,
/area/centcom/roomba_race)
"Vd" = (
/obj/machinery/door/poddoor/timed_late/containment/landing_zone{
	dir = 2
	},
/obj/structure/window/reinforced/viewing{
	dir = 4
	},
/turf/open/space/basic,
/area/centcom/roomba_race/race_area)
"VK" = (
/obj/effect/landmark/patrol_point{
	id = "TGMC_22";
	name = "TGMC exit point 22"
	},
/turf/open/floor/plating/ground/concrete,
/area/centcom/roomba_race)
"VP" = (
/obj/effect/landmark/patrol_point{
	id = "SOM_14";
	name = "SOM exit point 14"
	},
/turf/open/floor/plating/ground/concrete,
/area/centcom/roomba_race)
"Ws" = (
/obj/effect/landmark/xeno_silo_spawn,
/turf/open/floor/plating/ground/concrete,
/area/centcom/roomba_race)
"WH" = (
/turf/open/floor/mainship/purple/full,
/area/centcom/roomba_race)
"WM" = (
/obj/effect/win/winxeno,
/obj/structure/window/reinforced/viewing{
	dir = 4
	},
/obj/structure/window/reinforced/viewing{
	dir = 1
	},
/turf/open/space/basic,
/area/centcom/roomba_race/race_area)
"XC" = (
/obj/machinery/door/poddoor/timed_late/containment/landing_zone,
/turf/open/floor/plating/ground/concrete,
/area/centcom/roomba_race)
"ZW" = (
/obj/structure/bed/chair/sofa/corsat/verticalsouth,
/turf/open/floor/plating/ground/concrete,
/area/centcom/roomba_race)

(1,1,1) = {"
zw
zw
zw
zw
zw
zw
zw
zw
zw
zw
zw
zw
zw
zw
zw
zw
zw
zw
zw
zw
zw
zw
zw
zw
zw
zw
zw
zw
zw
zw
zw
zw
zw
zw
zw
zw
zw
zw
zw
zw
zw
zw
zw
zw
zw
zw
zw
zw
zw
zw
zw
zw
zw
zw
zw
zw
zw
zw
zw
zw
zw
zw
zw
zw
zw
zw
zw
zw
zw
zw
zw
zw
zw
zw
zw
zw
zw
zw
zw
zw
zw
zw
zw
zw
zw
"}
(2,1,1) = {"
zw
zw
zw
zw
zw
zw
zw
zw
zw
zw
zw
zw
zw
zw
zw
zw
zw
zw
zw
zw
zw
zw
zw
zw
zw
zw
zw
zw
zw
zw
zw
zw
zw
zw
zw
zw
zw
zw
zw
zw
zw
zw
zw
zw
zw
zw
zw
zw
zw
zw
zw
zw
zw
zw
zw
zw
zw
zw
zw
zw
zw
zw
zw
zw
zw
zw
zw
zw
zw
zw
zw
zw
zw
zw
zw
zw
zw
zw
zw
zw
zw
zw
zw
zw
zw
"}
(3,1,1) = {"
zw
zw
zw
zw
zw
zw
zw
zw
zw
zw
zw
zw
zw
zw
zw
zw
zw
zw
zw
zw
zw
zw
zw
zw
zw
zw
zw
zw
zw
zw
zw
zw
zw
zw
zw
zw
zw
zw
zw
zw
zw
zw
zw
zw
zw
zw
zw
zw
zw
zw
zw
zw
zw
zw
zw
zw
zw
zw
zw
zw
zw
zw
zw
zw
zw
zw
zw
zw
zw
zw
zw
zw
zw
zw
zw
zw
zw
zw
zw
zw
zw
zw
zw
zw
zw
"}
(4,1,1) = {"
zw
zw
zw
zw
zw
zw
zw
zw
zw
zw
zw
zw
zw
zw
zw
zw
zw
zw
zw
zw
zw
zw
zw
zw
zw
zw
zw
zw
zw
zw
zw
zw
zw
zw
zw
zw
zw
zw
zw
zw
zw
zw
zw
zw
zw
zw
zw
zw
zw
zw
zw
zw
zw
zw
zw
zw
zw
zw
zw
zw
zw
zw
zw
zw
zw
zw
zw
zw
zw
zw
zw
zw
zw
zw
zw
zw
zw
zw
zw
zw
zw
zw
zw
zw
zw
"}
(5,1,1) = {"
zw
zw
zw
zw
zw
zw
zw
zw
zw
zw
zw
zw
zw
zw
zw
zw
zw
zw
zw
zw
zw
zw
zw
zw
zw
zw
zw
zw
zw
zw
zw
zw
zw
zw
zw
zw
zw
zw
zw
zw
zw
zw
zw
zw
zw
zw
zw
zw
zw
zw
zw
zw
zw
zw
zw
zw
zw
zw
zw
zw
zw
zw
zw
zw
zw
zw
zw
zw
zw
zw
zw
zw
zw
zw
zw
zw
zw
zw
zw
zw
zw
zw
zw
zw
zw
"}
(6,1,1) = {"
zw
zw
zw
zw
zw
zw
zw
zw
zw
zw
zw
zw
zw
zw
zw
zw
zw
zw
zw
zw
zw
zw
zw
zw
zw
zw
zw
zw
zw
zw
zw
zw
zw
zw
zw
zw
zw
zw
zw
zw
zw
zw
zw
zw
zw
zw
zw
zw
zw
zw
zw
zw
zw
zw
zw
zw
zw
zw
zw
zw
zw
zw
zw
zw
zw
zw
zw
zw
zw
zw
zw
zw
zw
zw
zw
zw
zw
zw
zw
zw
zw
zw
zw
zw
zw
"}
(7,1,1) = {"
zw
zw
zw
zw
iP
iP
iP
iP
iP
iP
iP
iP
iP
iP
iP
iP
iP
iP
iP
iP
iP
iP
iP
iP
iP
iP
iP
iP
iP
iP
iP
iP
iP
iP
iP
iP
iP
iP
iP
iP
iP
iP
iP
iP
iP
iP
iP
iP
iP
iP
iP
iP
iP
iP
iP
iP
iP
iP
iP
iP
iP
iP
iP
iP
iP
iP
iP
zw
zw
zw
zw
zw
zw
zw
zw
zw
zw
zw
zw
zw
zw
zw
zw
zw
zw
"}
(8,1,1) = {"
zw
zw
zw
zw
iP
QF
pg
pg
LY
pg
pg
pg
pg
LY
pg
LY
iP
Kd
pg
pg
pg
pg
pg
pg
pg
pg
pg
pg
pg
pg
pg
pg
pg
pg
pg
pg
pg
pg
pg
pg
pg
pg
pg
pg
pg
pg
pg
pg
pg
pg
pg
pg
pg
pg
pg
pg
pg
pg
pg
pg
pg
pg
pg
pg
pg
pg
iP
zw
zw
zw
zw
zw
zw
zw
zw
zw
zw
zw
zw
zw
zw
zw
zw
zw
zw
"}
(9,1,1) = {"
zw
zw
zw
zw
iP
pg
pg
pg
pg
pg
pg
pg
pg
pg
iP
pg
iP
Kd
pg
pg
pg
pg
pg
pg
pg
pg
pg
pg
pg
pg
pg
pg
pg
pg
pg
pg
pg
pg
pg
pg
pg
pg
pg
pg
pg
pg
pg
pg
pg
pg
pg
pg
pg
pg
pg
pg
pg
pg
pg
pg
pg
pg
pg
pg
pg
pg
iP
zw
zw
zw
zw
zw
zw
zw
zw
zw
zw
zw
zw
zw
zw
zw
zw
zw
zw
"}
(10,1,1) = {"
zw
zw
zw
zw
iP
iP
iP
iP
pg
iP
iP
iP
iP
pg
iP
pg
iP
Kd
pg
pg
pg
pg
pg
pg
pg
pg
pg
pg
pg
pg
pg
pg
pg
pg
pg
pg
pg
pg
pg
pg
pg
pg
pg
pg
pg
pg
pg
pg
pg
pg
pg
pg
pg
pg
pg
pg
pg
pg
pg
pg
pg
pg
pg
pg
pg
pg
iP
zw
zw
zw
zw
zw
zw
zw
zw
zw
zw
zw
zw
zw
zw
zw
zw
zw
zw
"}
(11,1,1) = {"
zw
zw
zw
zw
iP
ST
ST
ST
ST
ST
ST
ST
iP
pg
iP
pg
iP
Kd
pg
pg
pg
pg
pg
pg
pg
pg
pg
pg
pg
pg
pg
pg
pg
pg
pg
pg
pg
pg
pg
pg
pg
pg
pg
pg
pg
pg
pg
pg
pg
pg
pg
pg
pg
pg
pg
pg
pg
pg
pg
pg
pg
pg
pg
pg
pg
pg
iP
zw
zw
zw
zw
zw
zw
zw
zw
zw
zw
zw
zw
zw
zw
zw
zw
zw
zw
"}
(12,1,1) = {"
zw
zw
zw
zw
iP
ST
LO
LO
LO
LO
LO
ST
iP
pg
iP
pg
iP
Kd
pg
pg
pg
pg
pg
pg
pg
pg
pg
pg
pg
pg
pg
BN
ZW
RD
BN
ZW
RD
BN
ZW
RD
BN
ZW
RD
BN
ZW
RD
BN
ZW
RD
BN
ZW
RD
BN
ZW
RD
BN
ZW
RD
BN
ZW
RD
pg
pg
pg
pg
pg
iP
zw
zw
zw
zw
zw
zw
zw
zw
zw
zw
zw
zw
zw
zw
zw
zw
zw
zw
"}
(13,1,1) = {"
zw
zw
zw
zw
iP
ST
pg
pg
pg
Ws
pg
ST
iP
pg
iP
pg
iP
Kd
pg
pg
pg
pg
pg
pg
pg
pg
LY
pg
pg
pg
pg
pg
pg
BD
pg
pg
BD
pg
LY
BD
pg
pg
BD
pg
pg
BD
pg
pg
BD
LY
pg
BD
pg
pg
BD
pg
pg
BD
pg
LY
BD
pg
pg
pg
pg
pg
iP
zw
zw
zw
zw
zw
zw
zw
zw
zw
zw
zw
zw
zw
zw
zw
zw
zw
zw
"}
(14,1,1) = {"
zw
zw
zw
zw
iP
ST
pg
pg
pg
pg
pg
ST
iP
pg
iP
pg
iP
Kd
pg
pg
pg
pg
pg
pg
pg
pg
pg
pg
pg
pg
pg
WH
WH
WH
WH
WH
WH
WH
WH
WH
WH
WH
WH
WH
WH
WH
WH
WH
WH
WH
WH
WH
WH
WH
WH
WH
WH
WH
WH
WH
WH
pg
pg
pg
pg
pg
iP
zw
zw
zw
zw
zw
zw
zw
zw
zw
zw
zw
zw
zw
zw
zw
zw
zw
zw
"}
(15,1,1) = {"
zw
zw
zw
zw
iP
ST
pg
pg
pg
pg
pg
ST
iP
pg
iP
pg
iP
Kd
pg
pg
pg
pg
pg
pg
pg
pg
pg
pg
pg
wT
pg
eu
BP
BP
BP
BP
BP
BP
BP
BP
BP
BP
BP
BP
BP
BP
BP
BP
BP
BP
BP
BP
BP
BP
BP
BP
BP
BP
BP
wq
Ac
wC
QB
pg
pg
pg
iP
zw
zw
zw
zw
zw
zw
zw
zw
zw
zw
zw
zw
zw
zw
zw
zw
zw
zw
"}
(16,1,1) = {"
zw
zw
zw
zw
iP
ST
LO
LO
kc
LO
LO
ST
pg
LY
iP
pg
iP
Kd
pg
pg
pg
pg
pg
pg
pg
pg
pg
pg
pg
iW
pg
WM
Jq
Jq
Jq
Jq
Jq
Jq
Jq
Jq
Jq
Jq
Jq
Jq
Jq
Jq
Jq
Jq
Jq
Jq
Jq
Jq
Jq
Jq
Jq
Jq
Jq
Jq
Jq
Vd
hH
wC
mC
pg
pg
pg
iP
zw
zw
zw
zw
zw
zw
zw
zw
zw
zw
zw
zw
zw
zw
zw
zw
zw
zw
"}
(17,1,1) = {"
zw
zw
zw
zw
iP
ST
ST
ST
ST
ST
ST
ST
iP
pg
iP
pg
iP
Kd
pg
pg
pg
pg
pg
pg
pg
pg
pg
pg
pg
OZ
vE
WM
Jq
Jq
Jq
Jq
Jq
Jq
Jq
Jq
Jq
Jq
Jq
Jq
Jq
Jq
Jq
Jq
Jq
Jq
Jq
Jq
Jq
Jq
Jq
Jq
Jq
Jq
Jq
Vd
hH
wC
Nh
pg
pg
pg
iP
zw
zw
zw
zw
zw
zw
zw
zw
zw
zw
zw
zw
zw
zw
zw
zw
zw
zw
"}
(18,1,1) = {"
zw
zw
zw
zw
iP
iP
iP
iP
iP
iP
iP
iP
iP
iP
iP
pg
iP
Kd
pg
pg
pg
pg
pg
pg
pg
pg
pg
pg
pg
VP
PD
WM
Jq
Jq
Jq
Jq
Jq
Jq
Jq
Jq
Jq
Jq
Jq
Jq
Jq
Jq
Jq
Jq
Jq
Jq
Jq
Jq
Jq
Jq
Jq
Jq
Jq
Jq
Jq
Vd
hH
wC
aD
pg
pg
pg
iP
zw
zw
zw
zw
zw
zw
zw
zw
zw
zw
zw
zw
zw
zw
zw
zw
zw
zw
"}
(19,1,1) = {"
zw
zw
zw
zw
iP
LY
pg
pg
pg
pg
pg
pg
pg
pg
pg
LY
iP
Kd
pg
pg
pg
pg
pg
pg
pg
pg
Ll
pg
pg
bW
PD
lM
Jq
Jq
Jq
Jq
Jq
Jq
Jq
Jq
Jq
Jq
Jq
Jq
Jq
Jq
Jq
Jq
Jq
Jq
Jq
Jq
Jq
Jq
Jq
Jq
Jq
Jq
Jq
Vd
hH
wC
dM
pg
pg
pg
iP
zw
zw
zw
zw
zw
zw
zw
zw
zw
zw
zw
zw
zw
zw
zw
zw
zw
zw
"}
(20,1,1) = {"
zw
zw
zw
zw
iP
pg
iP
iP
iP
iP
iP
iP
iP
iP
iP
iP
iP
Kd
pg
pg
pg
pg
pg
pg
pg
pg
pg
pg
pg
sy
vE
lM
Jq
Jq
Jq
Jq
Jq
Jq
Jq
Jq
Jq
Jq
Jq
Jq
Jq
Jq
Jq
Jq
Jq
Jq
Jq
Jq
Jq
Jq
Jq
Jq
Jq
Jq
Jq
Vd
hH
wC
VK
pg
pg
pg
iP
zw
zw
zw
zw
zw
zw
zw
zw
zw
zw
zw
zw
zw
zw
zw
zw
zw
zw
"}
(21,1,1) = {"
zw
zw
zw
zw
iP
LY
pg
pg
pg
pg
pg
pg
pg
pg
pg
LY
iP
Kd
pg
pg
pg
pg
pg
pg
pg
pg
pg
pg
pg
uT
pg
lM
Jq
Jq
Jq
Jq
Jq
Jq
Jq
Jq
Jq
Jq
Jq
Jq
Jq
Jq
Jq
Jq
Jq
Jq
Jq
Jq
Jq
Jq
Jq
Jq
Jq
Jq
Jq
Vd
hH
wC
pR
pg
pg
pg
iP
zw
zw
zw
zw
zw
zw
zw
zw
zw
zw
zw
zw
zw
zw
zw
zw
zw
zw
"}
(22,1,1) = {"
zw
zw
zw
zw
iP
iP
iP
iP
iP
iP
iP
iP
iP
iP
iP
pg
iP
Kd
pg
pg
pg
pg
pg
pg
pg
pg
pg
pg
pg
jY
pg
lM
Jq
Jq
Jq
Jq
Jq
Jq
Jq
Jq
Jq
Jq
Jq
Jq
Jq
Jq
Jq
Jq
Jq
Jq
Jq
Jq
Jq
Jq
Jq
Jq
Jq
Jq
Jq
Vd
hH
wC
gl
pg
pg
pg
iP
zw
zw
zw
zw
zw
zw
zw
zw
zw
zw
zw
zw
zw
zw
zw
zw
zw
zw
"}
(23,1,1) = {"
zw
zw
zw
zw
iP
LY
pg
pg
pg
pg
pg
pg
pg
pg
pg
LY
iP
Kd
pg
pg
pg
pg
pg
pg
pg
pg
pg
pg
pg
pg
pg
nL
nL
nL
nL
nL
nL
nL
nL
nL
nL
nL
nL
nL
nL
nL
nL
nL
nL
nL
nL
nL
nL
nL
nL
nL
nL
nL
nL
nL
nL
pg
pg
pg
pg
pg
iP
zw
zw
zw
zw
zw
zw
zw
zw
zw
zw
zw
zw
zw
zw
zw
zw
zw
zw
"}
(24,1,1) = {"
zw
zw
zw
zw
iP
pg
iP
iP
iP
iP
iP
iP
iP
iP
iP
iP
iP
Kd
pg
pg
pg
pg
pg
pg
pg
pg
LY
pg
pg
pg
pg
pg
pg
xE
pg
pg
xE
pg
LY
xE
pg
pg
xE
pg
pg
xE
pg
pg
xE
LY
pg
xE
pg
pg
xE
pg
pg
xE
pg
LY
xE
pg
pg
pg
pg
pg
iP
zw
zw
zw
zw
zw
zw
zw
zw
zw
zw
zw
zw
zw
zw
zw
zw
zw
zw
"}
(25,1,1) = {"
zw
zw
zw
zw
iP
LY
pg
pg
pg
pg
pg
pg
pg
pg
pg
LY
iP
Kd
pg
pg
pg
pg
pg
pg
pg
pg
pg
pg
pg
pg
pg
BN
ZW
RD
BN
ZW
RD
BN
ZW
RD
BN
ZW
RD
BN
ZW
RD
BN
ZW
RD
BN
ZW
RD
BN
ZW
RD
BN
ZW
RD
BN
ZW
RD
pg
pg
pg
pg
pg
iP
zw
zw
zw
zw
zw
zw
zw
zw
zw
zw
zw
zw
zw
zw
zw
zw
zw
zw
"}
(26,1,1) = {"
zw
zw
zw
zw
iP
iP
iP
iP
iP
iP
iP
iP
iP
iP
iP
pg
iP
Kd
pg
pg
pg
pg
pg
pg
pg
pg
pg
pg
pg
pg
pg
pg
pg
pg
pg
pg
pg
pg
pg
pg
pg
pg
pg
pg
pg
pg
pg
pg
pg
pg
pg
pg
pg
pg
pg
pg
pg
pg
pg
pg
pg
pg
pg
pg
pg
pg
iP
zw
zw
zw
zw
zw
zw
zw
zw
zw
zw
zw
zw
zw
zw
zw
zw
zw
zw
"}
(27,1,1) = {"
zw
zw
zw
zw
iP
LY
pg
pg
pg
pg
pg
pg
pg
pg
pg
LY
iP
Kd
pg
pg
pg
pg
pg
pg
pg
pg
pg
pg
pg
pg
pg
pg
pg
pg
pg
pg
pg
pg
pg
pg
pg
pg
pg
pg
pg
pg
pg
pg
pg
pg
pg
pg
pg
pg
pg
pg
pg
pg
pg
pg
pg
pg
pg
pg
pg
pg
iP
zw
zw
zw
zw
zw
zw
zw
zw
zw
zw
zw
zw
zw
zw
zw
zw
zw
zw
"}
(28,1,1) = {"
zw
zw
zw
zw
iP
pg
iP
iP
iP
iP
iP
iP
iP
iP
iP
iP
iP
Kd
pg
pg
pg
pg
pg
pg
pg
pg
pg
pg
pg
pg
pg
pg
pg
pg
pg
pg
pg
pg
pg
pg
pg
pg
pg
pg
pg
pg
pg
pg
pg
pg
pg
pg
pg
pg
pg
pg
pg
pg
pg
pg
pg
pg
pg
pg
pg
pg
iP
zw
zw
zw
zw
zw
zw
zw
zw
zw
zw
zw
zw
zw
zw
zw
zw
zw
zw
"}
(29,1,1) = {"
zw
zw
zw
zw
iP
pg
Kd
Kd
Kd
Kd
Kd
Kd
Kd
Kd
Kd
Kd
Kd
pg
pg
pg
pg
pg
pg
pg
pg
pg
pg
pg
pg
pg
pg
pg
pg
pg
pg
pg
pg
pg
pg
pg
pg
pg
pg
pg
pg
pg
pg
pg
pg
pg
pg
pg
pg
pg
pg
pg
pg
pg
pg
pg
pg
pg
pg
pg
pg
pg
iP
zw
zw
zw
zw
zw
zw
zw
zw
zw
zw
zw
zw
zw
zw
zw
zw
zw
zw
"}
(30,1,1) = {"
zw
zw
zw
zw
iP
LY
pg
pg
pg
pg
pg
pg
pg
pg
pg
pg
pg
LY
pg
pg
pg
pg
pg
pg
pg
pg
LY
pg
pg
pg
pg
pg
pg
pg
pg
LY
pg
pg
LY
pg
pg
pg
pg
pg
pg
BH
gj
Io
pg
pg
pg
pg
pg
tW
tW
tW
tW
tW
pg
pg
tW
tW
tW
tW
tW
tW
iP
zw
zw
zw
zw
zw
zw
zw
zw
zw
zw
zw
zw
zw
zw
zw
zw
zw
zw
"}
(31,1,1) = {"
zw
zw
zw
zw
iP
iP
iP
iP
iP
iP
iP
iP
iP
iP
iP
iP
iP
iP
iP
iP
iP
iP
iP
iP
iP
iP
iP
iP
iP
iP
iP
iP
iP
iP
pg
pg
iP
iP
iP
iP
iP
iP
iP
iP
iP
iP
iP
iP
iP
iP
iP
iP
iP
iP
iP
iP
iP
iP
XC
XC
iP
iP
iP
iP
iP
iP
iP
iP
iP
iP
iP
iP
iP
iP
iP
iP
iP
iP
iP
iP
iP
iP
iP
iP
iP
"}
(32,1,1) = {"
zw
zw
zw
zw
zw
zw
zw
zw
zw
zw
zw
zw
zw
zw
zw
zw
zw
zw
iP
pg
pg
pg
pg
pg
pg
pg
pg
pg
pg
pg
pg
pg
pg
pg
pg
pg
pg
pg
pg
pg
pg
pg
pg
pg
pg
pg
pg
pg
pg
pg
pg
pg
pg
iP
fu
Oe
Qf
iP
pg
pg
Kx
Kx
Kx
Kx
Kx
Kx
Kx
Kx
Kx
Kx
Kx
Kx
Kx
Kx
Kx
Kx
Kx
Kx
Kx
Kx
Kx
Kx
Kx
Kx
iP
"}
(33,1,1) = {"
zw
zw
zw
zw
zw
zw
zw
zw
zw
zw
zw
zw
zw
zw
zw
zw
zw
zw
iP
pg
pg
pg
pg
pg
pg
pg
pg
pg
pg
pg
pg
pg
pg
pg
pg
pg
pg
pg
pg
pg
pg
pg
pg
pg
pg
pg
pg
pg
pg
pg
pg
pg
pg
iP
fu
pg
yU
dA
pg
pg
pg
pg
pg
pg
pg
pg
pg
pg
pg
pg
pg
pg
pg
pg
pg
pg
pg
pg
pg
pg
pg
pg
pg
Kx
iP
"}
(34,1,1) = {"
zw
zw
zw
zw
zw
zw
zw
zw
zw
zw
zw
zw
zw
zw
zw
zw
zw
zw
iP
pg
pg
pg
pg
pg
pg
pg
pg
pg
pg
pg
pg
pg
pg
pg
pg
pg
pg
pg
pg
pg
pg
pg
pg
pg
pg
pg
pg
pg
pg
pg
pg
pg
pg
iP
fu
pg
Tl
iP
xq
LY
pg
pg
pg
pg
pg
pg
pg
pg
pg
pg
LY
pg
pg
pg
pg
pg
pg
pg
pg
pg
pg
pg
LY
Kx
iP
"}
(35,1,1) = {"
zw
zw
zw
zw
zw
zw
zw
zw
zw
zw
zw
zw
zw
zw
zw
zw
zw
zw
iP
pg
pg
pg
pg
pg
pg
pg
pg
pg
pg
pg
pg
pg
pg
pg
pg
pg
pg
pg
pg
pg
pg
pg
pg
pg
pg
pg
pg
pg
pg
pg
pg
pg
pg
iP
Tl
pg
Qf
iP
Kx
pg
pg
pg
pg
pg
pg
pg
pg
pg
ed
pg
pg
pg
pg
pg
pg
pg
pg
pg
pg
pg
pg
pg
pg
Kx
iP
"}
(36,1,1) = {"
zw
zw
zw
zw
zw
zw
zw
zw
zw
zw
zw
zw
zw
zw
zw
zw
zw
zw
iP
pg
pg
pg
pg
pg
pg
pg
pg
pg
pg
pg
pg
pg
pg
pg
pg
pg
pg
pg
pg
pg
pg
pg
pg
pg
pg
pg
pg
pg
pg
pg
pg
pg
pg
iP
Tl
Tl
Oe
iP
Kx
pg
pg
pg
Kx
Kx
Kx
Kx
Kx
pg
pg
pg
pg
pg
pg
Kx
Kx
Kx
Kx
Kx
Kx
Kx
Kx
pg
pg
Kx
iP
"}
(37,1,1) = {"
zw
zw
zw
zw
zw
zw
zw
zw
zw
zw
zw
zw
zw
zw
zw
zw
zw
zw
iP
pg
pg
pg
pg
pg
pg
pg
pg
pg
pg
pg
pg
pg
pg
pg
pg
pg
pg
pg
pg
pg
pg
pg
pg
pg
pg
pg
pg
pg
pg
pg
pg
pg
pg
iP
iP
iP
iP
iP
Kx
pg
aQ
aQ
aQ
aQ
aQ
aQ
aQ
aQ
aQ
aQ
qw
aQ
aQ
aQ
aQ
aQ
aQ
aQ
aQ
aQ
aQ
Kx
pg
Kx
iP
"}
(38,1,1) = {"
zw
zw
zw
zw
zw
zw
zw
zw
zw
zw
zw
zw
zw
zw
zw
zw
zw
zw
iP
pg
pg
pg
pg
pg
pg
pg
pg
pg
pg
pg
pg
pg
pg
pg
pg
pg
pg
pg
pg
pg
pg
pg
pg
pg
pg
pg
pg
pg
pg
pg
pg
pg
pg
iP
zw
zw
zw
iP
Kx
pg
aQ
aQ
qw
aQ
aQ
aQ
aQ
aQ
aQ
aQ
aQ
aQ
aQ
aQ
aQ
aQ
aQ
aQ
qw
aQ
aQ
Kx
pg
Kx
iP
"}
(39,1,1) = {"
zw
zw
zw
zw
zw
zw
zw
zw
zw
zw
zw
zw
zw
zw
zw
zw
zw
zw
iP
pg
pg
pg
pg
pg
pg
pg
pg
pg
pg
pg
pg
pg
pg
pg
pg
pg
pg
pg
pg
pg
pg
pg
pg
pg
pg
pg
pg
pg
pg
pg
pg
pg
pg
iP
zw
zw
zw
iP
Kx
pg
aQ
aQ
aQ
aQ
aQ
aQ
aQ
aQ
aQ
aQ
aQ
aQ
aQ
aQ
aQ
aQ
aQ
aQ
aQ
aQ
aQ
Kx
pg
Kx
iP
"}
(40,1,1) = {"
zw
zw
zw
zw
zw
zw
zw
zw
zw
zw
zw
zw
zw
zw
zw
zw
zw
zw
iP
pg
pg
pg
pg
pg
pg
pg
pg
pg
pg
pg
pg
pg
pg
zb
pg
pg
pg
pg
pg
pg
pg
pg
pg
pg
pg
pg
pg
pg
pg
pg
pg
pg
pg
iP
zw
zw
zw
iP
Kx
pg
aQ
aQ
aQ
aQ
aQ
aQ
aQ
aQ
aQ
aQ
aQ
aQ
aQ
aQ
aQ
aQ
aQ
aQ
aQ
aQ
aQ
Kx
pg
Kx
iP
"}
(41,1,1) = {"
zw
zw
zw
zw
zw
zw
zw
zw
zw
zw
zw
zw
zw
zw
zw
zw
zw
zw
iP
pg
pg
pg
pg
pg
pg
pg
pg
pg
pg
pg
pg
pg
pg
pg
pg
pg
pg
pg
pg
pg
pg
pg
pg
pg
pg
pg
pg
pg
pg
pg
pg
pg
pg
iP
zw
zw
zw
iP
Kx
pg
aQ
aQ
aQ
aQ
aQ
aQ
aQ
aQ
aQ
aQ
aQ
aQ
aQ
aQ
aQ
aQ
aQ
aQ
aQ
aQ
aQ
Kx
pg
Kx
iP
"}
(42,1,1) = {"
zw
zw
zw
zw
zw
zw
zw
zw
zw
zw
zw
zw
zw
zw
zw
zw
zw
zw
iP
pg
pg
pg
pg
pg
pg
pg
pg
pg
pg
pg
pg
pg
pg
pg
pg
pg
pg
pg
pg
pg
pg
pg
pg
pg
pg
pg
pg
pg
pg
pg
pg
pg
pg
iP
zw
zw
zw
iP
Kx
pg
aQ
aQ
aQ
aQ
aQ
aQ
aQ
aQ
aQ
aQ
qD
aQ
aQ
aQ
aQ
aQ
aQ
aQ
aQ
aQ
aQ
pg
LY
Kx
iP
"}
(43,1,1) = {"
zw
zw
zw
zw
zw
zw
zw
zw
zw
zw
zw
zw
zw
zw
zw
zw
zw
zw
iP
pg
pg
pg
pg
pg
pg
pg
pg
pg
pg
pg
pg
pg
pg
pg
pg
pg
pg
pg
pg
pg
pg
pg
pg
pg
pg
pg
pg
pg
pg
pg
pg
pg
pg
iP
zw
zw
zw
iP
Kx
pg
aQ
aQ
aQ
aQ
aQ
aQ
aQ
aQ
aQ
aQ
aQ
aQ
aQ
aQ
aQ
aQ
aQ
aQ
aQ
aQ
aQ
Kx
pg
Kx
iP
"}
(44,1,1) = {"
zw
zw
zw
zw
zw
zw
zw
zw
zw
zw
zw
zw
zw
zw
zw
zw
zw
zw
iP
pg
pg
pg
pg
pg
pg
pg
pg
pg
pg
pg
pg
pg
pg
pg
pg
pg
pg
pg
pg
pg
pg
pg
pg
pg
pg
pg
pg
pg
pg
pg
pg
pg
pg
iP
zw
zw
zw
iP
Kx
pg
aQ
aQ
aQ
aQ
aQ
aQ
aQ
aQ
aQ
aQ
aQ
aQ
aQ
aQ
aQ
aQ
aQ
aQ
aQ
aQ
aQ
Kx
pg
Kx
iP
"}
(45,1,1) = {"
zw
zw
zw
zw
zw
zw
zw
zw
zw
zw
zw
zw
zw
zw
zw
zw
zw
zw
iP
pg
pg
pg
pg
pg
pg
pg
pg
pg
pg
pg
pg
pg
pg
pg
pg
pg
pg
pg
pg
pg
pg
pg
pg
pg
pg
pg
pg
pg
pg
pg
pg
pg
pg
iP
zw
zw
zw
iP
Kx
pg
aQ
aQ
aQ
aQ
aQ
aQ
aQ
aQ
aQ
aQ
aQ
aQ
aQ
aQ
aQ
aQ
aQ
aQ
aQ
aQ
aQ
Kx
pg
Kx
iP
"}
(46,1,1) = {"
zw
zw
zw
zw
zw
zw
zw
zw
zw
zw
zw
zw
zw
zw
zw
zw
zw
zw
iP
pg
pg
pg
pg
pg
pg
pg
pg
pg
pg
pg
pg
pg
pg
pg
pg
pg
pg
pg
pg
pg
pg
pg
pg
pg
pg
pg
pg
pg
pg
pg
pg
pg
pg
iP
zw
zw
zw
iP
Kx
pg
aQ
aQ
qw
aQ
aQ
aQ
aQ
aQ
aQ
aQ
aQ
aQ
aQ
aQ
aQ
aQ
aQ
aQ
qw
aQ
aQ
Kx
pg
Kx
iP
"}
(47,1,1) = {"
zw
zw
zw
zw
zw
zw
zw
zw
zw
zw
zw
zw
zw
zw
zw
zw
zw
zw
iP
pg
pg
pg
pg
pg
pg
pg
pg
pg
pg
pg
pg
pg
pg
pg
pg
pg
pg
pg
pg
pg
pg
pg
pg
pg
pg
pg
pg
pg
pg
pg
pg
pg
pg
iP
zw
zw
zw
iP
Kx
pg
aQ
aQ
aQ
aQ
aQ
aQ
aQ
aQ
aQ
aQ
qw
aQ
aQ
aQ
aQ
aQ
aQ
aQ
aQ
aQ
aQ
Kx
pg
Kx
iP
"}
(48,1,1) = {"
zw
zw
zw
zw
zw
zw
zw
zw
zw
zw
zw
fc
fc
fc
zw
zw
zw
zw
iP
pg
pg
pg
pg
pg
pg
pg
pg
pg
pg
pg
pg
pg
pg
pg
pg
pg
pg
pg
pg
pg
pg
pg
pg
pg
pg
pg
pg
pg
pg
pg
pg
pg
pg
iP
zw
zw
zw
iP
Kx
LY
pg
pg
pg
pg
pg
pg
pg
pg
pg
pg
LY
pg
pg
pg
pg
pg
pg
pg
pg
pg
pg
pg
LY
Kx
iP
"}
(49,1,1) = {"
zw
zw
zw
zw
zw
zw
zw
zw
zw
zw
zw
fc
vt
fc
zw
zw
zw
zw
iP
pg
pg
pg
pg
pg
pg
pg
pg
pg
pg
pg
pg
pg
pg
pg
pg
pg
pg
pg
pg
pg
pg
pg
pg
pg
pg
pg
pg
pg
pg
pg
pg
pg
pg
iP
zw
zw
zw
iP
Kx
Kx
Kx
Kx
Kx
Kx
Kx
Kx
Kx
Kx
Kx
Kx
Kx
Kx
Kx
Kx
Kx
Kx
Kx
Kx
Kx
Kx
Kx
Kx
Kx
Kx
iP
"}
(50,1,1) = {"
zw
zw
zw
zw
zw
zw
zw
zw
zw
zw
zw
fc
fc
fc
zw
zw
zw
zw
iP
iP
iP
iP
iP
iP
iP
iP
iP
iP
iP
iP
iP
iP
iP
iP
iP
iP
iP
iP
iP
iP
iP
iP
iP
iP
iP
iP
iP
iP
iP
iP
iP
iP
iP
iP
zw
zw
zw
iP
iP
iP
iP
iP
iP
iP
iP
iP
iP
iP
iP
iP
iP
iP
iP
iP
iP
iP
iP
iP
iP
iP
iP
iP
iP
iP
iP
"}
