//MAP CONVERTED BY dmm2tgm.py THIS HEADER COMMENT PREVENTS RECONVERSION, DO NOT REMOVE
"AT" = (
/turf/open/floor/plating/ground/dirt,
/area/oscar_outpost/outside/underground)
"LE" = (
/obj/effect/ai_node,
/turf/open/floor/plating/ground/dirt,
/area/oscar_outpost/outside/underground)
"OR" = (
/obj/effect/decal/cleanable/blood/oil,
/turf/closed/mineral/smooth,
/area/oscar_outpost/outside/rock)
"Tp" = (
/turf/closed/mineral/smooth/indestructible,
/area/oscar_outpost/outside/rock)
"Xn" = (
/turf/closed/mineral/smooth,
/area/oscar_outpost/outside/rock)
"Zz" = (
/obj/machinery/camera/autoname/mainship{
	dir = 8
	},
/turf/open/floor/plating/ground/dirt,
/area/oscar_outpost/outside/underground)

(1,1,1) = {"
Xn
Xn
Xn
Xn
Xn
Xn
Xn
AT
AT
AT
AT
AT
AT
AT
AT
AT
AT
AT
Xn
Xn
Xn
Xn
Xn
Xn
Xn
Xn
Xn
Xn
Xn
"}
(2,1,1) = {"
Xn
Xn
Xn
Xn
Xn
Xn
Xn
Xn
Xn
AT
AT
AT
AT
AT
AT
AT
AT
AT
Xn
Xn
Xn
Xn
Xn
Xn
Xn
Xn
Xn
Xn
Xn
"}
(3,1,1) = {"
Xn
Xn
Xn
Xn
Xn
Xn
Xn
Xn
Xn
Xn
AT
AT
LE
AT
AT
AT
AT
LE
AT
Xn
Xn
Xn
Xn
Xn
Xn
Xn
Xn
Xn
Xn
"}
(4,1,1) = {"
Xn
Xn
Xn
Xn
Xn
Xn
Xn
Xn
Xn
Xn
Xn
AT
AT
AT
AT
AT
AT
AT
AT
Xn
Xn
Xn
Xn
Xn
Xn
Xn
Xn
Xn
Xn
"}
(5,1,1) = {"
Xn
Xn
Xn
Xn
Xn
Xn
Xn
Xn
Xn
Xn
Xn
Xn
AT
AT
AT
Zz
AT
AT
OR
Xn
Xn
Xn
Xn
Xn
Xn
Xn
Xn
Xn
Xn
"}
(6,1,1) = {"
Xn
Xn
Xn
Xn
Xn
Xn
Xn
Xn
Xn
Xn
Xn
Xn
Xn
Xn
Xn
Xn
Xn
Xn
Xn
Xn
Xn
Xn
Xn
Xn
Xn
Xn
Xn
Xn
Xn
"}
(7,1,1) = {"
Xn
Xn
Xn
Xn
Xn
Xn
Xn
Xn
Xn
Xn
Xn
Xn
Xn
Xn
Xn
Xn
Xn
Xn
Xn
Xn
Xn
Xn
Xn
Xn
Xn
Xn
Xn
Xn
Xn
"}
(8,1,1) = {"
Xn
Xn
Xn
Xn
Xn
Xn
Xn
Xn
Xn
Xn
Xn
Xn
Xn
Xn
Xn
Xn
Xn
Xn
Xn
Xn
Xn
Xn
Xn
Xn
Xn
Xn
Xn
Xn
Xn
"}
(9,1,1) = {"
Xn
Xn
Xn
Xn
Xn
Xn
Xn
Xn
Xn
Xn
Xn
Xn
Xn
Xn
Xn
Xn
Xn
Xn
Xn
Xn
Xn
Xn
Xn
Xn
Xn
Xn
Xn
Xn
Xn
"}
(10,1,1) = {"
Xn
Xn
Xn
Xn
Xn
Xn
Xn
Xn
Xn
Xn
Xn
Xn
Xn
Xn
Xn
Xn
Xn
Xn
Xn
Xn
Xn
Xn
Xn
Xn
Xn
Xn
Xn
Xn
Xn
"}
(11,1,1) = {"
Xn
Xn
Xn
Xn
Xn
Xn
Xn
Xn
Xn
Xn
Xn
Xn
Xn
Xn
Xn
Xn
Xn
Xn
Xn
Xn
Xn
Xn
Xn
Xn
Xn
Xn
Xn
Xn
Xn
"}
(12,1,1) = {"
Xn
Xn
Xn
Xn
Xn
Xn
Xn
Xn
Xn
Xn
Xn
Xn
Xn
Xn
Xn
Xn
Xn
Xn
Xn
Xn
Xn
Xn
Xn
Xn
Xn
Xn
Xn
Xn
Xn
"}
(13,1,1) = {"
Xn
Xn
Xn
Xn
Xn
Xn
Xn
Xn
Xn
Xn
Xn
Xn
Xn
Xn
Xn
Xn
Xn
Xn
Xn
Xn
Xn
Xn
Xn
Xn
Xn
Xn
Xn
Xn
Xn
"}
(14,1,1) = {"
Xn
Xn
Xn
Xn
Xn
Xn
Xn
Xn
Xn
Xn
Xn
Xn
Xn
Xn
Xn
Xn
Xn
Xn
Xn
Xn
Xn
Xn
Xn
Xn
Xn
Xn
Xn
Xn
Xn
"}
(15,1,1) = {"
Xn
Xn
Xn
Xn
Xn
Xn
Xn
Xn
Xn
Xn
Xn
Xn
Xn
Xn
Xn
Xn
Xn
Xn
Xn
Xn
Xn
Xn
Xn
Xn
Xn
Xn
Xn
Xn
Xn
"}
(16,1,1) = {"
Xn
Xn
Xn
Xn
Xn
Xn
Xn
Xn
Xn
Xn
Xn
Xn
Xn
Xn
Xn
Xn
Xn
Xn
Xn
Xn
Xn
Xn
Xn
Xn
Xn
Xn
Xn
Xn
Xn
"}
(17,1,1) = {"
Xn
Xn
Xn
Xn
Xn
Xn
Xn
Xn
Xn
Xn
Xn
Xn
Xn
Xn
Xn
Xn
Xn
Xn
Xn
Xn
Xn
Xn
Xn
Xn
Xn
Xn
Xn
Xn
Xn
"}
(18,1,1) = {"
Xn
Xn
Xn
Xn
Xn
Xn
Xn
Xn
Xn
Xn
Xn
Xn
Xn
Xn
Xn
Xn
Xn
Xn
Xn
Xn
Xn
Xn
Xn
Xn
Xn
Xn
Xn
Xn
Xn
"}
(19,1,1) = {"
Xn
Xn
Xn
Xn
Xn
Xn
Xn
Xn
Xn
Xn
Xn
Xn
Xn
Xn
Xn
Xn
Xn
Xn
Xn
Xn
Xn
Xn
Xn
Xn
Xn
Xn
Xn
Xn
Xn
"}
(20,1,1) = {"
Xn
Xn
Xn
Xn
Xn
Xn
Xn
Xn
Xn
Xn
Xn
Xn
Xn
Xn
Xn
Xn
Xn
Xn
Xn
Xn
Xn
Xn
Xn
Xn
Xn
Xn
Xn
Xn
Xn
"}
(21,1,1) = {"
Xn
Xn
Xn
Xn
Xn
Xn
Xn
Xn
Xn
Xn
Xn
Xn
Xn
Xn
Xn
Xn
Xn
Xn
Xn
Xn
Xn
Xn
Xn
Xn
Xn
Xn
Xn
Xn
Xn
"}
(22,1,1) = {"
Xn
Xn
Xn
Xn
Xn
Xn
Xn
Xn
Xn
Xn
Xn
Xn
Xn
Xn
Xn
Xn
Xn
Xn
Xn
Xn
Xn
Xn
Xn
Xn
Xn
Xn
Xn
Xn
Xn
"}
(23,1,1) = {"
Xn
Xn
Xn
Xn
Xn
Xn
Xn
Xn
Xn
Xn
Xn
Xn
Xn
Xn
Xn
Xn
Xn
Xn
Xn
Xn
Xn
Xn
Xn
Xn
Xn
Xn
Xn
Xn
Xn
"}
(24,1,1) = {"
Xn
Xn
Xn
Xn
Xn
Xn
Xn
Xn
Xn
Xn
Xn
Xn
Xn
Xn
Xn
Xn
Xn
Xn
Xn
Xn
Xn
Xn
Xn
Xn
Xn
Xn
Xn
Xn
Xn
"}
(25,1,1) = {"
Xn
Xn
Xn
Xn
Xn
Xn
Xn
Xn
Xn
Xn
Xn
Xn
Xn
Xn
Xn
Xn
Xn
Xn
Xn
Xn
Xn
Xn
Xn
Xn
Xn
Xn
Xn
Xn
Xn
"}
(26,1,1) = {"
Xn
Xn
Xn
Xn
Xn
Xn
Xn
Xn
Xn
Xn
Xn
Xn
Xn
Xn
Xn
Xn
Xn
Xn
Xn
Xn
Xn
Xn
Xn
Xn
Xn
Xn
Xn
Xn
Xn
"}
(27,1,1) = {"
Xn
Xn
Xn
Xn
Xn
Xn
Xn
Xn
Xn
Xn
Xn
Xn
Xn
Xn
Xn
Xn
Xn
Xn
Xn
Xn
Xn
Xn
Xn
Xn
Xn
Xn
Xn
Xn
Xn
"}
(28,1,1) = {"
Xn
Xn
Xn
Xn
Xn
Xn
Xn
Xn
Xn
Xn
Xn
Xn
Xn
Xn
Xn
Xn
Xn
Xn
Xn
Xn
Xn
Xn
Xn
Xn
Xn
Xn
Xn
Xn
Xn
"}
(29,1,1) = {"
Xn
Xn
Xn
Xn
Xn
Xn
Xn
Xn
Xn
Xn
Xn
Xn
Xn
Xn
Xn
Xn
Xn
Xn
Xn
Xn
Xn
Xn
Xn
Xn
Xn
Xn
Xn
Xn
Xn
"}
(30,1,1) = {"
Xn
Xn
Xn
Xn
Xn
Xn
Xn
Xn
Xn
Xn
Xn
Xn
Xn
Xn
Xn
Xn
Xn
Xn
Xn
Xn
Xn
Xn
Xn
Xn
Xn
Xn
Xn
Xn
Xn
"}
(31,1,1) = {"
Xn
Xn
Xn
Xn
Xn
Xn
Xn
Xn
Xn
Xn
Xn
Xn
Xn
Xn
Xn
Xn
Xn
Xn
Xn
Xn
Xn
Xn
Xn
Xn
Xn
Xn
Xn
Xn
Xn
"}
(32,1,1) = {"
Xn
Xn
Xn
Xn
Xn
Xn
Xn
Xn
Xn
Xn
Xn
Xn
Xn
Xn
Xn
Xn
Xn
Xn
Xn
Xn
Xn
Xn
Xn
Xn
Xn
Xn
Xn
Xn
Xn
"}
(33,1,1) = {"
Xn
Xn
Xn
Xn
Xn
Xn
Xn
Xn
Xn
Xn
Xn
Xn
Xn
Xn
Xn
Xn
Xn
Xn
Xn
Xn
Xn
Xn
Xn
Xn
Xn
Xn
Xn
Xn
Xn
"}
(34,1,1) = {"
Xn
Xn
Xn
Xn
Xn
Xn
Xn
Xn
Xn
Xn
Xn
Xn
Xn
Xn
Xn
Xn
Xn
Xn
Xn
Xn
Xn
Xn
Xn
Xn
Xn
Xn
Xn
Xn
Xn
"}
(35,1,1) = {"
Xn
Xn
Xn
Xn
Xn
Xn
Xn
Xn
Xn
Xn
Xn
Xn
Xn
Xn
Xn
Xn
Xn
Xn
Xn
Xn
Xn
Xn
Xn
Xn
Xn
Xn
Xn
Xn
Xn
"}
(36,1,1) = {"
Xn
Xn
Xn
Xn
Xn
Xn
Xn
Xn
Xn
Xn
Xn
Xn
Xn
Xn
Xn
Xn
Xn
Xn
Xn
Xn
Xn
Xn
Xn
Xn
Xn
Xn
Xn
Xn
Xn
"}
(37,1,1) = {"
Xn
Xn
Xn
Xn
Xn
Xn
Xn
Xn
Xn
Xn
Xn
Xn
Xn
Xn
Xn
Xn
Xn
Xn
Xn
Xn
Xn
Xn
Xn
Xn
Xn
Xn
Xn
Xn
Xn
"}
(38,1,1) = {"
Xn
Xn
Xn
Xn
Xn
Xn
Xn
Xn
Xn
Xn
Xn
Xn
Xn
Xn
Xn
Xn
Xn
Xn
Xn
Xn
Xn
Xn
Xn
Xn
Xn
Xn
Xn
Xn
Xn
"}
(39,1,1) = {"
Xn
Xn
Xn
Xn
Xn
Xn
Xn
Xn
Xn
Xn
Xn
Xn
Xn
Xn
Xn
Xn
Xn
Xn
Xn
Xn
Xn
Xn
Xn
Xn
Xn
Xn
Xn
Xn
Xn
"}
(40,1,1) = {"
Xn
Xn
Xn
Xn
Xn
Xn
Xn
Xn
Xn
Xn
Xn
Xn
Xn
Xn
Xn
Xn
Xn
Xn
Xn
Xn
Xn
Xn
Xn
Xn
Xn
Xn
Xn
Xn
Xn
"}
(41,1,1) = {"
Xn
Xn
Xn
Xn
Xn
Xn
Xn
Xn
Xn
Xn
Xn
Xn
Xn
Xn
Xn
Xn
Xn
Xn
Xn
Xn
Xn
Xn
Xn
Xn
Xn
Xn
Xn
Xn
Xn
"}
(42,1,1) = {"
Xn
Xn
Xn
Xn
Xn
Xn
Xn
Xn
Xn
Xn
Xn
Xn
Xn
Xn
Xn
Xn
Xn
Xn
Xn
Xn
Xn
Xn
Xn
Xn
Xn
Xn
Xn
Xn
Xn
"}
(43,1,1) = {"
Xn
Xn
Xn
Xn
Xn
Xn
Xn
Xn
Xn
Xn
Xn
Xn
Xn
Xn
Xn
Xn
Xn
Xn
Xn
Xn
Xn
Xn
Xn
Xn
Xn
Xn
Xn
Xn
Xn
"}
(44,1,1) = {"
Xn
Xn
Xn
Xn
Xn
Xn
Xn
Xn
Xn
Xn
Xn
Xn
Xn
Xn
Xn
Xn
Xn
Xn
Xn
Xn
Xn
Xn
Xn
Xn
Xn
Xn
Xn
Xn
Xn
"}
(45,1,1) = {"
Xn
Xn
Xn
Xn
Xn
Xn
Xn
Xn
Xn
Xn
Xn
Xn
Xn
Xn
Xn
Xn
Xn
Xn
Xn
Xn
Xn
Xn
Xn
Xn
Xn
Xn
Xn
Xn
Xn
"}
(46,1,1) = {"
Xn
Xn
Xn
Xn
Xn
Xn
Xn
Xn
Xn
Xn
Xn
Xn
Xn
Xn
Xn
Xn
Xn
Xn
Xn
Xn
Xn
Xn
Xn
Xn
Xn
Xn
Xn
Xn
Xn
"}
(47,1,1) = {"
Xn
Xn
Xn
Xn
Xn
Xn
Xn
Xn
Xn
Xn
Xn
Xn
Xn
Xn
Xn
Xn
Xn
Xn
Xn
Xn
Xn
Xn
Xn
Xn
Xn
Xn
Xn
Xn
Xn
"}
(48,1,1) = {"
Xn
Xn
Xn
Xn
Xn
Xn
Xn
Xn
Xn
Xn
Xn
Xn
Xn
Xn
Xn
Xn
Xn
Xn
Xn
Xn
Xn
Xn
Xn
Xn
Xn
Xn
Xn
Xn
Xn
"}
(49,1,1) = {"
Xn
Xn
Xn
Xn
Xn
Xn
Xn
Xn
Xn
Xn
Xn
Xn
Xn
Xn
Xn
Xn
Xn
Xn
Xn
Xn
Xn
Xn
Xn
Xn
Xn
Xn
Xn
Xn
Xn
"}
(50,1,1) = {"
Xn
Xn
Xn
Xn
Xn
Xn
Xn
Xn
Xn
Xn
Xn
Xn
Xn
Xn
Xn
Xn
Xn
Xn
Xn
Xn
Xn
Xn
Xn
Xn
Xn
Xn
Xn
Xn
Xn
"}
(51,1,1) = {"
Xn
Xn
Xn
Xn
Xn
Xn
Xn
Xn
Xn
Xn
Xn
Xn
Xn
Xn
Xn
Xn
Xn
Xn
Xn
Xn
Xn
Xn
Xn
Xn
Xn
Xn
Xn
Xn
Xn
"}
(52,1,1) = {"
Xn
Xn
Xn
Xn
Xn
Xn
Xn
Xn
Xn
Xn
Xn
Xn
Xn
Xn
Xn
Xn
Xn
Xn
Xn
Xn
Xn
Xn
Xn
Xn
Xn
Xn
Xn
Xn
Xn
"}
(53,1,1) = {"
Xn
Xn
Xn
Xn
Xn
Xn
Xn
Xn
Xn
Xn
Xn
Xn
Xn
Xn
Xn
Xn
Xn
Xn
Xn
Xn
Xn
Xn
Xn
Xn
Xn
Xn
Xn
Xn
Xn
"}
(54,1,1) = {"
Xn
Xn
Xn
Xn
Xn
Xn
Xn
Xn
Xn
Xn
Xn
Xn
Xn
Xn
Xn
Xn
Xn
Xn
Xn
Xn
Xn
Xn
Xn
Xn
Xn
Xn
Xn
Xn
Xn
"}
(55,1,1) = {"
Xn
Xn
Xn
Xn
Xn
Xn
Xn
Xn
Xn
Xn
Xn
Xn
Xn
Xn
Xn
Xn
Xn
Xn
Xn
Xn
Xn
Xn
Xn
Xn
Xn
Xn
Xn
Xn
Xn
"}
(56,1,1) = {"
Xn
Xn
Xn
Xn
Xn
Xn
Xn
Xn
Xn
Xn
Xn
Xn
Xn
Xn
Xn
Xn
Xn
Xn
Xn
Xn
Xn
Xn
Xn
Xn
Xn
Xn
Xn
Xn
Xn
"}
(57,1,1) = {"
Xn
Xn
Xn
Xn
Xn
Xn
Xn
Xn
Xn
Xn
Xn
Xn
Xn
Xn
Xn
Xn
Xn
Xn
Xn
Xn
Xn
Xn
Xn
Xn
Xn
Xn
Xn
Xn
Xn
"}
(58,1,1) = {"
Xn
Xn
Xn
Xn
Xn
Xn
Xn
Xn
Xn
Xn
Xn
Xn
Xn
Xn
Xn
Xn
Xn
Xn
Xn
Xn
Xn
Xn
Xn
Xn
Xn
Xn
Xn
Xn
Xn
"}
(59,1,1) = {"
Xn
Xn
Xn
Xn
Xn
Xn
Xn
Xn
Xn
Xn
Xn
Xn
Xn
Xn
Xn
Xn
Xn
Xn
Xn
Xn
Xn
Xn
Xn
Xn
Xn
Xn
Xn
Xn
Xn
"}
(60,1,1) = {"
Xn
Xn
Xn
Xn
Xn
Xn
Xn
Xn
Xn
Xn
Xn
Xn
Xn
Xn
Xn
Xn
Xn
Xn
Xn
Xn
Xn
Xn
Xn
Xn
Xn
Xn
Xn
Xn
Xn
"}
(61,1,1) = {"
Xn
Xn
Xn
Xn
Xn
Xn
Xn
Xn
Xn
Xn
Xn
Xn
Xn
Xn
Xn
Xn
Xn
Xn
Xn
Xn
Xn
Xn
Xn
Xn
Xn
Xn
Xn
Xn
Xn
"}
(62,1,1) = {"
Xn
Xn
Xn
Xn
Xn
Xn
Xn
Xn
Xn
Xn
Xn
Xn
Xn
Xn
Xn
Xn
Xn
Xn
Xn
Xn
Xn
Xn
Xn
Xn
Xn
Xn
Xn
Xn
Xn
"}
(63,1,1) = {"
Xn
Xn
Xn
Xn
Xn
Xn
Xn
Xn
Xn
Xn
Xn
Xn
Xn
Xn
Xn
Xn
Xn
Xn
Xn
Xn
Xn
Xn
Xn
Xn
Xn
Xn
Xn
Xn
Xn
"}
(64,1,1) = {"
Xn
Xn
Xn
Xn
Xn
Xn
Xn
Xn
Xn
Xn
Xn
Xn
Xn
Xn
Xn
Xn
Xn
Xn
Xn
Xn
Xn
Xn
Xn
Xn
Xn
Xn
Xn
Xn
Xn
"}
(65,1,1) = {"
Xn
Xn
Xn
Xn
Xn
Xn
Xn
Xn
Xn
Xn
Xn
Xn
Xn
Xn
Xn
Xn
Xn
Xn
Xn
Xn
Xn
Xn
Xn
Xn
Xn
Xn
Xn
Xn
Xn
"}
(66,1,1) = {"
Xn
Xn
Xn
Xn
Xn
Xn
Xn
Xn
Xn
Xn
Xn
Xn
Xn
Xn
Xn
Xn
Xn
Xn
Xn
Xn
Xn
Xn
Xn
Xn
Xn
Xn
Xn
Xn
Xn
"}
(67,1,1) = {"
Xn
Xn
Xn
Xn
Xn
Xn
Xn
Xn
Xn
Xn
Xn
Xn
Xn
Xn
Xn
Xn
Xn
Xn
Xn
Xn
Xn
Xn
Xn
Xn
Xn
Xn
Xn
Xn
Xn
"}
(68,1,1) = {"
Xn
Xn
Xn
Xn
Xn
Xn
Xn
Xn
Xn
Xn
Xn
Xn
Xn
Xn
Xn
Xn
Xn
Xn
Xn
Xn
Xn
Xn
Xn
Xn
Xn
Xn
Xn
Xn
Xn
"}
(69,1,1) = {"
Xn
Xn
Xn
Xn
Xn
Xn
Xn
Xn
Xn
Xn
Xn
Xn
Xn
Xn
Xn
Xn
Xn
Xn
Xn
Xn
Xn
Xn
Xn
Xn
Xn
Xn
Xn
Xn
Xn
"}
(70,1,1) = {"
Xn
Xn
Xn
Xn
Xn
Xn
Xn
Xn
Xn
Xn
Xn
Xn
Xn
Xn
Xn
Xn
Xn
Xn
Xn
Xn
Xn
Xn
Xn
Xn
Xn
Xn
Xn
Xn
Xn
"}
(71,1,1) = {"
Xn
Xn
Xn
Xn
Xn
Xn
Xn
Xn
Xn
Xn
Xn
Xn
Xn
Xn
Xn
Xn
Xn
Xn
Xn
Xn
Xn
Xn
Xn
Xn
Xn
Xn
Xn
Tp
Tp
"}
(72,1,1) = {"
Xn
Xn
Xn
Xn
Xn
Xn
Xn
Xn
Xn
Xn
Xn
Xn
Xn
Xn
Xn
Xn
Xn
Xn
Xn
Xn
Xn
Xn
Xn
Xn
Xn
Xn
Xn
Tp
Tp
"}
(73,1,1) = {"
Xn
Xn
Xn
Xn
Xn
Xn
Xn
Xn
Xn
Xn
Xn
Xn
Xn
Xn
Xn
Xn
Xn
Xn
Xn
Xn
Xn
Xn
Xn
Xn
Xn
Xn
Xn
Tp
Tp
"}
(74,1,1) = {"
Xn
Xn
Xn
Xn
Xn
Xn
Xn
Xn
Xn
Xn
Xn
Xn
Xn
Xn
Xn
Xn
Xn
Xn
Xn
Xn
Xn
Xn
Xn
Xn
Xn
Xn
Xn
Tp
Tp
"}
(75,1,1) = {"
Xn
Xn
Xn
Xn
Xn
Xn
Xn
Xn
Xn
Xn
Xn
Xn
Xn
Xn
Xn
Xn
Xn
Xn
Xn
Xn
Xn
Xn
Xn
Xn
Xn
Xn
Xn
Tp
Tp
"}
(76,1,1) = {"
Xn
Xn
Xn
Xn
Xn
Xn
Xn
Xn
Xn
Xn
Xn
Xn
Xn
Xn
Xn
Xn
Xn
Xn
Xn
Xn
Xn
Xn
Xn
Xn
Xn
Xn
Xn
Tp
Tp
"}
(77,1,1) = {"
Xn
Xn
Xn
Xn
Xn
Xn
Xn
Xn
Xn
Xn
Xn
Xn
Xn
Xn
Xn
Xn
Xn
Xn
Xn
Xn
Xn
Xn
Xn
Xn
Xn
Xn
Xn
Tp
Tp
"}
(78,1,1) = {"
Xn
Xn
Xn
Xn
Xn
Xn
Xn
Xn
Xn
Xn
Xn
Xn
Xn
Xn
Xn
Xn
Xn
Xn
Xn
Xn
Xn
Xn
Xn
Xn
Xn
Xn
Xn
Tp
Tp
"}
(79,1,1) = {"
Xn
Xn
Xn
Xn
Xn
Xn
Xn
Xn
Xn
Xn
Xn
Xn
Xn
Xn
Xn
Xn
Xn
Xn
Xn
Xn
Xn
Xn
Xn
Xn
Xn
Xn
Xn
Tp
Tp
"}
